,beauty_x,boring_x,lively_x,depressing_x,walk_x,safety_x,wealth_x,idx_x,decile_2011_beauty,oa,decile_2011_boring,decile_2011_lively,decile_2011_depressing,decile_2011_walk,decile_2011_safety,decile_2011_wealth,beauty_y,boring_y,lively_y,depressing_y,walk_y,safety_y,wealth_y,idx_y,decile_2021_beauty,decile_2021_boring,decile_2021_lively,decile_2021_depressing,decile_2021_walk,decile_2021_safety,decile_2021_wealth,count,decile_change_beauty,decile_change_boring,decile_change_lively,decile_change_depressing,decile_change_walk,decile_change_safety,decile_change_wealth
0,5.273980640293507,4.9433278381154775,5.699371545502309,5.061379297395771,5.457260843073384,5.7024663927849755,5.679752750343152,1449.258426966292,1,E01000001,1,6,8,4,0,7,5.272340673492068,4.888857982272193,5.6483453818729945,5.082797950790042,5.3471407197770615,5.699883186249506,5.729568037532625,1905.847619047619,1,0,5,7,4,0,7,1.0,0,-1,-1,-1,0,0,0
1,5.1515862648947195,4.9885364551293225,5.703918645256444,5.166894693123667,5.346879847217024,5.638831548523485,5.401719369386372,1557.0263157894738,0,E01000002,1,6,9,2,0,2,5.13834817137037,4.958838001659938,5.709755575316293,5.202613090787615,5.328248241969518,5.6844316032954625,5.588737503460475,2047.1314285714286,0,1,6,9,3,0,5,1.0,0,0,0,0,1,0,3
2,4.969232470900924,5.253559951429014,5.46900357581951,5.0616832530056985,5.348076979319255,5.515413257810804,5.235138486932825,2021.962962962963,0,E01000003,4,2,8,2,0,1,5.106616650308881,5.138449553080967,5.568257577078683,5.102403126444135,5.2324245657239645,5.6199522290910995,5.411645919936044,2894.7428571428572,0,3,4,7,1,0,2,1.0,0,-1,2,-1,-1,0,1
3,5.020063762153898,4.952113210445359,5.729286703325453,5.156077500610125,5.348819101850192,5.687709487619854,5.521016771594684,1418.2619047619048,0,E01000005,1,6,9,2,0,4,5.068620206759526,4.894755321282607,5.7284432252248125,5.063381887093568,5.355895512531966,5.669614949593178,5.601113350574787,2001.4102564102564,0,0,7,7,4,0,5,1.0,0,-1,1,-2,2,0,1
4,5.701343005353754,5.220902106978676,5.731262998147444,4.783091382546858,5.50310267222048,6.308233222576103,5.715236112324878,167298.0202020202,5,E01000006,4,6,2,5,9,7,5.585057634573716,5.183533144521189,5.62701597056546,5.047122714283702,5.29197483927339,6.130563659982367,5.488614953481234,210396.0879120879,5,4,5,6,2,8,3,1.0,0,0,-1,4,-3,-1,-4
5,5.028287009227495,5.531182547288438,5.194208156843127,5.343143126715912,5.1631810050800535,5.534645427224095,5.060681821378462,170538.42331288345,0,E01000007,9,0,9,0,0,0,5.017567140518586,5.3514717713945865,5.262024596936441,5.355992244847248,5.114102265738339,5.59986849396215,5.2634067314897655,215012.80924855493,0,7,0,9,0,0,0,1.0,0,-2,0,0,0,0,0
6,4.945223302726286,5.656828577259937,5.105393241686993,5.456435532454985,5.019316584230905,5.537158347037901,4.895976190107414,178891.6987951807,0,E01000008,9,0,9,0,0,0,5.005846344598449,5.434072843872674,5.187518914147179,5.276160925921827,4.928038004601356,5.53703789899845,5.117489130190103,226449.55445544556,0,8,0,9,0,0,0,1.0,0,-1,0,0,0,0,0
7,5.457780007694079,5.26982201182324,5.6083019318787946,5.045030160572217,5.3549346986024275,6.019244440742161,5.479045802613963,165614.81739130436,3,E01000009,5,5,7,2,5,4,5.379599380688589,5.294138178473613,5.595412549425344,5.188959134406731,5.227480561029716,5.927758195361153,5.425083525845261,208367.09016393442,2,6,4,8,1,4,2,1.0,-1,1,-1,1,-1,-1,-2
8,5.182809287050496,5.355321534301924,5.460816455923992,5.12511163742646,5.279646595146345,5.720104506741399,5.271021475480951,171005.61739130435,0,E01000010,6,2,8,1,1,1,5.222847361209964,5.193009349925459,5.502288276498968,5.163448209112341,5.205349313818719,5.7057300875009584,5.2930593160558335,215326.95867768594,1,4,3,8,1,0,0,1.0,1,-2,1,0,0,-1,-1
9,5.785200818725254,5.072334683459738,5.866321532622628,4.8508526190467505,5.498743008876192,6.291539067807405,5.652391608210578,162326.115942029,6,E01000011,2,8,4,5,9,7,5.617337965965271,5.047610678672791,5.824238735834758,4.922755338350932,5.364420375823975,6.147141459782918,5.56436821937561,204428.70666666667,5,2,8,4,4,8,4,1.0,-1,0,0,0,-1,-1,-3
10,5.211849982088262,5.534209129485217,5.401034826582128,5.100900606675581,5.198299399831078,5.818455735390836,5.239045838063413,172757.52272727274,0,E01000012,9,1,8,0,2,1,5.145035835412832,5.333664849564269,5.398082892973345,5.227682476515298,5.1704962515569,5.7058628142535035,5.342606583794395,218567.95604395604,0,7,1,9,0,0,1,1.0,0,-2,0,1,0,-2,0
11,5.240453989451169,5.420440332580159,5.541387514303659,5.113765537283803,5.25324466574283,5.896530371585875,5.402567459426764,165531.4503816794,1,E01000013,7,3,8,0,3,2,5.215524351596832,5.397134666259472,5.575696958028353,5.2422503508054294,5.1730173367720385,5.834087751461909,5.228188956700839,208270.88461538462,1,8,4,9,0,2,0,1.0,0,1,1,1,0,-1,-2
12,5.2621366946525825,5.4901006626927,5.292388083888035,5.101205029518776,5.26291035515031,5.878427461861006,5.2773630548925965,167974.71895424835,1,E01000014,8,0,8,1,2,1,5.339615184527177,5.45911554648326,5.342401414345472,5.193572468482531,5.215978395480376,5.838097972747607,5.266209608469254,211415.7371794872,2,8,1,8,1,2,0,1.0,1,0,1,0,0,0,-1
13,5.2201698534190655,5.5266543459147215,5.410282572731376,5.157890277914703,5.188754517585039,5.930690441280603,5.380949632264674,164527.2578125,0,E01000015,8,1,9,0,3,2,5.462692828935998,5.411512230044213,5.523155727119089,5.087327517081644,5.399677606386559,6.007898571335267,5.283832903220275,206965.13084112148,4,8,3,7,5,5,0,1.0,4,0,2,-2,5,2,-2
14,5.2597680445444785,5.44261539184441,5.380027153734433,5.089408514863353,5.230078869957035,5.864855614759154,5.34697079860558,164948.6779661017,1,E01000016,7,1,8,0,2,2,5.104446474521879,5.451661956688715,5.4161326714924405,5.250505236406175,5.111148856935047,5.822747270266215,5.203655152093797,207450.15873015873,0,8,1,9,0,2,0,1.0,-1,1,0,1,0,0,-2
15,5.263518954953577,5.460523250775459,5.434539839752719,5.16311672100654,5.253871825006273,5.877640239193908,5.354550652014903,165667.81196581197,1,E01000017,8,2,9,0,2,2,5.280175716423791,5.336339157474928,5.58252305826865,5.15413550700038,5.317313688845674,5.875538077236207,5.309492222533739,208400.04958677685,1,7,4,8,3,3,1,1.0,0,-1,2,-1,3,1,-1
16,5.196778798962499,5.533311695665927,5.4388120002574745,5.112603286365131,5.269190966545999,5.938873980496381,5.422162032342172,164997.7207207207,0,E01000018,9,2,8,1,4,3,5.357530961621483,5.415274947319391,5.574985599742745,5.0747769216321545,5.437182574901941,6.0266986882911535,5.382173695654239,207555.24528301886,2,8,4,7,6,6,1,1.0,2,-1,2,-1,5,2,-2
17,5.383960742576449,5.5551029443740845,5.513738655576519,5.017347615139157,5.327074385156818,5.950817306836446,5.376510278851378,156825.41176470587,2,E01000019,9,3,7,1,4,2,5.19670581540396,5.43251764312271,5.508850082870602,5.195706445117329,5.235465625459834,5.8325192152067675,5.285981507264366,197882.03100775194,1,8,3,9,1,2,0,1.0,-1,-1,0,2,0,-2,-2
18,5.26502410536227,5.5761554790579755,5.43064054198887,5.063858584735705,5.330965482670328,5.986579411962758,5.330706271917924,156881.05217391305,1,E01000020,9,2,8,1,4,1,5.2334207969327124,5.41630069190456,5.515346717449926,5.137760554590533,5.2594826221466064,5.913921796506451,5.321986572396371,197983.13709677418,1,8,3,8,2,3,1,1.0,0,-1,1,0,1,-1,0
19,5.267507366907029,5.385408604712714,5.499518010729835,5.128308021454584,5.2563921769460045,5.782135039284116,5.212916779518127,157458.98095238095,1,E01000021,7,3,8,0,1,0,5.116995585270417,5.3549732978527365,5.50399941053146,5.217754054273295,5.197944622773391,5.7429124636527815,5.284432501874418,198656.57264957266,0,7,3,9,1,1,0,1.0,-1,0,0,1,1,0,0
20,5.1908841469349,5.5813239476619625,5.41697639074081,5.185042928426694,5.291883788557134,6.020510443255433,5.292456886707208,157181.84615384616,0,E01000022,9,2,9,1,5,1,5.109539549827575,5.492277530670166,5.376699699401856,5.277044632911682,5.18059748840332,5.87222413444519,5.21872289943695,198341.688,0,9,1,9,1,3,0,1.0,0,0,-1,0,0,-2,-1
21,5.389466494595239,5.4849605669669055,5.551966030663307,4.98428011706116,5.342115407689996,5.894448687177186,5.231634610289827,157758.6880733945,2,E01000023,8,4,6,2,3,1,5.288479441290448,5.341119564262924,5.437971816700735,5.097190890342566,5.239047301043371,5.8266138817853985,5.512446890211409,199055.96815286623,1,7,2,7,1,2,3,1.0,-1,-1,-2,1,-1,-1,2
22,5.2030547333287664,5.504453694427406,5.4451688423261535,5.1717865231272935,5.215150332712865,5.986043018299145,5.317658789865264,157678.97802197802,0,E01000024,8,2,9,0,4,1,5.047866516787073,5.467744397080463,5.431222166704095,5.31545631263567,5.028156903774842,5.802547172359798,5.312488124422405,198901.14130434784,0,9,2,9,0,1,1,1.0,0,1,0,0,0,-3,0
23,5.164669660811729,5.4529750220319055,5.477418685213048,5.141103760993227,5.292044888151453,5.952104969227568,5.337332919557044,157845.06382978722,0,E01000025,8,2,9,1,4,2,5.02999501272079,5.541166305541992,5.402752333824788,5.253184788817659,5.133240763200533,5.812105229141515,5.342630077939515,199122.32110091744,0,9,1,9,0,2,1,1.0,0,1,-1,0,-1,-2,-1
24,5.537582929371394,5.669656742734519,5.104004046721765,5.040030190470623,5.303137188766435,5.780858463014078,5.151778755480783,270586.16374269006,4,E01000027,9,0,7,1,1,0,5.460958726944462,5.656077483532366,5.074837883196968,5.147675078635341,5.167639312156834,5.745198092502583,5.246649126153538,338397.66275659826,4,9,0,8,0,1,0,1.0,0,0,0,1,-1,0,0
25,5.186944878927552,5.542668569206011,5.26758591609426,5.130352230355291,5.274021439032979,5.798553410142955,5.164278671292975,151933.33663366336,0,E01000028,9,0,8,1,1,0,5.127186750110827,5.571613441015545,5.143800342710395,5.264261248237208,5.262218037404512,5.7131444730256735,5.229420863954645,191805.38947368422,0,9,0,9,2,0,0,1.0,0,0,0,1,1,-1,0
26,5.323466909058551,5.509054614508406,5.228569737774261,5.130651943227078,5.339275538921356,5.8636439480680105,5.312556873610679,151068.3510638298,1,E01000029,8,0,8,2,2,1,5.223829125069283,5.393191892391926,5.319424518379005,5.185977500838202,5.212102808179082,5.887971332910898,5.3767107583381035,190767.27027027027,1,8,0,8,1,3,1,1.0,0,0,0,0,-1,1,0
27,5.39611314444264,5.699834822004686,5.266767527490454,5.113310864153465,5.351320585327833,5.846007023691596,5.1904202544635725,150983.932735426,2,E01000030,9,0,8,2,2,0,5.291382665481042,5.625950721425748,5.183232588505526,5.149292109209463,5.210851164585954,5.853908700680514,5.312269334946204,190725.49541284403,1,9,0,8,1,2,1,1.0,-1,0,0,0,-1,0,1
28,5.390763973268334,5.480705026843122,5.31172726062185,5.093568311797248,5.271069789278334,5.827243482433079,5.232693030638395,150410.68599033816,2,E01000031,8,1,8,1,2,1,5.333950252576907,5.446116428770777,5.407927295579339,5.154567779483883,5.101864386813432,5.832394883379958,5.398907731205637,190077.61751152074,2,8,1,8,0,2,2,1.0,0,0,0,0,-1,0,1
29,5.319506735775057,5.390438561332958,5.454111466860638,5.088532345254994,5.266652121890191,5.952800138036632,5.327171866454226,150849.56983240222,1,E01000032,7,2,8,1,4,1,5.245291077572366,5.365886814105584,5.457112980925518,5.16041404342059,5.088054421525564,5.897249061868798,5.4359381850461785,190574.6894409938,1,7,2,8,0,3,2,1.0,0,0,0,0,-1,-1,1
30,5.112039939321653,5.541783098018531,5.286876892802691,5.205035770782317,5.143020272254944,5.90042111849544,5.2921347594020345,164090.88888888888,0,E01000033,9,0,9,0,3,1,5.17202603560622,5.4494291236323695,5.328873449756253,5.12498576025809,5.203691641489665,5.889344130792925,5.260997527389116,206483.44086021505,0,8,1,8,1,3,0,1.0,0,-1,1,-1,1,0,-1
31,5.335530364797229,5.491847090777897,5.305630891096024,5.02798986080147,5.276359179190227,5.8818804408822745,5.4051882816212515,170047.79761904763,1,E01000034,8,0,7,1,3,2,5.423918669543615,5.389913074127057,5.40977394944284,4.987385556465242,5.324310630559921,5.970947931452495,5.423547348598155,214876.05487804877,3,8,1,5,3,5,2,1.0,2,0,1,-2,2,2,0
32,4.929016114374913,5.56092441519466,5.192279292355984,5.333593678036961,5.045778967918606,5.554122951599436,5.067516891234511,164301.78440366974,0,E01000035,9,0,9,0,0,0,4.982136005010361,5.412302511777633,5.280333908398946,5.282634111551138,5.056615661963439,5.577163114914527,5.093075312712254,206764.54358974358,0,8,0,9,0,0,0,1.0,0,-1,0,0,0,0,0
33,5.219748462716194,5.315948647179016,5.282827037654511,5.2147209366706955,5.2019837702790355,5.888516671037021,5.246480552301015,164861.6301369863,0,E01000036,5,0,9,0,3,1,5.370156406417606,5.23707904684262,5.442659733802315,5.113454073432862,5.2633138350614415,5.895692298731466,5.3209964525042555,207713.72440944883,2,5,2,7,2,3,1,1.0,2,0,2,-2,2,0,0
34,5.2602540182587285,5.394943331712044,5.544903918400707,5.117520733967724,5.363712709222064,5.9611546673230675,5.595994021268499,172586.6577181208,1,E01000037,7,4,8,2,4,6,5.23180271503402,5.350119334895436,5.49392045416483,5.178271372143815,5.297788398294914,5.919374114129601,5.461070927904873,217994.9024390244,1,7,3,8,3,4,3,1.0,0,0,-1,0,1,0,-3
35,5.184361788056652,5.4238417170802995,5.375127703506754,5.193122683104521,5.272683311693417,5.844901434383037,5.391083220517413,173470.68322981367,0,E01000038,7,1,9,1,2,2,5.266510674312933,5.218310247606306,5.547133111242038,5.123203449284852,5.287325036169878,5.9584833597069355,5.415311793782818,219244.97014925373,1,5,3,8,2,4,2,1.0,1,-2,2,-1,1,2,0
36,5.3313368270861226,5.584077152629827,5.263051077023449,5.111575077844146,5.1766218267031165,5.833243662878971,5.187439360874611,172759.6510067114,1,E01000039,9,0,8,0,2,0,5.48854868772418,5.426517734000849,5.307772072941758,5.054451247287351,5.335023604853209,5.837768371022025,5.256384274987287,218254.3023255814,4,8,0,6,3,2,0,1.0,3,-1,0,-2,3,0,0
37,5.160308925628662,5.477585751533509,5.416590857505798,5.163009572982788,5.210248112678528,5.871783620834351,5.08215350818634,168225.768,0,E01000040,8,2,9,0,2,0,5.089031657189813,5.368330031860876,5.462603199572963,5.210675144923552,5.139437132209312,5.830892650225691,5.230072940578897,211450.15267175573,0,7,2,9,0,2,0,1.0,0,-1,0,0,0,0,0
38,5.409274275486286,5.4348657644712,5.465612462850717,4.995574331283569,5.324888819914598,6.043952875870925,5.405161219376784,177814.29230769232,2,E01000041,7,2,6,1,5,2,5.31554460962978,5.3992072671925255,5.488767322050322,5.095281265197544,5.2703435136637555,5.999293410449947,5.44959649142869,225157.11926605506,2,8,2,7,2,5,2,1.0,0,1,0,1,1,0,0
39,5.44379757899864,5.523573199128793,5.376290509903353,4.985789502368254,5.300066206969467,5.979156194948683,5.268485354442222,170027.16339869282,2,E01000042,8,1,6,1,4,1,5.299019753932953,5.49736264679167,5.371762444575627,5.056206157637967,5.244751225743029,5.927495234542423,5.313728305200736,213578.49305555556,1,9,1,6,1,4,1,1.0,-1,1,0,0,0,0,0
40,5.287351631536716,5.437122513608235,5.438293262952712,5.135179114777867,5.247324042930836,5.930880597451838,5.302051445332969,168846.0487804878,1,E01000043,7,2,8,0,3,1,5.204538496234749,5.3349310242677035,5.447253584861755,5.114847589142715,5.151753454268733,5.929484913620768,5.581164983254444,212196.18354430379,1,7,2,7,0,4,5,1.0,0,0,0,-1,0,1,4
41,5.223533550305153,5.342376419857366,5.4424445424506915,5.179671306218674,5.301298245565215,5.781564981190126,5.132862061706941,168339.223880597,0,E01000044,6,2,9,1,1,0,5.268581126417432,5.258164214236396,5.469252860546112,5.160310063191822,5.296536680630275,5.8294810737882345,5.423795471021108,211581.82142857142,1,5,2,8,2,2,2,1.0,1,-1,0,-1,1,1,2
42,5.0361681966822545,5.496098517348326,5.282182534876811,5.1932069820395865,5.143005311744919,5.723963312325048,5.236201527804265,174236.991416309,0,E01000045,8,0,9,0,1,1,5.111026562361354,5.398800965293823,5.354699484315742,5.174946840987148,5.108621738043176,5.7887748724006745,5.350850675479475,219936.1887550201,0,8,1,8,0,1,1,1.0,0,0,1,-1,0,0,0
43,5.331006281303637,5.3980488126928154,5.441046647351198,5.011055257585314,5.364873137136902,6.059168256894506,5.388184726840318,177282.45454545456,1,E01000046,7,2,7,2,6,2,5.290041216529242,5.408913543908903,5.3624375515645095,5.107483617149957,5.3158255154543586,6.018431743772903,5.5432108617064975,224548.91089108912,1,8,1,7,3,6,4,1.0,0,1,-1,0,1,0,2
44,5.004316369692485,5.4897306476320535,5.272937476634979,5.278928118092673,5.151029748576028,5.552262902259827,5.1037491503215975,169551.09523809524,0,E01000048,8,0,9,0,0,0,4.9970799423754215,5.51217120885849,5.248937889933586,5.234578117728233,4.98442867398262,5.545079506933689,5.135029427707195,212980.25,0,9,0,9,0,0,0,1.0,0,1,0,0,0,0,0
45,5.004060275241977,5.556503040868728,5.063673436641693,5.3436268929575315,5.01698284266425,5.526443614334356,5.121124724872777,169548.05737704918,0,E01000049,9,0,9,0,0,0,5.133756933388887,5.4762985242737665,5.219682355721791,5.334830745502755,5.07124924659729,5.636890821986729,5.237543167891325,212979.2685185185,0,9,0,9,0,0,0,1.0,0,0,0,0,0,0,0
46,5.248570183227802,5.393672585487366,5.435827436118291,5.102239628290308,5.250819043866519,5.770511121585451,5.1983799379447415,168829.6724137931,1,E01000050,7,2,8,0,1,0,5.180310543094363,5.297499372490814,5.487944460340908,5.233535620783057,5.194662068571363,5.7023153475352695,5.416559278964996,212170.69642857142,0,6,2,9,1,0,2,1.0,-1,-1,0,1,1,-1,2
47,4.986296985298395,5.4816600903868675,5.519743226468563,5.316207408905029,5.0650096498429775,5.714509837329388,5.208483442664146,168476.65625,0,E01000051,8,3,9,0,1,0,4.949368037283421,5.326549146324396,5.305093884468079,5.333180174231529,5.1316515281796455,5.689555995166302,5.199427518993616,211968.375,0,7,0,9,0,0,0,1.0,0,-1,-3,0,0,-1,0
48,5.302502068110875,5.411346805436271,5.377370444706508,5.086394802502223,5.289943327903748,5.844671171733311,5.149094272341047,169022.13714285713,1,E01000052,7,1,8,1,2,0,5.322661707136366,5.326917021804386,5.407460288206736,5.116889801952574,5.240347799327639,5.805744191010793,5.3469905171129435,212398.73888888888,2,7,1,7,1,2,1,1.0,1,0,0,-1,0,0,1
49,5.142119979858398,5.559336695671082,5.210663821220398,5.147098003387451,5.1090022554397585,5.636772121429443,5.205150831222534,175885.432,0,E01000053,9,0,9,0,0,0,5.171732201399626,5.486362733664336,5.3018701138319795,5.23171090638196,5.183443006762752,5.744298152570371,5.2938102519070664,222709.05185185187,0,9,0,9,1,1,0,1.0,0,0,0,0,1,1,0
50,5.087653974692027,5.530893258253733,5.381245374679565,5.241276680429777,5.235666561126709,5.815968036651611,5.285392658909162,176542.55833333332,0,E01000054,9,1,9,0,2,1,5.035381596507007,5.470981787179262,5.376602684268515,5.286614910336851,5.114818459248725,5.8094262221387325,5.324180377348688,223667.2900763359,0,9,1,9,0,2,1,1.0,0,0,0,0,0,0,0
51,5.145369707296292,5.501438458760579,5.323763700822989,5.157555724183719,5.258388166626294,5.879793646434943,5.204351457456748,176876.41666666666,0,E01000055,8,1,9,0,3,0,5.206796319797785,5.462246837037982,5.389446053842102,5.166632704060487,5.200314938419997,5.8654105494720765,5.4337959060765275,224052.31313131313,1,9,1,8,1,2,2,1.0,1,1,0,-1,1,-1,2
52,5.12803002101619,5.72313382567429,5.26140259048803,5.226374261747531,5.084368236665803,5.704162334038959,5.127662041322972,176231.47154471546,0,E01000056,9,0,9,0,0,0,5.147660297732199,5.503730320161389,5.365452310731334,5.258772336667584,5.160040686207433,5.8135102083606105,5.266299087193705,223240.54032258064,0,9,1,9,0,2,0,1.0,0,0,1,0,0,2,0
53,5.130298335928666,5.328058788650914,5.406078998666061,5.184595640082108,5.238547998980472,5.820315243068494,5.281568357819005,177005.83157894737,0,E01000057,6,1,9,0,2,1,5.1898762572486445,5.337719834075783,5.4345004401117,5.125207109271355,5.198855653124036,5.865689383362824,5.384208530749914,224224.0849056604,0,7,2,8,1,2,1,1.0,0,1,1,-1,1,0,0
54,5.170042059754812,5.496253425075162,5.464689329106321,5.067856878362676,5.283653423350344,5.912132068346906,5.3178392764060725,174378.25806451612,0,E01000058,8,2,8,1,3,1,5.251907530952902,5.336466393050025,5.470792309910643,5.1266455743827075,5.309456117012921,5.866995203728769,5.3751667083478445,220949.4019607843,1,7,2,8,3,3,1,1.0,1,-1,0,0,2,0,0
55,5.246833407980764,5.47759057313968,5.355801256293924,5.059910933176677,5.261655298053709,5.878838859052739,5.360353434187735,175819.37606837606,1,E01000059,8,1,8,1,2,2,5.232894768130104,5.398395725016324,5.548176817174228,5.133548202379695,5.319683746346888,5.9064407528571365,5.244801002853322,222659.37735849057,1,8,3,8,3,3,0,1.0,0,0,2,0,2,1,-2
56,5.307326776640756,5.544662769351687,5.295342066458294,5.072266540889229,5.259706088474819,5.900210168744836,5.284945033490658,164944.3125,1,E01000060,9,0,8,0,3,1,5.245495043354905,5.483513988894546,5.35622620632045,5.143004193840185,5.25460004509732,5.853626722122129,5.264169693982453,207516.90871369294,1,9,1,8,2,2,0,1.0,0,0,1,0,2,-1,-1
57,5.108826995706883,5.6192482742322545,5.209364933221519,5.230604957561104,5.079290665736814,5.650817089340314,5.212260681755689,164846.87074829932,0,E01000061,9,0,9,0,0,0,5.221247003402239,5.530594278264929,5.261617062268434,5.2248300961506216,5.171840307889162,5.7638863398705,5.212500859189917,207389.97530864197,1,9,0,9,0,1,0,1.0,1,0,0,0,0,1,0
58,5.270169185996056,5.415091525316239,5.464596534967423,5.119807357788086,5.3251785439252854,5.981469208002091,5.4053986221551895,164886.815,1,E01000062,7,2,8,1,4,2,5.281664448125022,5.3665361705280485,5.471498324189867,5.142869904495421,5.359752529008048,5.950095400356111,5.32488963717506,207434.72857142857,1,7,2,8,4,4,1,1.0,0,0,0,0,3,0,-1
59,5.256708043813705,5.5188958704471585,5.46599330107371,5.0960592240095135,5.2335321545600895,5.884640304247538,5.401111205418904,166090.175,1,E01000063,8,2,8,0,3,2,5.247411770621936,5.402268586556117,5.514190763235092,5.188605546951294,5.197610612710317,5.864497882127762,5.3317936559518175,208843.30833333332,1,8,3,8,1,2,1,1.0,0,0,1,0,1,-1,-1
60,5.157608865091465,5.415905779640147,5.444941847116355,5.128539162194169,5.238908474077315,5.8032918016382515,5.336427050148881,164200.50335570468,0,E01000064,7,2,8,0,1,2,5.1845242847879245,5.351061291005238,5.445370220994374,5.11641009098076,5.227401576128351,5.838329613926899,5.29756037442081,206582.1626506024,0,7,2,7,1,2,0,1.0,0,0,0,-1,1,1,-2
61,5.306956199828736,5.464329624604322,5.395463820703015,5.1258906354447324,5.2520813677839175,5.848920982041045,5.340913018066726,166199.56886227545,1,E01000065,8,1,8,0,2,2,5.316219875167088,5.314822154809098,5.477476498698661,5.088738992069308,5.280825431834268,5.873361873363263,5.399329006342598,208969.8232044199,2,6,2,7,2,3,2,1.0,1,-2,1,-1,2,1,0
62,5.67933345910145,5.296580339226487,5.623001187371566,4.852942705154419,5.567247308957737,6.1909850520403396,5.419078881430519,158537.8071748879,5,E01000066,5,5,4,7,8,3,5.434336410740674,5.2345848012778715,5.439301229634528,5.049839441554021,5.34761297904839,6.04963276952,5.556131500813921,199966.4279661017,3,5,2,6,4,6,4,1.0,-2,0,-3,2,-3,-2,1
63,5.674421616155525,5.211167016933704,5.714682148448352,4.899142143027536,5.606695076514935,6.144325149470363,5.405621973091159,159344.9827586207,5,E01000067,4,6,5,7,7,2,5.502186077685396,5.1901980224719715,5.600094870102307,5.010147808997099,5.333161700363002,6.107527312168405,5.5780858225073695,200883.86776859505,4,4,4,6,3,7,5,1.0,-1,0,-2,1,-4,0,3
64,5.809168167788573,5.051748763431203,5.816826887805052,4.655524716232762,5.575735007873689,6.3397860093550245,5.770792884056014,163460.101010101,7,E01000068,1,7,1,7,9,8,5.627449357632509,5.072758941306281,5.7335316569534776,4.963614009090306,5.384835854019086,6.220241789965286,5.7481624416469295,206386.72164948453,6,2,7,5,5,9,8,1.0,-1,1,0,4,-2,0,0
65,5.745892991843047,5.107732069050824,5.733005196959884,4.841922527772409,5.60942404711688,6.278769795099894,5.578871262515032,160627.22962962964,6,E01000069,2,6,4,7,9,5,5.496583109948693,5.051195394702074,5.611094831451168,5.100568213113925,5.439234668646401,6.108614937076724,5.715697800240865,202169.0162601626,4,2,5,7,6,7,7,1.0,-2,0,-1,3,-1,-2,2
66,5.675346522540837,5.216577389738062,5.7458316159772345,4.795449939402905,5.51358163356781,6.184925936080597,5.594001225717775,160443.6978021978,5,E01000070,4,7,3,5,8,6,5.531194820048961,5.140644975165103,5.674497139580707,5.047868739417258,5.3310231813725,6.134715699134989,5.606265777603109,202220.92021276595,4,3,6,6,3,8,5,1.0,-1,-1,-1,3,-2,0,-1
67,5.450469223061049,5.244162655290151,5.622799721756422,4.908235957167741,5.38990264338565,6.108436968974296,5.484459491134379,165840.36416184972,3,E01000071,4,5,5,3,6,4,5.409415301595415,5.198129743848528,5.527777079854693,5.024338095528739,5.342069673538208,6.06926700592041,5.579544503348214,208860.78857142857,3,4,3,6,4,7,5,1.0,0,0,-2,1,1,1,1
68,5.1579985757206765,5.446626437726871,5.404626175414684,5.223246367402779,5.213693505109743,5.845148380412612,5.307341154231581,165634.72868217053,0,E01000072,7,1,9,0,2,1,5.0675865637710675,5.465619005408942,5.298608163602991,5.2464079716626335,5.043400657722374,5.773524634978351,5.397056285851921,207654.8496732026,0,9,0,9,0,1,2,1.0,0,2,-1,0,0,-1,1
69,5.413429168967514,5.365017766351098,5.425373317959072,5.093632662618482,5.29382661871008,5.941110149160162,5.469247425998653,158127.52252252251,2,E01000073,6,2,8,1,4,4,5.163128800079471,5.441161162540561,5.442454712312729,5.207358139460204,5.118412688130238,5.9536994109388255,5.361784943791687,199516.45901639343,0,8,2,9,0,4,1,1.0,-2,2,0,1,-1,0,-3
70,5.285861875897362,5.360514263879685,5.458444854191371,5.134672231901259,5.19559922785986,5.98695588566008,5.528311127708072,158263.20952380952,1,E01000074,6,2,8,0,4,5,5.0400742867897295,5.467731398755107,5.306242116566362,5.3352228803881285,5.060022476418265,5.844995402056595,5.250441851287053,199687.9051724138,0,9,0,9,0,2,0,1.0,-1,3,-2,1,0,-2,-5
71,5.482515802177099,5.4372522452702885,5.4446587568292255,4.937368179743107,5.486481487177885,6.058447949015177,5.420396622556907,164507.99038461538,3,E01000075,7,2,6,5,6,3,5.478948218729889,5.366178995775945,5.382667792653574,5.059715120537767,5.307940997545002,6.01774173106962,5.503321946245952,208243.53398058252,4,7,1,6,3,5,3,1.0,1,0,-1,0,-2,-1,0
72,5.1717722079692745,5.401764167679681,5.483050491055872,5.108929397713425,5.300125144485735,5.929617830830762,5.366694346452371,165595.94017094016,0,E01000076,7,3,8,1,3,2,5.046856937772136,5.499461470013958,5.432113710096327,5.253321795140282,5.117766151993962,5.824017997515404,5.303540969299058,210229.89830508476,0,9,2,9,0,2,1,1.0,0,2,-1,1,-1,-1,-1
73,5.175304935528682,5.3634707904778995,5.511528138930981,5.068490805534216,5.274295584513591,6.033932202137434,5.405498548195912,157938.33653846153,0,E01000077,6,3,8,1,5,2,5.031159887468911,5.465972339234701,5.37213354769761,5.209317685142765,5.124311255245674,5.774428241621188,5.256765477056426,199226.82113821138,0,9,1,9,0,1,0,1.0,0,3,-2,1,-1,-4,-2
74,5.130116707136651,5.495937916411071,5.395829979111166,5.073932065683253,5.267993398073341,5.869559284017868,5.268887298447745,159231.69747899158,0,E01000078,8,1,8,1,2,1,5.303703795016651,5.378516658930711,5.490755777123948,5.165686232942931,5.283668842114193,5.846796939070796,5.251173759010476,201586.77464788733,2,7,2,8,2,2,0,1.0,2,-1,1,0,1,0,-1
75,5.147845003154728,5.508612212601242,5.298487985884393,5.155853591598831,5.216154630367573,5.7694935615246115,5.289725228623077,166593.42657342658,0,E01000079,8,0,9,0,1,1,5.325636382355834,5.335014945629871,5.368008058179509,5.103866129210501,5.35617730292407,5.862950400872664,5.279114047686259,209521.21212121213,2,7,1,7,4,2,0,1.0,2,-1,1,-2,4,1,-1
76,5.053577595032179,5.563523240960562,5.386694552806707,5.147791679088886,5.176971637285673,5.8354867375814,5.266414196445392,161963.27884615384,0,E01000080,9,1,9,0,2,1,5.149759885552641,5.395566263756194,5.393001971306739,5.2972307127791565,5.253926899526026,5.765688193308843,5.2296088670755365,205855.1038961039,0,8,1,9,2,1,0,1.0,0,-1,0,0,2,-1,-1
77,5.017164082039059,5.54818903461216,5.333658911111787,5.248295202029972,5.187291554578646,5.80434946375569,5.252336549946643,166922.64566929135,0,E01000081,9,1,9,0,1,1,5.100851524877184,5.475014447255899,5.446910170198397,5.341115400081373,5.146076177822724,5.74638746712954,5.111195495110432,209824.2748091603,0,9,2,9,0,1,0,1.0,0,0,1,0,0,0,-1
78,5.256673381796905,5.492152397121702,5.48979386474405,5.209585035485881,5.293230754988534,5.884987062641552,5.357442369418485,166699.51785714287,1,E01000082,8,3,9,1,3,2,5.346503631635145,5.402096936919472,5.619410328431563,5.071237702803178,5.232638120651245,5.926254599744623,5.311076192422346,209606.9,2,8,5,7,1,4,1,1.0,1,0,2,-2,0,1,-1
79,5.358975513838232,5.490972346626222,5.541403081268072,4.981333543546498,5.3124861512333155,6.026522746309638,5.534798404201865,157223.890625,2,E01000083,8,3,6,1,5,5,5.28960165747425,5.4046616146439,5.634607980125828,5.177823229839928,5.216823498408,5.88560964768393,5.381620439521053,198446.00877192983,1,8,5,8,1,3,1,1.0,-1,0,2,2,0,-2,-4
80,5.311944027917575,5.27513656468518,5.584938758242447,5.048447806223304,5.29317839799729,5.935614117478902,5.348207706898714,171581.25663716815,1,E01000084,5,4,7,1,3,2,5.354071621346263,5.236356493646064,5.547476127084377,5.062192020163072,5.252022565993587,5.925477835984356,5.293497780782986,216569.13274336283,2,5,3,7,2,4,0,1.0,1,0,-1,0,1,1,-2
81,5.165041869594937,5.496838139163123,5.417832963050357,5.149475234841543,5.278558219236041,5.863757931996906,5.365788726579575,175175.50793650793,0,E01000085,8,2,9,1,2,2,5.223007829372699,5.359481561183929,5.450008208935078,5.061360013484955,5.256830165936397,5.886206032679631,5.373990021302149,221803.1,1,7,2,7,2,3,1,1.0,1,-1,0,-2,1,1,-1
82,5.1768036382366915,5.458626862728234,5.443093059038875,5.097442850922093,5.245523669502952,5.852108131755482,5.378510528140598,175478.41414141413,0,E01000086,8,2,8,0,2,2,5.197470579986219,5.380637806874734,5.514061190463878,5.112846786225283,5.289698009137754,5.920133400846411,5.222256509242235,222194.90740740742,1,8,3,7,2,4,0,1.0,1,0,1,-1,2,2,-2
83,4.9989297302757825,5.628376830641816,5.063654970831987,5.326319671258694,5.015095045653785,5.580058769481938,5.16833524369612,175290.21341463414,0,E01000087,9,0,9,0,0,0,5.081474541069626,5.591539799392997,5.11942727302576,5.327381524946783,4.89800207258819,5.626445405669027,5.2567470499447415,222004.16883116882,0,9,0,9,0,0,0,1.0,0,0,0,0,0,0,0
84,5.121294880581793,5.461489727563947,5.4311908561492634,5.2148856292261145,5.211351399109742,5.8348445691794995,5.478411861669238,174890.57009345794,0,E01000088,8,2,9,0,2,4,5.117734960317612,5.349505051374435,5.384409155845642,5.274262154102326,5.134006105661392,5.820149443149567,5.296775125265121,221405.38,0,7,1,9,0,2,0,1.0,0,-1,-1,0,0,0,-4
85,5.134283032417297,5.473140695095062,5.268815001249314,5.2659359395504,5.224077818393707,5.79647216796875,5.312716479301453,174629.78,0,E01000089,8,0,9,0,1,1,5.080513458985549,5.20581119450239,5.431958806056243,5.318166487492048,5.037380975026351,5.8776480280436,5.416262573920763,220997.63461538462,0,4,2,9,0,3,2,1.0,0,-4,2,0,0,2,1
86,4.854495610608611,5.8564557207878245,4.840776783089305,5.443690728656081,4.870175264255945,5.405017234211744,4.988202242310657,175040.60755813954,0,E01000090,9,0,9,0,0,0,4.877117367891165,5.679800267050252,4.893236371892444,5.40732419032317,4.759618955603718,5.462939695141019,5.214059958091149,221462.38461538462,0,9,0,9,0,0,0,1.0,0,0,0,0,0,0,0
87,5.236222267150879,5.648944164276123,5.36426690864563,5.165027387619019,5.267278171539306,5.860750548362732,5.130015933990479,169867.16,0,E01000091,9,1,9,1,2,0,5.215388816553396,5.494455146622824,5.44943020727251,5.120867946764806,5.271754512420068,5.911518436211806,5.267523472959345,213898.6853146853,1,9,2,8,2,3,0,1.0,1,0,1,-1,1,1,0
88,4.843594084086927,5.740706900948459,4.8982063441214825,5.5120058603657105,4.927395180783997,5.3869085502855985,4.835637071564745,170422.77508090614,0,E01000092,9,0,9,0,0,0,5.00652183008089,5.588628537197995,5.057415620083326,5.357210838584648,5.021383792555805,5.545400220917185,5.101109582159488,214978.83370044053,0,9,0,9,0,0,0,1.0,0,0,0,0,0,0,0
89,5.165526854004829,5.625526517819447,5.243833912405998,5.2547581674187045,5.165879577588123,5.741729599655054,5.151228905483416,169646.42675159237,0,E01000093,9,0,9,0,1,0,5.194924499359599,5.483590531934259,5.328494613155997,5.141007617207393,5.2928635452422625,5.8218229241166375,5.2204408828466216,213109.86503067485,1,9,1,8,2,2,0,1.0,1,0,1,-1,2,1,0
90,5.098489483400267,5.713664268352548,4.823782745064522,5.38199614931126,5.09824487627769,5.51167765503027,4.871834778055852,174762.2193877551,0,E01000094,9,0,9,0,0,0,5.2275157656755535,5.520132399357117,5.0888627370198565,5.267450455609743,5.160233460568093,5.64344780187349,5.223145670181996,220846.0045045045,1,9,0,9,0,0,0,1.0,1,0,0,0,0,0,0
91,4.848468341125523,5.927924626875719,4.683457037566826,5.5124901954610355,4.885399004939113,5.3329224145104925,4.776761219063731,176429.71927162368,0,E01000095,9,0,9,0,0,0,4.973068282794565,5.844840230090047,4.830643922776105,5.485918719165219,4.818473166477374,5.414667860419566,4.98193806482426,223397.58457374832,0,9,0,9,0,0,0,1.0,0,0,0,0,0,0,0
92,4.885604629516601,5.722217133045197,4.881075152754784,5.435626736879349,5.001902602910995,5.389166425466538,4.840984187722206,175269.28,0,E01000096,9,0,9,0,0,0,4.937209721155993,5.670419241969041,5.045095376142367,5.371720413523396,4.996208873320752,5.519120104200258,5.018378529492326,221690.1062992126,0,9,0,9,0,0,0,1.0,0,0,0,0,0,0,0
93,5.3498628278573355,5.595623635252317,5.47767384548982,5.132133341828982,5.342019341389338,5.930277190605799,5.4614640295505525,156005.94166666668,1,E01000097,9,2,8,2,3,3,5.1371475177652695,5.465099754578927,5.43521756372031,5.270796535646214,5.225739088128595,5.863783077282064,5.295255231506684,196814.36029411765,0,9,2,9,1,2,0,1.0,-1,0,0,1,-1,-1,-3
94,5.299960548227483,5.523762997352716,5.5137814084688825,4.958167106816263,5.2916866414474715,6.015993811867454,5.402250849839413,156340.18181818182,1,E01000098,8,3,6,1,5,2,5.1336656048793925,5.416434032004951,5.4249695211448925,5.187458191141986,5.206549624468656,5.859651858374576,5.337304828150961,197254.06040268455,0,8,2,8,1,2,1,1.0,-1,0,-1,2,0,-3,-1
95,5.2194018824191035,5.619640078725694,5.399322071407415,5.112703625159927,5.218367249905309,5.812775755984874,5.324531568002097,158723.35443037975,0,E01000099,9,1,8,0,2,1,5.154373134126757,5.504030399983472,5.458003786530825,5.2260474958042105,5.237614085178564,5.843894264485576,5.242451851320739,200298.33663366336,0,9,2,9,1,2,0,1.0,0,0,1,1,1,0,-1
96,5.399045320314782,5.433341461921406,5.518133820774399,5.050146085079585,5.2905418482896325,5.886797272156332,5.424716640855665,166886.261682243,2,E01000100,7,3,7,1,3,3,5.305146572089964,5.406186904638044,5.5574360393708755,5.128921918330654,5.322350589498397,5.952902607379421,5.497888223778817,209838.38709677418,2,8,4,8,3,4,3,1.0,0,1,1,1,2,1,0
97,5.30204474484479,5.445453889943935,5.425562995451468,5.1394383465802225,5.186034035903436,5.848315309595178,5.350202988695215,166344.41666666666,1,E01000101,7,2,9,0,2,2,5.157882407195586,5.475851051789477,5.404455606202434,5.2167176259191415,5.175985498535902,5.83634913326206,5.3781027354692155,209158.53383458647,0,9,1,9,0,2,1,1.0,-1,2,-1,0,0,0,-1
98,5.261066041646465,5.461808455567206,5.507898215324648,5.092366657910809,5.285868868712456,5.917977656087568,5.302313003809221,159769.8306451613,1,E01000102,8,3,8,1,3,1,5.277938043834358,5.361572370623911,5.465606766820743,5.184715947568022,5.232083904822141,5.8617207214532305,5.332046028794042,201831.1655629139,1,7,2,8,1,2,1,1.0,0,-1,-1,0,0,-1,0
99,5.0189498122781515,5.768369376659393,5.068964680035909,5.383664167796572,5.108392719179392,5.5544339294234915,4.8983269824335975,173722.046875,0,E01000103,9,0,9,0,0,0,5.19944121837616,5.515636251866818,5.251500684022903,5.244016701728105,5.235910779237747,5.710728249698877,5.095151157677174,219661.6625,1,9,0,9,1,0,0,1.0,1,0,0,0,1,0,0
100,5.018141106007591,5.620803543499538,5.12741446116614,5.277542231574891,5.074858276616959,5.633102717853728,5.066376390911284,173917.68253968254,0,E01000104,9,0,9,0,0,0,5.255985811904624,5.3791424857245556,5.32264751151756,5.214487355726736,5.285018361056292,5.852193726433648,5.321123094028897,220054.31851851853,1,8,0,9,2,2,1,1.0,1,-1,0,0,2,2,1
101,5.145745116013747,5.472050712658809,5.3088815230589645,5.2330002051133375,5.233844493902646,5.798980259895325,5.140955634300525,166728.4846153846,0,E01000105,8,1,9,0,1,0,5.24230687881445,5.383970010590244,5.440701749417689,5.144458122841724,5.241924014958468,5.809800770375635,5.273257072095747,210212.33116883118,1,8,2,8,1,2,0,1.0,1,0,1,-1,1,1,0
102,5.144390907901072,5.642600621396338,5.168823074876216,5.269629721753081,5.230853181136282,5.6608904544373,5.033212621309604,165994.9356725146,0,E01000106,9,0,9,0,0,0,5.24384490285601,5.429355637005397,5.361439403806414,5.129895609446934,5.213173920767648,5.783066832678658,5.19464402948107,208800.17142857143,1,8,1,8,1,1,0,1.0,1,-1,1,-1,1,1,0
103,5.1146719816119175,5.554772970288298,5.298010913438575,5.264330158399981,5.154458621213602,5.818517752858096,5.166615450798079,173363.76744186046,0,E01000107,9,0,9,0,2,0,5.283754607975083,5.322509359193329,5.476845760473469,5.144725045901817,5.399651775424112,5.9524202442809235,5.30270570396577,219324.90604026846,1,7,2,8,5,4,1,1.0,1,-2,2,-1,5,2,1
104,5.120630002559576,5.452155952166794,5.285559761793094,5.262776107716381,5.155326899729277,5.727273811971335,5.221614282830317,170062.42857142858,0,E01000108,8,0,9,0,1,0,5.218342999458313,5.267427910804749,5.462126762390136,5.131453870773315,5.233997436523437,5.866525688171387,5.339974472999573,214718.016,1,6,2,8,1,3,1,1.0,1,-2,2,-1,1,2,1
105,5.112401800090764,5.517244437924859,5.331927547649461,5.258341140487567,5.130586113248553,5.7691240456639505,5.176666842836912,164877.7074829932,0,E01000109,8,1,9,0,1,0,4.9328023532787,5.38114745214761,5.315134620092001,5.410538490996303,5.126696537776166,5.721630224262375,5.179617129176496,208041.59638554216,0,8,0,9,0,1,0,1.0,0,0,-1,0,0,0,0
106,5.34733916024367,5.3818256268898645,5.49543492992719,5.0253899474938715,5.2898061593373615,5.94822634657224,5.3076105107863745,150186.2,1,E01000110,7,3,7,1,4,1,5.295161829731328,5.361233714150219,5.5229585093211355,5.066718078241116,5.106126180509242,5.961759086546859,5.462304680328059,189605.9024390244,1,7,3,7,0,4,3,1.0,0,0,0,0,-1,0,2
107,5.246157467973475,5.529435317735283,5.390659547581965,5.143584669244532,5.251692233645186,5.7771012941185305,5.171332095958749,159789.3724489796,1,E01000111,8,1,9,0,1,0,5.126897214232264,5.442321502947593,5.299188258948627,5.26059411989676,5.054797547357577,5.736742771960594,5.175018051723102,201659.79279279278,0,8,0,9,0,1,0,1.0,-1,0,-1,0,0,0,0
108,5.131779803858175,5.345709846391307,5.4245670832596815,5.099524807620358,5.224844767675771,5.810195442143973,5.216863262188899,152915.03896103895,0,E01000112,6,2,8,0,2,0,5.107685652918786,5.318079336634222,5.403502031692169,5.203787145374706,5.095665376141386,5.767379804227337,5.233287737054645,193084.27672955976,0,6,1,9,0,1,0,1.0,0,0,-1,1,0,-1,0
109,5.189832458645105,5.2992478787899016,5.446233424544334,5.196332058310508,5.308614605665207,5.774215136468411,5.115197218954563,154063.4375,0,E01000113,5,2,9,1,1,0,5.129048943519592,5.3523056708103,5.3821890790795175,5.238037968097731,5.144321985716044,5.725910397463067,5.23598801881768,194274.15697674418,0,7,1,9,0,1,0,1.0,0,2,-1,0,-1,0,0
110,5.139533771408929,5.465981398688422,5.444185612599055,5.272928920057085,5.2698334601190355,5.818638973765903,5.227092778682708,165561.74444444446,0,E01000114,8,2,9,1,2,0,4.98985256404473,5.435225567489705,5.335021413823284,5.352528498286293,5.100529963377292,5.745504099855978,5.301931853016848,208241.6349206349,0,8,1,9,0,1,1,1.0,0,0,-1,0,-1,-1,1
111,5.944492631488377,5.312154623566482,5.673419473032472,4.812843503144683,5.685760993175406,6.182134195610329,5.819880745398304,448052.5291005291,8,E01000115,5,6,3,9,7,9,5.908101503382024,5.248067502508459,5.767792623067639,4.7559924574242425,5.625922222727353,6.274722427436986,5.889082974379825,573035.9278350516,8,5,7,1,9,9,9,1.0,0,0,1,-2,0,2,0
112,5.916470251720527,5.2945588981283125,5.716575773111705,4.858881757177156,5.649006111868497,6.23629013423262,5.670562639318663,448462.2155172414,8,E01000116,5,6,4,8,8,7,5.930659229979922,5.08561392642992,5.768368778741948,4.713225544300849,5.655559349487715,6.305150399828171,5.801051622014409,573567.3587443946,9,3,7,0,9,9,8,1.0,1,-2,1,-4,1,1,1
113,5.433950174529597,5.545990964151779,5.410734122654177,5.0242525935173035,5.352405711165014,5.878096549016125,5.408048353667529,449327.6698113208,2,E01000117,9,1,7,2,2,3,5.428534523712541,5.396026281133357,5.489736146009118,4.932478010903841,5.354379375609394,5.941900429865306,5.487986127701763,574855.1464435146,3,8,2,4,4,4,3,1.0,1,-1,1,-3,2,2,0
114,5.673337154918247,5.355180652821121,5.689511847380855,4.917590773048032,5.486200634408112,6.178375126659006,5.614042050020706,449988.01932367147,5,E01000118,6,6,5,5,7,6,5.632827643611005,5.241656056348829,5.6709617278426165,4.896390135161543,5.4928354186136366,6.164255143363695,5.74811713764633,575424.0579710145,6,5,6,3,7,8,8,1.0,1,-1,0,-2,2,1,2
115,5.672702760994435,5.268221155554056,5.712118598818779,4.922166039049626,5.507194392383099,6.162604662775993,5.798406402021646,448860.2125,5,E01000119,5,6,5,5,7,8,5.481877953355963,5.293793110413985,5.704934716947151,5.037623210386797,5.433587522217722,6.066599614692457,5.666771294131424,574629.6848484848,4,6,6,6,6,6,6,1.0,-1,1,0,1,1,-1,-2
116,5.591411915692416,5.269316406993123,5.706827792254361,5.002556210214442,5.498976368408699,6.127007708921061,5.761493308203561,448338.0,4,E01000120,5,6,7,5,7,8,5.395612761179606,5.168683299223582,5.7320534054438275,5.0151836546262105,5.333005052407582,6.047538803418477,5.767871731122335,573218.0733333334,3,4,7,6,3,6,8,1.0,-1,-1,1,-1,-2,-1,0
117,5.622948169708252,5.596465653022833,5.432593938523689,4.935068105174377,5.409138979110042,5.971878659408705,5.355365997922104,451616.80530973454,5,E01000121,9,2,6,3,4,2,5.523203002779107,5.4758963109855365,5.35974044907362,5.044873287803249,5.28035773280868,5.911839280809675,5.487022565719776,577908.9398496241,4,9,1,6,2,3,3,1.0,-1,0,-1,0,-1,-1,1
118,5.814694785829728,5.368953970483112,5.6920511081134,4.869127661443604,5.566447143022179,6.183976788206149,5.736547265561099,451228.9137055838,7,E01000122,6,6,4,7,8,8,5.577995969832522,5.318947648539127,5.643642506553132,5.077723698708618,5.43164849975734,6.076037252412259,5.640516916525017,577386.9126213592,5,6,5,7,6,7,6,1.0,-2,0,-1,3,-1,-1,-2
119,5.7826506822973816,5.288770832203247,5.571651545199719,4.79072081387698,5.533007240557408,6.090774542682773,5.5199792581600144,452592.532967033,6,E01000123,5,4,3,6,6,4,5.705787759601024,5.420198902749179,5.389720455073474,4.90126157225224,5.447214089464723,5.977901111569321,5.473772577026434,579053.8333333334,7,8,1,3,6,5,3,1.0,1,3,-3,0,0,-1,-1
120,5.517352288554174,5.369077094593403,5.494652056545945,4.935726141337282,5.387684177167667,5.847667332761777,5.311182495229733,453196.2546583851,3,E01000124,6,3,6,3,2,1,5.254464529178761,5.436237214524069,5.279709203007781,5.1776297372064475,5.219564096427258,5.732230159971449,5.274476431770089,579986.4074074074,1,8,0,8,1,1,0,1.0,-2,2,-3,2,-2,-1,-1
121,5.121652531905992,5.56702577221323,5.229275034729546,5.1980263855330335,5.193186209752009,5.651116785918467,5.213187331984029,105002.65680473374,0,E01000125,9,0,9,0,0,0,5.236145136091444,5.390464827749464,5.38083568877644,5.151519774066077,5.247253397438262,5.720837571223577,5.191618240541882,120181.16666666667,1,8,1,8,2,1,0,1.0,1,-1,1,-1,2,1,0
122,5.3688307850300765,5.412317728795925,5.342489711376799,5.105524554973891,5.279889123780387,5.748975505348013,5.107769479270742,480081.6386554622,2,E01000126,7,1,8,1,1,0,5.378996539891251,5.453477073491104,5.427146209933894,5.143105604784275,5.356537832477229,5.800171410165182,5.207249858515049,614604.6341463415,2,8,2,8,4,1,0,1.0,0,1,1,0,3,0,0
123,5.798266985837151,5.398730765370762,5.454684479563844,4.852950311174579,5.526044319657719,6.064765030262517,5.495434747022741,480991.50980392157,7,E01000127,7,2,4,6,6,4,5.756136349269322,5.368002697661683,5.468106610434396,4.890195921227172,5.496475365135696,6.041064031831511,5.53193569445348,615676.9230769231,7,7,2,3,7,6,4,1.0,0,0,0,-1,1,0,0
124,5.509073017416774,5.360069921693286,5.370566927097939,5.014576008996448,5.42098688918191,5.892175147662291,5.430530921027467,481014.95945945947,3,E01000128,6,1,7,3,3,3,5.460566661075542,5.429873893135472,5.42306056383409,5.055764911990416,5.322319782878223,5.888777806570656,5.413397373337495,615773.2039473684,4,8,1,6,3,3,2,1.0,1,2,0,-1,0,0,-1
125,5.327599034921543,5.310435531912623,5.491551452391857,5.074830403199067,5.284559195911562,5.752632687220702,5.2302267470875305,422101.38513513515,1,E01000129,5,3,8,1,1,1,5.349687655519995,5.21864546529995,5.553679100474956,5.037231708905711,5.168353772311477,5.7389024022203055,5.215687414133771,514558.5900621118,2,5,4,6,0,1,0,1.0,1,0,1,-2,-1,0,-1
126,5.586253043879633,5.47319902026135,5.461283731460571,5.005089224939761,5.418714088978975,5.951144894309666,5.418633449595908,480282.8782608696,4,E01000130,8,2,7,3,4,3,5.560472980433819,5.454579187374489,5.553497153169968,4.900569995244344,5.401961861872206,6.0620888424854655,5.6238961921018715,614826.8039215687,5,8,4,3,5,6,6,1.0,1,0,2,-4,2,2,3
127,5.720973453414974,5.241712755231715,5.646313291877063,4.875338719851935,5.462242510781359,6.024862878358186,5.6648707710095305,480001.1119402985,6,E01000131,4,5,4,4,5,7,5.566040911497893,5.192040456665887,5.586079791740135,5.008479113048978,5.400329392927664,6.0253282635300245,5.609744420758,614122.4444444445,5,4,4,5,5,6,5,1.0,-1,0,-1,1,1,1,-2
128,5.522810765840475,5.491423660111659,5.408877701435275,4.966065777158274,5.374033367749557,6.04795503616333,5.425714536777978,480952.2912621359,3,E01000132,8,1,6,2,5,3,5.397343174319401,5.363366934740655,5.448154866138351,5.0506260829551195,5.401712448797493,5.955177166751612,5.42239629108215,615579.355140187,3,7,2,6,5,4,2,1.0,0,-1,1,0,3,-1,-1
129,5.5712275120519825,5.413977403794566,5.433027253996942,4.870050039983565,5.323181424410112,6.008578663872134,5.483015994871816,480327.0564516129,4,E01000133,7,2,4,1,5,4,5.5524928115663075,5.477071400672671,5.52460727805183,4.971286731106894,5.51794771921067,6.001288998694647,5.411515643672337,614870.4603174604,5,9,3,5,8,5,2,1.0,1,2,1,1,7,0,-2
130,5.599463658297763,5.461618363857269,5.412412482149461,4.956663365749752,5.415934481164989,5.91278759170981,5.40845762982088,292094.9926470588,4,E01000134,8,2,6,3,3,3,5.548275265231061,5.33889094395424,5.481720981313221,4.954321346176204,5.3920496960184465,5.941856647605326,5.437006370345158,370292.8134328358,5,7,2,4,5,4,2,1.0,1,-1,0,-2,2,1,-1
131,5.939760158091415,5.198254617643945,5.688128648716726,4.753727174099581,5.5949990550676985,6.156082332870106,5.738273691983871,466910.6296296296,8,E01000135,3,6,2,7,7,8,5.776064219817616,5.172074773732354,5.679514735352759,4.819930924309625,5.472274741316153,6.219591658099804,5.855145298577602,597164.2026143791,7,4,6,2,7,9,9,1.0,-1,1,0,0,0,2,1
132,6.292453767548145,5.112541845147039,5.744386521863266,4.589813858130728,5.749231872424273,6.212257156909351,5.812365765862622,466464.1502347418,9,E01000136,2,7,0,9,8,9,6.097286488215128,5.148034974733989,5.648131459024217,4.727285321553548,5.566292212274339,6.125337891048855,5.84006975279914,596182.4177777778,9,4,5,0,9,7,9,1.0,0,2,-2,0,0,-1,0
133,5.575372536977132,5.3581703787758235,5.575597834019434,4.8707160992281775,5.355027914047241,6.048602952843621,5.468398759762446,466878.40476190473,4,E01000137,6,4,4,2,5,4,5.455222968445268,5.29956793092018,5.537005084891652,5.03421937171803,5.320493329403012,5.986389154611632,5.507486749527066,597274.8139534884,3,6,3,6,3,5,3,1.0,-1,0,-1,2,1,0,-1
134,5.658244648948312,5.339863802306354,5.634848672896624,4.816241173073649,5.4893908938393,6.090624475851655,5.6493255235254765,465363.8046875,5,E01000138,6,5,3,5,6,7,5.437957638544394,5.237906587039325,5.644145664593852,5.050611400435157,5.248776889861898,6.004264145032734,5.722937726805396,595341.340425532,3,5,5,6,2,5,7,1.0,-2,-1,0,3,-3,-1,0
135,5.8836325310558255,5.224013642079568,5.6302884210740896,4.853544652806542,5.592619832540523,6.088790613791846,5.690563611901564,472069.23121387284,7,E01000139,4,5,4,7,6,7,5.618901441606243,5.242676326398099,5.598501035336698,4.920852934376577,5.376947053362814,6.034962356760261,5.734519158186537,603964.0280898877,6,5,4,4,4,6,7,1.0,-1,1,-1,0,-3,0,0
136,5.756215777397156,5.174341157913208,5.735092584609985,4.839240282058716,5.503300610542297,5.997462244987488,5.57208193397522,469808.6,6,E01000140,3,6,4,5,5,5,5.529167121456515,5.015399269519314,5.672917990915237,4.978019088506699,5.451765098879414,5.86273693653845,5.592627539750068,600674.3548387097,4,2,6,5,6,2,5,1.0,-2,-1,0,1,1,-3,0
137,5.442825151387082,5.196619083163559,5.541700545818575,5.004192392672262,5.341861399912065,5.799807730541434,5.319122562485356,471636.311827957,2,E01000141,3,3,7,2,1,1,5.295043844590213,5.281204892989786,5.484175529071991,5.124082902536035,5.198684619072287,5.714731913836882,5.332021002463478,603666.1122994652,1,6,2,8,1,0,1,1.0,-1,3,-1,1,-1,-1,0
138,5.633199405339029,5.3376942235562534,5.595140920745002,5.029084149334166,5.440198541515404,6.056849358810319,5.509979897903071,463568.15277777775,5,E01000142,6,4,7,4,6,4,5.474142708118607,5.3220890715437115,5.499757187921296,5.069966407691908,5.357939040136038,6.024687900483233,5.7321339515770005,593019.0566037736,4,7,3,7,4,6,7,1.0,-1,1,-1,0,0,0,3
139,5.5727149209250575,5.401826042196025,5.593303493831469,4.907175483910934,5.324032460865767,6.039680859316951,5.464709486650384,473687.92391304346,4,E01000143,7,4,5,1,5,4,5.330790542592906,5.400252011087206,5.502901260298912,5.078737328750918,5.283633354938392,5.986248478744969,5.54958800836043,606049.1515151515,2,8,3,7,2,5,4,1.0,-2,1,-1,2,1,0,0
140,5.870713940402806,5.07940238674215,5.845905492769792,4.713085648997518,5.637039226173554,6.205753988867638,5.598509318076524,466515.0805369128,7,E01000144,2,8,1,8,8,6,5.446896327866448,5.09346979111433,5.643724163373311,4.992389025787513,5.409909874200821,6.030055368940036,5.597507397333781,597118.1458333334,3,3,5,5,5,6,5,1.0,-4,1,-3,4,-3,-2,-1
141,5.876410110728947,5.214140746537156,5.702663742651151,4.8248317635904145,5.4800650529035435,6.2278572011181685,5.631523472117626,464711.4409448819,7,E01000145,4,6,3,5,8,6,5.670862923376262,5.0938780987635255,5.646920263767242,4.909433166496456,5.380713250488043,6.199942797422409,5.820865140296519,594387.453125,6,3,5,3,5,8,8,1.0,-1,-1,-1,0,0,0,2
142,5.811985910264521,4.9586678163601405,5.9611585895871855,4.763669374210587,5.549071242900494,6.130704217921189,5.656137156356228,466489.78142076504,7,E01000146,1,9,2,6,7,7,5.67873271034985,4.901835152579517,5.848204234169751,4.87721278202243,5.455176302863331,6.033525305841027,5.714775531466414,596878.1414634146,6,0,8,3,6,6,7,1.0,-1,-1,-1,1,0,-1,0
143,5.620617765099255,5.16326024816997,5.597183138576906,4.907488653908914,5.460102166702498,6.0342100396085145,5.635260090899112,472245.5671641791,5,E01000147,3,4,5,4,5,6,5.532219925182778,5.135513044043675,5.69219348334626,5.001539791990447,5.389980060142158,5.984348384325936,5.564570509347339,604198.100671141,4,3,6,5,5,5,4,1.0,-1,0,2,0,1,0,-2
144,5.197179261654142,5.287714106695993,5.459920620161389,5.083641220652868,5.2385455123961915,5.787974730370537,5.243496617627522,473937.21428571426,0,E01000148,5,2,8,0,1,1,5.144773227603812,5.259380216661253,5.551742904280362,5.185511397688012,5.2078560535845,5.779860298884542,5.31267717715941,606769.802631579,0,5,4,8,1,1,1,1.0,0,0,2,0,1,0,0
145,5.3317758556944215,5.480878689709832,5.439268224379596,5.068751914468826,5.2504791776519015,5.8510908821589265,5.400282362467563,471745.35294117645,1,E01000150,8,2,8,0,2,2,5.3131795343198736,5.368880494544495,5.452272322624242,5.145168431817669,5.284607388113187,5.805264791941534,5.338770543603593,603520.9178082192,2,7,2,8,2,2,1,1.0,1,-1,0,0,2,0,-1
146,5.655381811198904,5.472627102439083,5.343481832475804,4.8731433188737325,5.480558238812347,5.844209372107662,5.244733022220099,478725.0895522388,5,E01000151,8,1,4,5,2,1,5.473641044215152,5.454698598698566,5.3454903442608686,5.133455888221138,5.297481913315623,5.629223042412808,5.154318608735737,612913.1184210526,4,8,1,8,2,0,0,1.0,-1,0,0,4,-3,-2,-1
147,5.548529071382957,5.599092160121049,5.264172886857892,5.054668720405881,5.3482000686154505,5.794605167785494,5.083857105510069,478732.57425742573,4,E01000152,9,0,7,2,1,0,5.595700503389041,5.526631285746892,5.366799755891164,5.029186669985453,5.410967624187469,5.828467808167139,5.333849926789601,612908.1666666666,5,9,1,6,5,2,1,1.0,1,0,1,-1,3,1,1
148,5.5110699394169975,5.508252232682471,5.394425403838064,4.988044313355988,5.422742658970403,5.796865874645757,5.2182778751148895,479377.96078431373,3,E01000153,8,1,6,3,1,0,5.543445401487097,5.465250765327859,5.438651772726954,5.010523801356291,5.409430208459365,5.806273373882328,5.433307581243262,613725.6283185841,5,9,2,6,5,2,2,1.0,2,1,1,0,2,1,2
149,5.4300348401069645,5.519664895534516,5.324822650353114,5.055359705289205,5.3054667929808295,5.674043575922648,5.130866732199987,478897.93333333335,2,E01000154,8,1,7,1,0,0,5.109141702122159,5.471126205391354,5.37552920182546,5.288428322474162,5.225636117988163,5.668927070829604,5.217784949143728,613123.4222222222,0,9,1,9,1,0,0,1.0,-2,1,0,2,0,0,0
150,5.510598049658101,5.392598369499532,5.389651819700148,5.019601621278903,5.439735062965533,5.867077160172347,5.409427673351474,479442.14634146343,3,E01000155,7,1,7,4,2,3,5.51843575835228,5.226378201842308,5.663837512731552,4.983144332170486,5.504049042463302,6.01448202252388,5.564825900197029,613881.29,4,5,6,5,8,5,4,1.0,1,-2,5,-2,4,3,1
151,5.837684073050817,5.148424968123436,5.845705143610636,4.738155181209247,5.499904834230741,6.275979040066401,5.787346985936165,409077.175,7,E01000156,3,8,2,5,8,8,5.71982991596884,5.029012076125658,5.81288621839413,4.8580673253240665,5.434806443442983,6.166375162187687,5.759080694726676,521879.80165289255,7,2,8,2,6,8,8,1.0,0,-1,0,0,1,0,0
152,5.763236118498303,5.290346159253802,5.660540278752645,4.750196242332459,5.455008561270578,6.133104167665754,5.674778293427967,408563.02857142856,6,E01000157,5,5,2,4,7,7,5.609619597593944,5.055394146526069,5.660282193568715,4.971672508800239,5.33980431473046,6.045678289313066,5.63583172831619,521317.8245614035,5,2,6,5,3,6,6,1.0,-1,-3,1,3,-1,-1,-1
153,5.9624623605447225,5.204465599023094,5.7063843686451285,4.7517416541890585,5.644418688707574,6.240480289902798,5.5928731325060825,452194.1937984496,8,E01000158,4,6,2,8,8,6,5.778651219367981,5.186667922019958,5.621433568954468,4.8363105545043945,5.431809888839721,6.161849271774292,5.648169781684875,578565.072,7,4,5,2,6,8,6,1.0,-1,0,-1,0,-2,0,0
154,6.036723476011776,5.279767752851098,5.710199964856638,4.645803398877671,5.7234959301439305,6.265415992551637,5.754455621960093,453349.28155339806,8,E01000159,5,6,0,9,8,8,5.749856465325063,5.326308124527639,5.566825359451528,4.888431108727747,5.477576183421271,6.114333974463599,5.6955481469631195,580208.7295918367,7,7,4,3,7,7,7,1.0,-1,2,-2,3,-2,-1,-1
155,5.804291816746316,5.276227818756569,5.597058521538246,4.850797322465152,5.527873406322991,6.089718954592216,5.653343814175304,441687.5487804878,7,E01000160,5,4,4,6,6,7,5.625127226114273,5.353186935186386,5.536089125352028,4.979338835447263,5.309160439631878,6.026126870742211,5.556798231143218,564232.7692307692,6,7,3,5,3,6,4,1.0,-1,2,-1,1,-3,0,-3
156,5.78321350812912,5.210721434865679,5.702145886421204,4.843057285887855,5.533202697549547,6.118070123876844,5.617035192251206,449883.95714285714,6,E01000161,4,6,4,6,7,6,5.614353649543993,5.164347590099681,5.62918804920081,4.97289011333928,5.353135768572489,6.04307620453112,5.633055884187872,576103.6303030303,5,4,5,5,4,6,6,1.0,-1,0,-1,1,-2,-1,0
157,5.712171873817705,5.153362721613009,5.819975345102075,4.8313822403346025,5.54692901160619,6.144519835302274,5.590861015940366,429893.0068493151,6,E01000162,3,7,4,6,7,6,5.480576784495848,5.0774374719125674,5.746918798929237,4.889594078063965,5.313522653407361,6.0085409348269545,5.662208258387554,551957.6144578314,4,2,7,3,3,5,6,1.0,-2,-1,0,-1,-3,-2,0
158,5.582771987800139,5.589410287788115,5.34121760546443,4.988719255091196,5.363655213131962,5.874482166336243,5.3503483117344866,408766.6144578313,4,E01000163,9,1,6,2,2,2,5.52508570096072,5.514826292150161,5.300103144084706,5.0344691402771895,5.2206940482644475,5.782542148758384,5.293374664643231,521557.03529411764,4,9,0,6,1,1,0,1.0,0,0,-1,0,-1,-1,-2
159,5.53117974318904,5.573514335877668,5.170075736105194,5.08088957669824,5.297724426534661,5.7638591898922105,5.246387133954472,409341.51867219916,3,E01000164,9,0,8,1,1,1,5.369644208847423,5.538876357432389,5.153991449005612,5.183416256635012,5.112514956258632,5.668805110580929,5.21584509750137,522228.18374558305,2,9,0,8,0,0,0,1.0,-1,0,0,0,-1,-1,-1
160,5.655955904937652,5.538482951830669,5.430014047277979,5.013702202992267,5.400442891092186,5.919864824019283,5.445814490318298,412590.078313253,5,E01000165,9,2,7,3,3,3,5.542021163919354,5.495792165645578,5.295361324568479,5.080634518222914,5.3247779765840395,5.920536049163144,5.506116473213744,526130.9116022099,5,9,0,7,3,4,3,1.0,0,0,-2,0,0,1,0
161,5.640564090904149,5.442276037972549,5.430574977534941,4.848707793772905,5.498997808187857,5.989642844803032,5.560200347982604,452511.9885057471,5,E01000166,7,2,4,5,4,5,5.792981362095769,5.331430440739647,5.611623723272215,4.766690367861733,5.566465202390839,6.116781431158589,5.708772932927226,579163.7150259067,7,7,5,1,9,7,7,1.0,2,0,3,-3,4,3,2
162,5.740925689189755,5.523789218991821,5.405865761271694,4.843854768931517,5.464520019397401,5.962107913535938,5.552301413134525,456456.8947368421,6,E01000167,8,1,4,4,4,5,5.898152929268136,5.322420443130644,5.61343707627808,4.735902129419592,5.610390697883455,6.160831629835217,5.757247589281853,584451.8543046358,8,7,5,0,9,8,8,1.0,2,-1,4,-4,5,4,3
163,5.675258206255609,5.374822276264595,5.5573231987447045,4.902009840784126,5.547440599462839,6.093274352936771,5.546659462944755,449509.9888268156,5,E01000168,6,4,5,6,6,5,5.697660598261603,5.351620597400885,5.668173692692285,4.906722423674046,5.522898342417575,6.155264799622284,5.622984087330171,575155.0229885058,6,7,6,3,8,8,6,1.0,1,1,2,-2,2,2,1
164,5.805073612266117,5.3608117989367905,5.532756442825,4.767120842304495,5.594583373930719,6.071658492088318,5.757331892020172,455270.59027777775,7,E01000169,6,3,2,7,6,8,5.7149442053855735,5.228809644144477,5.586351285589502,4.895252883011568,5.529262119996632,6.1179633918383445,5.752386640149651,582856.1205673759,7,5,4,3,8,7,8,1.0,0,-1,1,1,1,1,0
165,5.5202298876715865,5.525921144136569,5.432518242335901,5.01530593415586,5.3430983416917845,5.976720914608094,5.561679240407013,455642.65853658534,3,E01000170,8,2,7,2,4,5,5.521813049282827,5.361694509714422,5.4716118725252825,4.935465748041448,5.386945611994031,6.025533941430106,5.540753332661911,582930.485915493,4,7,2,4,5,6,4,1.0,1,-1,0,-3,3,2,-1
166,5.284030267646193,5.34318805873061,5.424657009167378,5.046090306516466,5.321878659658592,5.795008044003108,5.359409580017601,458574.5754189944,1,E01000171,6,2,7,1,1,2,5.295694131424973,5.240131294927117,5.521110089797547,5.0460986784716555,5.35771635990569,5.820735371312615,5.254015321172149,586781.1340782123,1,5,3,6,4,2,0,1.0,0,-1,1,-1,3,1,-2
167,5.781233823561406,5.428117923684173,5.542861113836477,4.882792863217029,5.582036809606866,6.114880196340791,5.58889276771755,448752.3021978022,6,E01000172,7,3,4,7,7,6,5.727184815406799,5.290898233822414,5.593740303856986,4.851947000367301,5.466872719355992,6.147488580431257,5.7392949281420025,573959.76,7,6,4,2,7,8,7,1.0,1,-1,1,-2,0,1,1
168,5.600699174042904,5.338277751026731,5.603604607148604,4.942403649561333,5.469578438094168,6.028115243622751,5.470401921416774,449550.5272727273,4,E01000173,6,4,6,4,5,4,5.586069247334502,5.279084025981814,5.590197122928708,5.0001382927561915,5.3603739056476325,5.884684909221738,5.481982006028641,575190.3162790698,5,6,4,5,4,3,3,1.0,1,0,0,-1,0,-2,-1
169,5.526546761393547,5.16824674819197,5.680483615824154,4.94839794082301,5.422588877379894,6.042975768446922,5.461824695978846,453671.9910714286,3,E01000174,3,6,6,3,5,3,5.586002295738773,5.12683074411593,5.721429606017313,4.86394132987449,5.352627371486864,6.019390859101948,5.538437289626975,582078.75,5,3,7,2,4,6,4,1.0,2,0,1,-4,1,1,1
170,5.774768824070955,5.473602401471771,5.486672452065797,4.848204013520637,5.527113353256631,6.026511913907211,5.518227406835134,452875.81415929203,6,E01000175,8,3,4,6,5,4,5.845659263928732,5.325071817920321,5.572173836117699,4.821562448002044,5.564539370650337,6.126419147990998,5.71147087698891,579063.5571428571,8,7,4,2,8,7,7,1.0,2,-1,1,-2,2,2,3
171,5.513921836527382,5.575672094414874,5.2101243698015445,5.0013993084430695,5.219664343973485,5.841381514217796,5.22821127786869,455819.9512195122,3,E01000176,9,0,7,0,2,0,5.570920812529187,5.451662889746732,5.272830897292425,4.9665117970732755,5.161998613629231,5.793700892564862,5.23129553087922,583593.4127906977,5,8,0,5,0,1,0,1.0,2,-1,0,-2,0,-1,0
172,5.818959143853957,5.195427031286301,5.794187490017183,4.701846751474565,5.580443856216246,6.251505676777132,5.6098101658205834,435351.25,7,E01000177,3,7,1,7,8,6,5.781947218660099,5.101239703484436,5.699482962266723,4.785637622448935,5.477102443353454,6.112214620433637,5.627693105099806,558432.7014925373,7,3,6,1,7,7,6,1.0,0,0,-1,0,0,-1,0
173,6.076328883107925,4.991959428945124,5.863469349627463,4.70009819482336,5.573990914995307,6.343380406992325,5.844288006523587,404709.9867549669,9,E01000178,1,8,1,7,9,9,6.224408764455278,5.175992907103845,5.5925945417355685,4.673076277062044,5.436810672283173,6.153077083118891,5.690947527602567,519887.07627118647,9,4,4,0,6,8,7,1.0,0,3,-4,-1,-1,-1,-2
174,5.859706453374915,5.349268098135252,5.645350604443936,4.788956461726008,5.489478109119175,6.169300489597492,5.593415080964029,457453.0630630631,7,E01000179,6,5,3,5,7,6,5.62908685908598,5.209342310241625,5.713334406123442,4.838838656743367,5.367977111947303,6.054054765140309,5.5766616440286825,585136.931372549,6,5,6,2,4,6,5,1.0,-1,-1,1,-1,-1,-1,-1
175,5.802742241949275,5.319988879604616,5.620799322059189,4.802368015482806,5.507509438887887,6.070892779723458,5.5848177844199585,416437.44202898553,7,E01000180,6,5,3,5,6,6,5.751371961958865,5.262438071534989,5.6345961516630565,4.837048746169882,5.4917955567650765,6.082455034797073,5.657562406350535,531907.0780141844,7,6,5,2,7,7,6,1.0,0,0,0,-1,2,1,0
176,5.951975563439456,4.904721514745192,5.987220022895119,4.696671506491574,5.612837685238231,6.388545582511208,5.856594986265356,399156.3181818182,8,E01000181,0,9,1,8,9,9,5.8478583331201595,4.874997366877163,5.992187324692221,4.70434273224251,5.425623145757937,6.280708046520457,5.87179044414969,510160.40196078434,8,0,9,0,6,9,9,1.0,0,0,0,-1,-2,0,0
177,5.9619199551068816,5.042266139617333,5.913045059717619,4.561624594835135,5.664417679493244,6.280627123209146,5.780743779585912,398615.1230769231,8,E01000182,1,8,0,8,9,8,5.869328072196559,4.984552706094613,5.869864729114044,4.75331257250076,5.535938888564146,6.227534548680585,5.8538665861115415,509593.36842105264,8,1,8,1,8,9,9,1.0,0,0,0,1,0,0,1
178,6.03298446622198,5.367209903077583,5.592367628406238,4.705058004125695,5.6288616505661455,6.243223631313081,5.673757893501679,444229.5722543353,8,E01000183,6,4,1,8,8,7,5.841120019103542,5.324544900113886,5.572627398462006,4.778777091430896,5.534937963341221,6.155914498820449,5.622145451198925,566550.9212121213,8,7,4,1,8,8,5,1.0,0,1,0,0,0,0,-2
179,5.667096252087504,5.563094907905906,5.136528593953699,5.005618207156658,5.19458168791607,5.791329690255225,5.336396137718111,431426.71875,5,E01000184,9,0,7,0,1,2,6.051125178292946,5.494951448617158,5.2442515053130965,4.785776961953552,5.32202324823097,5.886033974974244,5.339090391883143,538718.187037037,9,9,0,1,3,3,1,1.0,4,0,0,-6,3,2,-1
180,5.669295943484586,5.475315446012161,5.561148194705739,4.872033542745253,5.5065180105321545,5.926144810283885,5.432352190859177,443063.3058823529,5,E01000185,8,4,4,5,3,3,5.552494295835495,5.3741387474536895,5.576134642362595,4.920868693590164,5.4284955704212186,5.869644086360932,5.33822500705719,568628.19,5,7,4,4,6,3,1,1.0,0,-1,0,0,1,0,-2
181,5.697830132877125,5.449292178013746,5.53279869556427,4.949142606819377,5.574983824000639,6.064012081482831,5.585723172917086,40081.282352941176,5,E01000186,8,3,6,7,6,6,5.664099439080939,5.300801315221442,5.650140444916415,4.9424281012581055,5.4349335015538225,6.145215326044933,5.68136995815369,51790.138554216865,6,6,5,4,6,8,7,1.0,1,-2,2,-2,-1,2,1
182,5.501218136432952,5.516349800920064,5.433112544296062,5.0131410075499945,5.425878939375413,5.9540715407481235,5.52314443187376,41652.902654867255,3,E01000187,8,2,7,3,4,4,5.6685163483900185,5.33391492507037,5.62250510150311,4.950735892735276,5.481237035171659,6.1418621002459055,5.657958534418368,54940.617647058825,6,7,5,4,7,8,6,1.0,3,-1,3,-3,4,4,2
183,5.638529569093435,5.737305454498419,4.943610804761114,5.075543331953646,5.204494375758376,5.647270817332473,5.2182821761245375,127809.29754601227,5,E01000188,9,0,8,0,0,0,5.7750048059942465,5.699610790738734,5.049848432703854,5.0452492024533635,5.209607380991705,5.749807979872818,5.306021588518219,176102.67756315006,7,9,0,6,1,1,1,1.0,2,0,0,-2,1,1,1
184,5.33588307464824,5.556517787540661,5.278542902890374,5.162968977759866,5.327382034413954,5.69980271283318,5.202012437932631,39232.69411764706,1,E01000189,9,0,9,1,0,0,5.586193723786146,5.355691977013323,5.583450139913344,5.016894733099113,5.493563877908807,6.028090595302725,5.541324460416808,50837.21052631579,5,7,4,6,7,6,4,1.0,4,-2,4,-3,6,6,4
185,5.796053748746072,5.348511409759522,5.560912299925281,4.815303059547178,5.646015822502875,6.067773643616707,5.762207315045019,38816.72903225807,7,E01000190,6,4,3,8,6,8,5.886096894741058,5.244404009298274,5.712588768256338,4.808505688058703,5.722786511245527,6.179606858052705,5.706766328529308,50284.46710526316,8,5,6,2,9,8,7,1.0,1,-1,2,-1,1,2,-1
186,5.521602529467958,5.486019857002027,5.400890473765556,4.9626820478776486,5.406854563289219,5.92106276449531,5.549530348392448,38129.954545454544,3,E01000191,8,1,6,3,3,5,5.714633163245948,5.3201772999119115,5.56658518378799,4.924065652409116,5.378403546359088,6.012086560275104,5.634839894320514,49464.227027027024,7,7,4,4,4,5,6,1.0,4,-1,3,-2,1,2,1
187,5.566197528311955,5.310206817622161,5.589214499871336,4.908270051131895,5.447846515094815,6.002562503119809,5.6284762513098405,36837.54271356784,4,E01000192,5,4,5,4,5,6,5.573350492826442,5.168545966910333,5.655353232757332,5.002570224176977,5.446416221328618,5.972447916404488,5.628978756285205,47760.865979381444,5,4,5,5,6,5,6,1.0,1,-1,1,0,2,0,0
188,5.6082358961519985,5.390306970347529,5.544817277659541,4.828665794496951,5.499035490077475,6.1057664145594055,5.649999373892079,38218.852173913045,4,E01000193,7,4,3,5,6,7,5.665651682148809,5.249174929701764,5.662658797139707,5.0009887591652245,5.433704948425293,6.088468325656393,5.648500109755474,49503.747826086954,6,5,6,5,6,7,6,1.0,2,-2,2,2,1,1,-1
189,5.488012588769197,5.315129730850458,5.604766009747982,4.934920848160982,5.451549565047026,6.016359066218138,5.547861422598362,36895.6125,3,E01000194,5,4,6,4,5,5,5.452169825633367,5.179610038797061,5.627291501189272,5.002441375826796,5.4027908978362875,5.989754090706508,5.51083714949588,47961.135416666664,3,4,5,5,5,5,3,1.0,0,-1,1,-1,1,0,-2
190,5.334452026551313,5.70874437896332,5.026796607687922,5.133245406764568,5.207985939365803,5.654181819150944,5.17421676321785,86908.43564356436,1,E01000195,9,0,8,0,0,0,5.468369239229497,5.738845186020301,5.0206122422606,5.164940535053005,5.064797542444089,5.7139947753611615,5.1714139861789175,118799.5731707317,4,9,0,8,0,0,0,1.0,3,0,0,0,0,0,0
191,5.779195761680603,5.142153221766154,5.7542645438512166,4.839010877609253,5.587815872828165,6.084305822054545,5.612063381671906,467207.05333333334,6,E01000196,3,7,4,7,6,6,5.658021479845047,5.099299686758415,5.676062927297924,4.8519188217494795,5.400916474668876,5.963859454445217,5.637199837228526,597318.2282608695,6,3,6,2,5,4,6,1.0,0,0,-1,-2,-2,-2,0
192,5.993185663368644,5.1366349000756335,5.7676636678416555,4.75348413717456,5.589291555125539,6.279308346713462,5.720062141011401,456310.21341463417,8,E01000197,3,7,2,7,9,7,5.727577270135372,5.1525066004702325,5.65087719288098,4.876760158313097,5.41917308547793,6.121505301379593,5.6807635387725375,583854.224852071,7,4,5,3,6,7,7,1.0,-1,1,-2,1,-1,-2,0
193,5.739930314000182,5.388384266877274,5.462853739949948,4.899533165049852,5.479601788720326,5.984614879017594,5.603384010961365,475105.39748953976,6,E01000198,7,2,5,5,4,6,5.586978954076767,5.387343647579352,5.406095195313295,5.033908262848854,5.309023733933767,5.98537860661745,5.64468540896972,608881.85,5,8,1,6,3,5,6,1.0,-1,1,-1,1,-2,1,0
194,6.002377817034722,5.181557134538889,5.713639675080776,4.69781099036336,5.6693636864423755,6.164933362603188,5.767643359303475,475875.6125,8,E01000199,3,6,1,8,7,8,5.87686009696834,5.239598710233994,5.60474150813087,4.841095684641632,5.520421452285176,6.082807967675984,5.657258287319162,609036.4143646408,8,5,5,2,8,7,6,1.0,0,2,-1,1,0,0,-2
195,6.035179580366889,5.281112290399019,5.789414730182914,4.659245348253916,5.658435415389926,6.263269424438477,5.815952633009401,475590.31976744183,8,E01000200,5,7,1,8,8,9,5.811681561324061,5.245645827176619,5.652684091305246,4.814182911600385,5.465894592051604,6.11901352113607,5.769703165609009,608496.8571428572,8,5,5,2,7,7,8,1.0,0,0,-2,1,-1,-1,-1
196,5.923316681527521,5.305154458935042,5.6574652080991825,4.7434467072505875,5.578731247153415,6.158878348263136,5.708350381053301,467840.7250996016,8,E01000201,5,5,2,7,7,7,5.85585232387329,5.206531807780266,5.687545337553682,4.785017345999849,5.5633784722665265,6.146766081966203,5.815816100815247,599685.4094827586,8,4,6,1,8,8,8,1.0,0,-1,1,-1,1,1,1
197,6.099777950099641,5.059130726416418,5.912619280668856,4.6233804474579046,5.682531361199596,6.429540284572203,5.8839976495029,465841.1717791411,9,E01000202,2,8,0,9,9,9,5.852820944786072,5.137344999173108,5.752434013871586,4.797412175290725,5.46631864379434,6.237281321076786,5.917250997178694,596634.8705882353,8,3,7,1,7,9,9,1.0,-1,1,-1,1,-2,0,0
198,5.809639930725098,5.448165739698363,5.550638278716891,4.894435130316635,5.507477498994085,6.063425401161457,5.557517387596844,464300.4187192118,7,E01000203,8,4,5,5,6,5,5.498428382709915,5.446879851467469,5.42112231722065,5.006248932843115,5.257665755702,5.966837814041212,5.636443925254485,593641.7696078431,4,8,1,5,2,4,6,1.0,-3,0,-3,0,-3,-2,1
199,6.042800347010295,5.075655316051684,5.870712976009525,4.6961052368956,5.617061336138095,6.272416014420359,5.775966209974903,474726.8538011696,9,E01000204,2,8,1,8,8,8,5.7793290747129,5.164451574178843,5.752975689814641,4.886753884095412,5.423513950934777,6.155893927354079,5.824543347725501,607652.8830769231,7,4,7,3,6,8,8,1.0,-2,2,-1,2,-2,0,0
200,6.410549811946535,5.2556643688563005,5.770859396573409,4.47198862821153,5.732919502605513,6.378466798263846,5.937129998091355,465448.854368932,9,E01000205,4,7,0,9,9,9,6.156359678628493,5.232570725436113,5.715315352897255,4.580561656732948,5.601743795433823,6.304122282534229,5.962735976491656,595598.974489796,9,5,7,0,9,9,9,1.0,0,1,0,0,0,0,0
201,6.366312816602375,5.225422189596596,5.648952236962975,4.481543811089402,5.810083775345339,6.181238577453368,5.853965131514663,442674.0252293578,9,E01000206,4,5,0,9,7,9,6.2184999144130755,5.28188130807449,5.610154737271536,4.618097982064491,5.6019255382597715,6.122034884354459,5.776893953036835,565381.2892376682,9,6,5,0,9,7,8,1.0,0,2,0,0,0,0,-1
202,6.348325455827372,5.133170689323118,5.964100595031466,4.523836784596954,5.787462391491447,6.466112434864044,6.110223959067038,464714.93303571426,9,E01000207,3,9,0,9,9,9,6.136813502373366,5.1261222773584825,5.800749591712294,4.638031663051967,5.6112610086284835,6.351444655451282,6.0387623957518874,594726.1422413794,9,3,8,0,9,9,9,1.0,0,0,-1,0,0,0,0
203,6.30157583579421,5.318958593998104,5.779131990391761,4.596610068809241,5.730986838694662,6.338779008947313,5.951488288119435,415501.93359375,9,E01000208,5,7,0,9,9,9,6.036091160593611,5.354206786462755,5.565936985792535,4.773487543969443,5.564904676693859,6.227403180165724,5.938923702998594,533361.0568181818,9,7,4,1,9,9,9,1.0,0,2,-3,1,0,0,0
204,6.4454944457924155,5.2300074424659995,5.917447252231732,4.414283044505537,5.795745737719954,6.555318105639073,6.06620604950085,465986.63157894736,9,E01000209,4,8,0,9,9,9,6.138838452842614,5.174655870818273,5.71973839645222,4.607206018185923,5.547555241461987,6.400863550251645,6.032369108159143,596290.5064377682,9,4,7,0,8,9,9,1.0,0,0,-1,0,-1,0,0
205,6.037482818134692,5.401976983587281,5.596776566585572,4.708859547847459,5.5783564338163165,6.210262128285,5.734241823188397,462491.80672268907,8,E01000210,7,4,1,7,8,8,6.12841601627867,5.356361399526182,5.4987198934530666,4.596965819978348,5.563362883484882,6.205693564146681,5.710205775392635,592498.7314578005,9,7,3,0,8,8,7,1.0,1,0,-1,-1,1,0,-1
206,5.681752564560654,5.221702059110005,5.630482963007739,4.89647476744448,5.4337808443949775,5.9776198293408775,5.566949274804857,466411.6324786325,5,E01000211,4,5,5,3,4,5,5.460035616782174,5.173963121069011,5.601011233098471,5.008515025252726,5.24883564417042,5.913233365585555,5.5803764618154785,596820.2910447761,4,4,4,5,2,3,5,1.0,-1,0,-1,0,-1,-1,0
207,6.297993596971343,5.189077925805601,5.741929592863883,4.57097337406534,5.716720718176254,6.325742719086958,5.92316519843482,465879.71502590674,9,E01000212,3,7,0,9,9,9,6.156949135851352,5.224118658836852,5.673160002586689,4.646301633500038,5.583743986931253,6.260796634440727,5.895419473343707,596068.2765957447,9,5,6,0,9,9,9,1.0,0,2,-1,0,0,0,0
208,6.422855828771528,5.192806185476038,5.900050071691045,4.433099247761909,5.915355630268325,6.509893368411538,6.189166776391844,455598.96026490064,9,E01000213,3,8,0,9,9,9,6.193066196495227,5.213255574194233,5.805033193545395,4.586787960502539,5.79742980405186,6.436296578203694,6.110722303390503,580691.9719101123,9,5,8,0,9,9,9,1.0,0,2,0,0,0,0,0
209,6.270724632342657,5.1539146363735195,5.785186662276586,4.629565512140592,5.772055155038833,6.198622425397237,5.939407600959142,465652.7083333333,9,E01000214,3,7,0,9,8,9,6.032294547893632,5.1688855172882615,5.697475505546785,4.657279357104234,5.508116641514738,6.23909256659763,5.868625836473115,595938.1549295775,9,4,6,0,8,9,9,1.0,0,1,-1,0,-1,1,0
210,5.598895663832441,5.2460423752113625,5.618405013908575,4.966627959116005,5.425724568926258,6.05102112558153,5.522142572903339,462020.0987654321,4,E01000215,4,5,6,3,5,4,5.419861199050549,5.168112520350526,5.673493254263669,4.995251414791638,5.28926852049417,5.962440249146215,5.546277835669107,591159.0264900662,3,4,6,5,2,4,4,1.0,-1,0,1,-1,-1,-1,0
211,6.02986754820897,5.05229191443859,5.799859639925835,4.690032649498719,5.587490933063703,6.375731093761249,5.737992158302894,467081.46153846156,8,E01000216,1,7,1,7,9,8,5.770880422678339,5.057175278663635,5.759128052068044,4.8228913610240065,5.49102451571499,6.251338266464601,5.78536922673145,597612.4939759036,7,2,7,2,7,9,8,1.0,-1,1,0,1,0,0,0
212,5.80259053388112,5.190507780498182,5.777465053007636,4.78674557679136,5.558943174254726,6.204498845086971,5.767630898616683,467045.6549295775,7,E01000217,3,7,3,6,8,8,5.530192162714848,5.190666334969657,5.701788207300666,4.913860265900489,5.349522758503349,6.072993186055397,5.794223292344282,597487.8707482993,4,4,6,3,4,7,8,1.0,-3,1,-1,0,-2,-1,0
213,5.585059294493302,5.164502112761788,5.734023204057113,4.830580065561377,5.475214441962864,6.1968510917995285,5.5400931192481,463805.7565217391,4,E01000218,3,6,3,4,8,5,5.41485760746331,5.066242319756541,5.757661544043442,5.002158113594713,5.338971711438278,6.042504688789105,5.565795814168864,593558.0086206896,3,2,7,5,3,6,4,1.0,-1,-1,1,2,-1,-2,-1
214,5.522453246445491,5.388676751071009,5.522754572177756,4.997413608123516,5.387507443592466,6.01565779159809,5.494651047114668,461618.4551724138,3,E01000219,7,3,7,3,5,4,5.319784277640049,5.332655469576518,5.448156360560243,5.159454362197492,5.2465000482475235,5.920035440217024,5.435920811299258,590714.320754717,2,7,2,8,2,4,2,1.0,-1,0,-1,1,-1,-1,-2
215,5.740399708139136,5.074577601666146,5.75502267289669,4.800401518953607,5.540229414371734,6.214733402779761,5.628051396380079,462708.09574468085,6,E01000220,2,7,3,6,8,6,5.44167051079509,5.167970274830912,5.744809803071913,4.9302174259018114,5.386416934348724,6.084167278729952,5.722896105640537,592300.7802197802,3,4,7,4,5,7,7,1.0,-3,2,0,1,-1,-1,1
216,5.176109429941339,5.724060543512894,4.962780922550266,5.257179318848303,5.170361463094162,5.612402634701486,5.093252097145986,462840.50169491523,0,E01000221,9,0,9,0,0,0,5.157051792771546,5.657439834371056,4.98533847067774,5.399261788301861,4.990766876444374,5.608311443599229,5.126192212412038,592133.2963917525,0,9,0,9,0,0,0,1.0,0,0,0,0,0,0,0
217,5.583408429443492,5.324672091903025,5.5381753237950315,4.956262060672562,5.417206642944689,5.98901489979959,5.477374563327414,462986.387283237,4,E01000222,6,3,6,3,4,4,5.38856439111094,5.301895311900547,5.411503170533155,5.06897766123373,5.330994904987396,5.889700118826811,5.57019392586259,592391.0264550265,3,6,1,7,3,3,4,1.0,-1,0,-2,1,0,-1,0
218,5.253111668786064,5.590224235761361,5.129923964133028,5.138583433432657,5.218509597367928,5.665735600913157,5.210714137456456,463948.368852459,1,E01000223,9,0,9,0,0,0,5.160353837373122,5.5036983409017886,5.177197441065086,5.212711891138329,5.071580210271871,5.6476196981825915,5.260702255536925,594008.4867924529,0,9,0,9,0,0,0,1.0,-1,0,0,0,0,0,0
219,5.816465465351939,5.148513267748058,5.7672645300626755,4.795551880262792,5.574096996337175,6.2015416491776705,5.755694183520973,461877.2734375,7,E01000224,3,7,3,7,8,8,5.649348912844017,5.085959775234336,5.59156836146739,4.952773193814862,5.422388877441634,6.007944510943854,5.667704351802371,590966.6641791045,6,3,4,4,6,5,6,1.0,-1,0,-3,1,-1,-3,-2
220,5.590436247294535,5.3686672363452566,5.498026830707482,4.909271331604369,5.425668136088434,5.98124654564315,5.542904796714554,461719.1017964072,4,E01000225,6,3,5,3,4,5,5.4701432668710055,5.318099513084074,5.510633449011211,5.07231779566294,5.2005712125874775,5.911609153204326,5.6378765988953505,591153.7911392405,4,6,3,7,1,3,6,1.0,0,0,0,2,-2,-1,1
221,5.5193614519160725,5.487148928469506,5.3844708791677505,4.86012171489605,5.355359535286392,6.036049860111182,5.436216067576754,265814.1811594203,3,E01000226,8,1,4,2,5,3,5.590818494769699,5.403819480686323,5.465090127701455,4.902401104041025,5.381956113145707,6.0183486566475946,5.323355074469925,350312.42553191487,5,8,2,3,5,6,1,1.0,2,0,1,-1,3,1,-2
222,5.5621212267539875,5.371641457920343,5.521398457003311,5.0427309039612895,5.414688464621423,6.085520311140678,5.695434184981064,256519.6971830986,4,E01000227,6,3,7,3,6,7,5.442363221069862,5.209542435613172,5.625101058236484,5.101363312787023,5.337216004832038,6.005948148924729,5.613979164485274,326682.84137931035,3,5,5,7,3,5,5,1.0,-1,-1,2,0,0,-1,-2
223,5.8018763281812715,5.566712976095095,5.116083973675818,4.93248426854907,5.339757008339042,5.752497694978667,5.327152389198987,468591.57960199006,7,E01000228,9,0,5,2,1,1,5.811132215481582,5.594697444273128,5.115293047125105,4.98753925907812,5.282944124665478,5.792731091558791,5.42230796585266,600561.6330935252,8,9,0,5,2,1,2,1.0,1,0,0,0,0,0,1
224,5.515013787397153,5.676758450307664,5.316803161505681,5.01468682668771,5.401200876873769,5.894568116801559,5.41417059093524,283552.1592356688,3,E01000229,9,1,7,3,3,3,5.4498153078940605,5.482162684202194,5.387005902105762,5.063143577306501,5.329651877764733,5.943722023117926,5.425844935640212,336639.77419354836,3,9,1,7,3,4,2,1.0,0,0,0,0,0,1,-1
225,5.4916017723370745,5.541796229689954,5.469093318445137,5.040202518543565,5.410953980612468,5.980602890612131,5.511735607342548,36395.4156626506,3,E01000230,9,2,7,3,4,4,5.4875320082201675,5.2848230819491775,5.514241818119498,5.066817595678217,5.380588897887399,6.042214225320255,5.643333300948143,47245.05147058824,4,6,3,7,5,6,6,1.0,1,-3,1,0,2,2,2
226,5.455662094313523,5.592224142160909,5.217796605208824,5.192576010679376,5.239906720560173,5.8011155570375506,5.234835305090608,481581.1982758621,3,E01000231,9,0,9,0,1,1,5.385667547057657,5.565369842099209,5.20473251062281,5.2454840819040935,5.126764147421893,5.814352007473216,5.419479289709353,616367.0039215686,3,9,0,9,0,2,2,1.0,0,0,0,0,0,1,1
227,5.477619843524799,5.589469326169867,5.333232667362481,5.15206172487192,5.303012332372498,5.8403719511994145,5.417004514158818,460184.3859649123,3,E01000232,9,1,9,1,2,3,5.537089352174239,5.440727294575084,5.474265667525205,5.10130010843277,5.323277706449682,5.891484142433513,5.531387417424809,587878.740909091,4,8,2,7,3,3,4,1.0,1,-1,1,-2,2,1,1
228,5.509053841412785,5.34760479826525,5.518895720861044,5.007033821330013,5.412776142717844,5.991929538278694,5.602242099951549,478963.0903614458,3,E01000233,6,3,7,3,4,6,5.382459151744842,5.255272097587586,5.606968700885773,5.056609393755595,5.333685508569082,5.9351436217625935,5.5134799098968506,612631.0066666667,3,5,5,6,3,4,3,1.0,0,-1,2,-1,0,0,-3
229,5.797650431910305,5.395039109473533,5.656378199868168,4.778243849463497,5.562707924673743,6.223481191810986,5.798972727559137,480334.4539007092,7,E01000234,7,5,2,7,8,8,5.806223717602816,5.192392467549353,5.728955487410228,4.881781058781074,5.638208416375247,6.249448927966031,5.770143195535198,614833.9015151515,8,4,7,3,9,9,8,1.0,1,-3,2,1,2,1,0
230,5.628993202181696,5.448208288660327,5.355688502487627,4.937994000402469,5.416034269101411,5.947675724631375,5.36698434422317,480381.43203883496,5,E01000235,8,1,6,3,4,2,5.6175958010756855,5.400443825328234,5.49123782671771,4.920953486150908,5.410326787568991,5.973799231561642,5.351922261483461,614873.5339805825,5,8,2,4,5,5,1,1.0,0,0,1,-2,2,1,-1
231,5.579770932326445,5.3788832563000755,5.467197353775437,4.991416182066943,5.335135460705371,5.901542737677291,5.550830533375612,461636.8040540541,4,E01000236,7,2,6,2,3,5,5.579728720071432,5.2980626388029615,5.618338995880181,5.001320588838804,5.374842631233322,5.97491907323157,5.571587920188904,590704.979020979,5,6,5,5,4,5,5,1.0,1,-1,3,-1,2,2,0
232,5.580771832980893,5.218281725590879,5.641032893549312,5.0018565729260445,5.418562307276509,6.004566208882765,5.6177771484309975,465330.8806818182,4,E01000237,4,5,7,3,5,6,5.43961847978195,5.197159639469863,5.602805227192525,5.037088014147608,5.27613733807191,5.928050509564162,5.563711021152245,595664.614213198,3,4,5,6,2,4,4,1.0,-1,0,0,-1,-1,-1,-2
233,5.604256419410483,5.238809771705092,5.540496780161272,4.865338518605594,5.402415470073097,6.088122076458401,5.596427421123661,461725.52046783624,4,E01000238,4,3,4,3,6,6,5.5060826494435595,5.261278450868692,5.5677283653028455,4.965423792790455,5.3381875928040525,5.999380854284688,5.509225704108074,590831.6815286624,4,5,4,5,3,5,3,1.0,0,1,1,1,0,-1,-3
234,5.30145072595193,5.648623630137426,5.057852792056231,5.220717934297404,5.127542858909963,5.600994215216688,5.15665879599937,470315.40860215056,1,E01000239,9,0,9,0,0,0,5.306833567145543,5.596245322089929,5.094635395667492,5.284330522402739,5.069089559408335,5.6357710892573385,5.264570350830372,601940.1185897436,2,9,0,9,0,0,0,1.0,1,0,0,0,0,0,0
235,5.4674479940296274,5.5935895453512146,5.177473306655884,5.114162675574818,5.232331689480132,5.806207776069641,5.401697789145782,477177.8230088496,3,E01000240,9,0,8,0,2,2,5.410229165875722,5.628984193953257,5.198429810622382,5.1827195717228784,5.159843736697757,5.852448983797951,5.484900168010166,610925.3888888889,3,9,0,8,0,2,3,1.0,0,0,0,0,0,0,1
236,5.876039670474493,5.23454120977601,5.651508799239771,4.8117863135551335,5.522986086446847,6.149807462051733,5.889752205628068,476612.8432835821,7,E01000241,4,5,3,6,7,9,5.763653375362527,5.204941087755664,5.656976977710066,4.842952870500499,5.505708807912366,6.099696368184583,5.6475744469412446,610462.6275862069,7,4,6,2,8,7,6,1.0,0,0,1,-1,2,0,-3
237,5.8355948185098585,5.303627597874608,5.570324536027579,4.793162698033212,5.536267454596771,6.034700981501875,5.707938373773947,465689.5804597701,7,E01000242,5,4,3,6,5,7,5.600507649403174,5.4238721618374575,5.452486142950151,4.9964530161283545,5.34142757330126,5.894807778515862,5.540153270786249,597207.5533980583,5,8,2,5,4,3,4,1.0,-2,3,-2,2,-2,-2,-3
238,5.631553810034225,5.256531801686358,5.691567340893532,4.896316423344968,5.513153748725777,6.081500007145441,5.619177043437958,465576.7089552239,5,E01000243,4,6,5,5,6,6,5.508457932342478,5.132259709494455,5.748422679446993,4.9447297547139275,5.386765870107275,6.018534129979659,5.6038369597220905,594963.081632653,4,3,7,4,5,6,5,1.0,-1,-1,1,-1,0,0,-1
239,5.689151856728962,5.2078089245728085,5.665588632651738,4.762841022866112,5.500356769561767,6.094762098789215,5.6266083887645175,467973.1357142857,5,E01000244,4,5,2,5,6,6,5.627499817110968,5.132500854789788,5.587947728786062,4.9543842009618775,5.44327454194955,5.979658091321904,5.540403765144077,599158.7872340425,6,3,4,4,6,5,4,1.0,1,-1,-1,2,1,-1,-2
240,5.249936731325255,5.338913410074181,5.468768064346579,5.080090207358201,5.2738311108615665,5.703532214793894,5.294187739491463,463099.1041666667,1,E01000245,6,2,8,1,0,1,5.15004051533066,5.288240030032246,5.520786457702894,5.170728790659864,5.183629132118545,5.612701248721916,5.19110025778538,592432.9663865546,0,6,3,8,1,0,0,1.0,-1,0,1,0,0,0,-1
241,5.936298865184449,5.5401729947642275,5.240385701363547,4.775885789436207,5.601882284984254,5.847911437352498,5.466339963360837,489844.1614035088,8,E01000246,9,0,2,7,2,4,6.016308465531764,5.324152544254565,5.557375952487684,4.71129997586476,5.63350803069486,6.062190091336957,5.566778136573675,626890.2290076336,9,7,4,0,9,6,4,1.0,1,-2,4,-2,2,4,0
242,5.922724785226764,5.245283228881432,5.62307767976414,4.788936739618128,5.5879655733253015,6.199626965956255,5.724363753289888,457522.7727272727,8,E01000247,4,5,3,7,8,8,5.727017866988336,5.2031831683651095,5.688250226359213,4.890878813882028,5.526672130630862,6.110815503904896,5.590292650845743,585506.8629032258,7,4,6,3,8,7,5,1.0,-1,0,1,0,1,-1,-3
243,5.906459261195451,5.236369319225786,5.535141641093839,4.78080975350147,5.506106467840309,6.0887381492122525,5.548245792564709,484738.1612903226,8,E01000248,4,3,2,5,6,5,5.844805034415982,5.1123907029346265,5.742683990306764,4.759956091501136,5.524251330520304,6.158801528514844,5.633163348193417,620238.1469194313,8,3,7,1,8,8,6,1.0,0,-1,4,-1,3,2,1
244,5.895756748235114,5.372059523502243,5.417621436520157,4.805621598368493,5.5428285621037,6.041039178861636,5.555413330826804,515535.6355140187,7,E01000249,6,2,3,6,5,5,5.861589577591535,5.2019996226412575,5.654382599210276,4.812618675741177,5.54490495769723,6.151711976643905,5.629198180240335,651026.1262135922,8,4,5,2,8,8,6,1.0,1,-2,3,-1,2,3,1
245,5.561766538214176,5.28330068258529,5.581671186372743,4.90483011294764,5.477553389173873,5.936929860859053,5.510228885826489,475408.1489361702,4,E01000250,5,4,5,4,3,4,5.566959562940874,5.115192440540894,5.6732247592746345,4.86140165121659,5.432994812295057,6.034338780071424,5.587032351804816,608848.4673913043,5,3,6,2,6,6,5,1.0,1,-2,2,-3,2,3,1
246,5.671846425894535,5.322643347219987,5.67377105770689,4.90377747073318,5.488872683409489,6.064264592257413,5.612501725283536,458123.4484848485,5,E01000251,6,6,5,5,6,6,5.637911375831155,5.170467086016813,5.747977170077237,4.93251790783622,5.488703859043631,6.098551669860269,5.648418910363141,586236.8663101604,6,4,7,4,7,7,6,1.0,1,-2,1,-1,2,1,0
247,5.99000579245547,5.366407472191128,5.671870500483411,4.785471697225638,5.658368114038562,6.225415684652667,5.760829550154666,458377.90780141845,8,E01000252,6,6,3,8,8,8,5.822405205739962,5.111392043687247,5.747813711633215,4.806365005619876,5.571371815421364,6.170443856632793,5.586554547289868,586585.6923076923,8,3,7,1,9,8,5,1.0,0,-3,1,-2,1,0,-3
248,6.007789862852027,5.619727884983495,5.066568874312143,4.786867207419263,5.490046683889236,5.726240058449934,5.320986339210593,484478.29562043794,8,E01000253,9,0,3,5,1,1,6.041026635902945,5.504311190779757,5.204411196996923,4.827698620078065,5.451237021332577,5.859670069139445,5.439854937513875,619876.8635578584,9,9,0,2,6,2,2,1.0,1,0,0,-1,1,1,1
249,6.124084301565176,5.456387378448664,5.352750197201472,4.697104858005562,5.576820942254558,6.001141059438256,5.472538799146482,660605.4252491695,9,E01000254,8,1,1,7,5,4,6.0741279255959295,5.322824412392031,5.44080699451508,4.732088643504727,5.558811787636049,6.104965109209861,5.474630192018324,847061.5419354839,9,7,2,0,8,7,3,1.0,0,-1,1,-1,1,2,-1
250,5.920279955548862,5.522191902089224,5.351501120344658,4.814043368536995,5.566107567186398,5.983107884024734,5.495007536484806,477421.5947136564,8,E01000255,8,1,3,7,4,4,5.832552137082083,5.418591903489933,5.37983963364049,4.85221104454576,5.46388793253062,5.990105226374509,5.536024778558497,611136.5307017544,8,8,1,2,7,5,4,1.0,0,0,0,-1,0,1,0
251,5.82685228688034,5.408660858120751,5.369057358209811,4.793290092717463,5.522891955759058,5.975815832914419,5.492757044844891,478237.5175879397,7,E01000256,7,1,3,6,4,4,5.8403902864947765,5.3435050513326505,5.492940393919797,4.837111344656994,5.456991764688,6.047889906106536,5.666273913432643,612328.149484536,8,7,3,2,7,6,6,1.0,1,0,2,-1,1,2,2
252,5.642379133971696,5.476563856159289,5.295967807474825,4.903780449911491,5.4498489689581175,5.875854628602254,5.2596908961374735,476062.94845360826,5,E01000257,8,0,5,4,2,1,5.609275505277846,5.517963361210294,5.353304235140483,5.022506684727139,5.367614840401544,5.881626955668131,5.426943051550124,609138.1244444444,5,9,1,6,4,3,2,1.0,0,1,1,1,0,1,1
253,5.805330561034045,5.456573332973461,5.377528431427539,4.883959408980518,5.4167889116996495,5.921408649065985,5.444105921678208,479092.82412060304,7,E01000258,8,1,5,3,3,3,5.7857008479498875,5.377763118062701,5.407558047125492,5.000469702217966,5.396340281505303,5.983232489947615,5.587739320224141,613292.2167487685,7,7,1,5,5,5,5,1.0,0,-1,0,0,2,2,2
254,5.704317285272175,5.397163458570035,5.4501217496609256,4.850565040896752,5.492101429465288,6.018373904113998,5.54199336852856,476717.38323353295,5,E01000259,7,2,4,5,5,5,5.728951354472958,5.36474474166569,5.540914718867742,4.88870026075352,5.450853408777226,6.100547596027977,5.619676110688706,610103.3070175438,7,7,3,3,6,7,5,1.0,2,0,1,-1,1,2,0
255,5.245982947861752,5.730497658405158,4.998447276747135,5.235879770630156,5.092425167713019,5.604789328392204,5.189219415340277,477934.35294117645,1,E01000260,9,0,9,0,0,0,5.312929299642455,5.632902110522648,5.108032194510946,5.236854534666493,5.096943675347094,5.71534799826595,5.2997391100199716,611877.5259433963,2,9,0,9,0,0,0,1.0,1,0,0,0,0,0,0
256,6.0078688859939575,5.3451178793179785,5.426386714385727,4.683849019923453,5.654843875917337,5.996361599130146,5.564348442271604,480008.0847457627,8,E01000261,6,2,1,8,4,5,6.015191161787355,5.2739128938743045,5.492899295571562,4.733211955466828,5.624224592725952,6.033170974099791,5.660375265719055,614221.6915584416,9,6,3,0,9,6,6,1.0,1,0,1,-1,1,2,1
257,5.979878843892318,5.491434848035565,5.226917436711357,4.789177741409865,5.524807185617112,5.822203778128587,5.357013339911405,476487.96437659033,8,E01000262,8,0,3,6,2,2,5.843540474772453,5.452929578856988,5.349109468947757,4.85744837901809,5.459063166921789,5.909054290977392,5.461561317606406,609630.5818181818,8,8,1,2,7,3,3,1.0,0,0,1,-1,1,1,1
258,5.937094249144322,5.317143824921937,5.654116322012508,4.646593448494663,5.6542984207137295,6.158930649276541,5.765843611805379,480185.0504201681,8,E01000263,5,5,0,8,7,8,5.996311852644229,5.229766588272719,5.6795016845752455,4.742404787191029,5.646151969145084,6.221720236128774,5.806375700338133,614658.2543103448,9,5,6,1,9,9,8,1.0,1,0,1,1,1,2,0
259,5.408943395799314,5.416822131250946,5.443919097873526,5.035903447530639,5.273043607322263,5.795830586846446,5.408172460928769,480081.0985915493,2,E01000264,7,2,7,1,1,3,5.349694521943475,5.38704246510366,5.408487236044209,5.154092656578987,5.180244561593244,5.776286695033881,5.449866409894008,614543.7388535031,2,8,1,8,1,1,2,1.0,0,1,-1,1,0,0,-1
260,5.5131711065769196,5.341828626890977,5.628731977608469,4.972968171868059,5.439424430330594,6.043140863378842,5.414995078411367,452550.5625,3,E01000265,6,5,6,4,5,3,5.275944476674317,5.412088196748381,5.529540356557081,5.063055121215286,5.232495161378459,5.890377854086031,5.4169797046928645,579033.898089172,1,8,3,7,1,3,2,1.0,-2,2,-2,1,-3,-2,-1
261,6.133145056491674,5.2657496748968615,5.781303826459618,4.604575930639755,5.7753326851268145,6.27919810178668,5.879040804020194,452851.12209302327,9,E01000266,5,7,0,9,9,9,5.84200757116244,5.281686490411916,5.625060035378893,4.782267756224996,5.547898832605688,6.18510890138742,5.850164396328162,579554.6243093923,8,6,5,1,8,8,9,1.0,-1,1,-2,1,-1,-1,0
262,5.837833529710769,5.309988515079022,5.671003894507885,4.861231864243746,5.573449416458606,6.187679177522659,5.693328730762005,459826.6375,7,E01000267,5,6,4,7,8,7,5.474096361209046,5.32807132737203,5.628550931811333,5.071418604390188,5.421385125680403,5.9941595278003,5.53372668271715,588393.3068181818,4,7,5,7,6,5,4,1.0,-3,2,-1,3,-1,-3,-3
263,5.646509818773012,5.308392291455656,5.549924414222305,4.8240464680903665,5.472868608139657,5.9616589004929,5.686124991726231,458769.1027027027,5,E01000268,5,4,3,4,4,7,5.639015062531429,5.232909825310778,5.673126390324303,5.005972799377062,5.479119449705627,5.9796777020639444,5.62317342248129,587057.1293532338,6,5,6,5,7,5,6,1.0,1,0,2,2,3,1,-1
264,5.696006810223615,5.361025456398252,5.504971273361691,4.798583192169351,5.510548812371713,6.107384013120459,5.803308078220913,459322.1957671958,5,E01000269,6,3,3,5,6,8,5.7203168004609966,5.238551177119756,5.618261452534752,4.892262346936628,5.460412185903974,6.112748450012568,5.775129130101317,587765.5876777251,7,5,5,3,7,7,8,1.0,2,-1,2,0,2,1,0
265,5.985043506691421,5.411072413126628,5.602108077726502,4.694729214993076,5.6211128424907075,6.0955439667770825,5.72654162109762,459083.0724637681,8,E01000270,7,4,1,8,6,8,5.782651485668288,5.31166654245721,5.646093055605888,4.91691825290521,5.560884070065287,6.085159768660863,5.601296745240688,587449.1666666666,7,6,5,4,8,7,5,1.0,-1,-1,1,3,0,1,-3
266,6.011910087095116,5.250624360903254,5.649943202171686,4.743881086695869,5.628985634389913,6.210683628073278,5.770653620081128,459857.0283018868,8,E01000271,4,5,2,8,8,8,5.810080495373956,5.223202422261238,5.601984566655652,4.903153573130739,5.460264722848761,6.120138808571059,5.745954679004077,588506.3793103448,8,5,4,3,7,7,8,1.0,0,1,-1,1,-1,-1,0
267,6.17354438077198,5.199598819352268,5.783288493585051,4.602508690250054,5.724934429934855,6.275293584620015,5.855193029628711,454607.9157303371,9,E01000272,3,7,0,9,8,9,5.97008705509759,5.225080065776647,5.625627743147816,4.723771806825628,5.587686645552284,6.18967497163486,5.847026136872682,581801.5958549223,9,5,5,0,9,8,9,1.0,0,2,-2,0,0,0,0
268,5.864784465033627,5.310904967714343,5.696409290358865,4.7969098591945585,5.555866678790934,6.163633672443368,5.637656726780728,455550.17159763316,7,E01000273,5,6,3,6,7,6,5.667345212667416,5.2462862748366135,5.594676076448881,4.91958800523709,5.413043033771026,6.019446196922889,5.592992140085269,583156.7025641026,6,5,4,4,5,6,5,1.0,-1,0,-2,1,-1,-1,-1
269,5.74649424638067,5.365605422428676,5.680352206741061,4.838602760717983,5.53091530147053,6.181484176999047,5.57783477576006,451810.6666666667,6,E01000274,6,6,4,6,7,5,5.460679421886321,5.254458475112915,5.6234097203900735,4.957366371923877,5.340683917845449,6.077595977629385,5.580409100747878,578012.6838709677,4,5,5,4,3,7,5,1.0,-2,-1,-1,0,-3,0,0
270,5.864095893969019,5.263080168201263,5.684535952935736,4.7546027324285856,5.563364639339677,6.163512430995343,5.660443110638354,453532.3674698795,7,E01000275,5,6,2,7,7,7,5.818930653577351,5.331408379486253,5.644492205993905,4.915810867567747,5.493906759425421,6.123838620949845,5.741977082431646,580382.5801104972,8,7,5,4,7,7,7,1.0,1,2,-1,2,0,0,0
271,5.957552315313605,5.270583228974402,5.7036562599713285,4.736993427518048,5.708642285081405,6.255152148536489,5.833675782891769,455211.0759493671,8,E01000276,5,6,2,9,8,9,5.765287192538381,5.291000407189131,5.683351619169116,4.898749751038849,5.674318913370371,6.1761011518538,5.902915088459849,582279.953125,7,6,6,3,9,8,9,1.0,-1,1,0,1,0,0,0
272,6.153942670577612,5.18745917845995,5.779480159792126,4.5642137181045666,5.740243889327742,6.228609148253742,5.828946519101787,454165.6666666667,9,E01000277,3,7,0,9,8,9,5.848277909415109,5.2467938634686,5.704923480973208,4.833290491785322,5.560385745270808,6.134893528500894,5.7135121248718495,581139.1353383459,8,5,6,2,8,8,7,1.0,-1,2,-1,2,-1,0,-2
273,5.9334687529466095,5.162246672006754,5.769656827052434,4.699137317828643,5.68660547488775,6.320887045982556,5.815160229420051,457315.08974358975,8,E01000278,3,7,1,9,9,9,5.800368817546699,5.132490967647938,5.662758877005758,4.77856398685069,5.551201977307284,6.287581623355044,6.049273095553434,585265.5949367088,8,3,6,1,8,9,9,1.0,0,0,-1,0,-1,0,0
274,6.2649481909766696,5.448068864065369,5.222068366613198,4.62171923955634,5.697172870128488,5.88167457622858,5.470980175054258,473981.1064301552,9,E01000279,8,0,0,9,3,4,6.351416975883261,5.469134498839598,5.3630389261944025,4.636006983753028,5.726089412447798,5.995802125172635,5.565505444754118,606758.140167364,9,9,1,0,9,5,4,1.0,0,1,1,0,0,2,0
275,6.090177239122845,5.2810971010298955,5.576194782484145,4.680973895390829,5.715261474109831,6.173385406675793,5.728645438239688,459260.95714285714,9,E01000280,5,4,1,9,7,8,6.086316402057349,5.2003714005518615,5.656717120227726,4.686841114325458,5.655429965340048,6.168596822545275,5.767686595565163,587755.0092165899,9,4,5,0,9,8,8,1.0,0,-1,1,-1,0,1,0
276,5.491693673815046,5.392964727537972,5.528958209923336,4.9428157934120724,5.423160759040288,5.93707857472556,5.467445447615215,452773.4928571429,3,E01000281,7,3,6,3,3,4,5.294533273925079,5.428504190561962,5.43160159748756,5.13956258852789,5.330559707126734,5.841241443084061,5.453090351783425,579589.6380368099,1,8,2,8,3,2,2,1.0,-2,1,-1,2,0,-1,-2
277,5.7084654245762465,5.2617284369606505,5.733744424202539,4.818080926906167,5.519239866664644,6.207354431207469,5.6346840582831055,453455.161849711,6,E01000282,5,6,3,6,8,6,5.594360756495642,5.281032487828895,5.68891695945982,4.962452704944308,5.436693040151445,6.1111005058995,5.693703117193999,580499.6613756614,5,6,6,4,6,7,7,1.0,-1,1,0,1,0,-1,1
278,5.795100514327778,5.2857121769119715,5.598084919592914,4.8184585809707645,5.581971540170557,6.135573413792779,5.70193923852023,453326.5,7,E01000283,5,4,3,7,7,7,5.786058615137647,5.301418336121352,5.618751807646318,4.881464633908305,5.533280516004229,6.073685160883657,5.706822474519689,580135.7412587412,7,6,5,3,8,7,7,1.0,0,1,1,0,1,0,0
279,5.895240790154561,5.286232128200761,5.621418833014476,4.772398593914078,5.558980533157486,6.066769913018468,5.577659718243472,452542.4638554217,7,E01000284,5,5,2,6,6,5,5.745219371275987,5.273034041513226,5.618504404307839,4.84083118267402,5.472841722522667,6.053918684314111,5.563093363881825,579072.5149700599,7,6,5,2,7,6,4,1.0,0,1,0,0,1,0,-1
280,5.640049342839223,5.491858887222578,5.436450395943983,4.862316868215237,5.385440871400653,6.027736960716967,5.569504090075223,482987.4528301887,5,E01000285,8,2,4,2,5,5,5.715079458363085,5.342230628771954,5.553946767944887,4.8705301988555725,5.508164219109409,6.098668147282428,5.569539890231856,617921.9759036144,7,7,4,3,8,7,4,1.0,2,-1,2,-1,6,2,-1
281,5.713567876815796,5.548216674725214,5.443205349312889,4.816803732183245,5.448775823911031,6.090603692001767,5.548133882549074,483440.7555555556,6,E01000286,9,2,3,4,6,5,5.708230205446656,5.3722161779626765,5.586666850318686,4.872749096468875,5.537163977037396,6.089944811592325,5.593417803446452,618551.485380117,7,7,4,3,8,7,5,1.0,1,-2,2,0,4,1,0
282,5.683469044195639,5.478711344744708,5.422437456491831,4.950447976267015,5.449815982096904,6.007464501664445,5.472633493268812,483524.8162162162,5,E01000287,8,2,6,4,5,4,5.654425683077315,5.408140981406496,5.531966095082244,4.932617221659387,5.46428424573084,6.033822968689321,5.545116603723046,618656.298245614,6,8,3,4,7,6,4,1.0,1,0,1,-2,3,1,0
283,5.550476395000111,5.413976235823198,5.430259461113901,5.028535400014935,5.420396244164669,5.994325710787917,5.478576768528331,459196.45454545453,4,E01000288,7,2,7,3,4,4,5.663721099234464,5.290424374809042,5.6460764854275,4.985636387652124,5.48476172957504,6.049344821282995,5.5810577932157015,587501.4444444445,6,6,5,5,7,6,5,1.0,2,-1,3,-2,4,2,1
284,5.295933035631029,5.716748665249537,5.182824660861303,5.157132923603058,5.261675442021991,5.7035296266041104,5.104194709232876,465352.9365079365,1,E01000289,9,0,9,1,0,0,5.498065434464621,5.4674257827461314,5.4182179728779225,5.073436819085288,5.3707766926616705,5.8367090706431535,5.3314542628209525,593935.1743119266,4,9,1,7,4,2,1,1.0,3,0,1,-2,3,2,1
285,5.860424066863357,5.666993763043548,5.062107211050718,4.843689575747142,5.386197054775249,5.67880355993435,5.302566213140856,484153.7537091988,7,E01000290,9,0,4,2,0,1,5.900113682224326,5.583985435146175,5.135757049142498,4.844508492456724,5.345244551684758,5.742619441959956,5.273043214784909,619506.4876712329,8,9,0,2,4,1,0,1.0,1,0,0,-2,2,1,-1
286,5.432723879814148,5.581050119901958,5.478298874905235,4.914720119928059,5.38429614368238,6.035783860557958,5.3196825516851325,482746.46315789473,2,E01000291,9,2,5,2,5,1,5.45895817982299,5.425279894045421,5.606505962354796,5.052236418638911,5.435821200055735,6.096576386264393,5.388237680707659,617551.9642857143,3,8,5,6,6,7,1,1.0,1,-1,3,1,4,2,0
287,5.830374160328427,5.3727856890575305,5.519521289580577,4.85726693997512,5.49301071424742,6.08357582704441,5.690303075957942,482605.29054054053,7,E01000292,6,3,4,5,6,7,5.708830800632502,5.179724506083751,5.682206357085465,4.824076482913638,5.520328033690484,6.19940642542487,5.762708547131327,617482.1409395973,7,4,6,2,8,8,8,1.0,0,-2,3,-2,3,2,1
288,5.862290683217074,5.18971553023573,5.695640138306543,4.743590744378055,5.581876097549318,6.2835856644895065,5.737789885535914,474355.8795811518,7,E01000293,3,6,2,7,9,8,5.828508930736118,5.042561725775401,5.8096790585252975,4.769838758309683,5.587149029307895,6.272348827785915,5.7948994292153255,607672.0833333334,8,2,8,1,9,9,8,1.0,1,-1,2,-1,2,0,0
289,5.744524732844471,5.429603043484361,5.526673558640153,4.792206155110712,5.587738537625091,6.089114701911194,5.47911090393589,482947.7465753425,6,E01000294,7,3,3,7,6,4,5.669307454772618,5.183515336202539,5.698637913966524,4.77317434290181,5.551275783690853,6.196294677430305,5.653595546881358,617941.9565217391,6,4,6,1,8,8,6,1.0,0,-3,3,-2,1,2,2
290,6.201055818880108,5.03471603108124,5.9895268443604595,4.622086775134987,5.684744505815103,6.536455325677362,5.940575830533471,456489.6408450704,9,E01000295,1,9,0,9,9,9,5.919530678450856,5.025394505241892,5.836589578910382,4.735505297421589,5.479225191463719,6.446583174348287,6.055770568421616,584194.4845360825,8,2,8,0,7,9,9,1.0,-1,1,-1,0,-2,0,0
291,5.667821524094562,5.171743765169261,5.74989238888228,4.800191566246707,5.5080528916144855,6.10059744322381,5.637827515602112,456895.48979591834,5,E01000296,3,7,3,5,6,6,5.705042419258071,5.057107760130993,5.672392497033429,4.847047682188771,5.39490177660632,6.066096610818173,5.647000520507251,584741.0981595092,7,2,6,2,5,6,6,1.0,2,-1,-1,-1,0,0,0
292,5.855938542516608,5.232944297790527,5.638967431219,4.769146478803534,5.464446235957898,6.182753299411974,5.552731109920301,455781.1473684211,7,E01000297,4,5,2,4,8,5,5.6181620076759575,5.28584972730617,5.603213243877764,4.962724391947088,5.356545168099944,6.097854123902075,5.641423331093542,583385.8969072165,5,6,5,4,4,7,6,1.0,-2,2,0,2,0,-1,1
293,5.911866980729644,5.058405170735624,5.851460057435577,4.7343822146199415,5.665518718896453,6.202328572568205,5.679887923997702,456089.40721649484,8,E01000298,2,8,2,8,8,7,5.722944474864651,4.981215749560175,5.731467591105281,4.854086257315971,5.414668455639401,6.142053419834859,5.7306965376879715,583723.1081081082,7,1,7,2,5,8,7,1.0,-1,-1,-1,0,-3,0,0
294,5.578644924335651,5.074352141973135,5.763905205168165,4.860164815241152,5.52096829328451,6.016412853120683,5.409325002550005,455216.1081081081,4,E01000299,2,7,4,6,5,3,5.386616362134616,5.038308147589365,5.8077757080396015,5.056604239344597,5.253563009699186,5.8589220404624935,5.502644820014636,582640.175,3,2,8,6,2,2,3,1.0,-1,0,1,2,-4,-3,0
295,6.044867458088057,4.969437019101211,5.832888850143978,4.612269005605152,5.656554452010563,6.35288981454713,5.805517258388655,455867.8660714286,9,E01000300,1,8,0,8,9,8,5.854042951725731,5.018611859684148,5.783293046241949,4.811040312790674,5.479195175092082,6.269544250708966,5.788295703485978,583429.1818181818,8,2,7,2,7,9,8,1.0,-1,1,-1,2,-1,0,0
296,5.827580124139786,5.1841567449949,5.730138610709798,4.768472110005942,5.578559795563871,6.2602345022288235,5.733721435747364,456333.4090909091,7,E01000301,3,6,2,7,8,8,5.695199427909629,5.21328158226124,5.607559119546136,4.843527633783429,5.43054567381393,6.190267847027889,5.883948398190875,584016.7616279069,6,5,5,2,6,8,9,1.0,-1,2,-1,0,-1,0,1
297,5.821486983980451,5.211596721694583,5.688661041713896,4.731766155787876,5.656597759988573,6.105896050967868,5.699395678346119,455878.0,7,E01000302,4,6,2,8,6,7,5.6205208603649925,5.24567086810935,5.622888274388771,5.022423585800276,5.413412598714436,6.009343437952538,5.6911800095479785,583437.8493150685,6,5,5,6,5,5,7,1.0,-1,1,-1,4,-3,-1,0
298,5.952319059573429,5.171260703617419,5.7757541999010975,4.7479875020577875,5.65845869460576,6.238088710207335,5.629977436132834,456892.58450704225,8,E01000303,3,7,2,8,8,6,5.623248150017088,5.290817578107316,5.639742488103197,4.869856860463982,5.449897425064188,6.193928925406854,5.719364720464542,584687.5960264901,6,6,5,3,6,8,7,1.0,-2,3,-2,1,-2,0,1
299,6.133929396497792,5.101476552157567,5.8877700896098695,4.650068485531314,5.711163494093665,6.420086581131508,5.669743585175481,459842.3362068966,9,E01000304,2,8,0,9,9,7,6.083772875760731,5.0698572052152535,5.769599514049396,4.703781623589365,5.586057562577097,6.293191483146266,5.714517552601664,588504.298245614,9,2,7,0,9,9,7,1.0,0,0,-1,0,0,0,0
300,5.195622128626657,5.601838474235837,5.156362071396813,5.240237194394308,5.141302336776067,5.544794199012575,5.146396624190467,469236.38095238095,0,E01000305,9,0,9,0,0,0,5.151333907865128,5.538269096050622,5.180635578227493,5.311490374241235,5.029095607883526,5.582290193269838,5.134208748025714,600144.0075471698,0,9,0,9,0,0,0,1.0,0,0,0,0,0,0,0
301,5.755062668522199,5.259541909893354,5.6153532346089685,4.851424372196197,5.46044374704361,6.172270958622296,5.560594689846039,470564.7,6,E01000306,4,5,4,4,7,5,5.609593782160017,5.0842001958498875,5.608512795160687,4.946338501241472,5.317819375840444,6.113286446011256,5.4768459607684425,602023.8333333334,5,3,5,4,3,7,3,1.0,-1,-1,0,0,-1,0,-2
302,5.222805010975232,5.697683914216271,5.093114560660894,5.167654707161013,5.149338593773565,5.674009131922946,5.2218046627546615,465252.92243767314,0,E01000307,9,0,9,0,0,0,4.941253667316218,5.74481748027363,4.9779265022825925,5.423764288288424,4.920948382081656,5.519811384705291,5.069550277720923,594699.2183908046,0,9,0,9,0,0,0,1.0,0,0,0,0,0,0,0
303,5.633264815684447,5.4454697948141195,5.342925836130516,5.010056571862132,5.410995630873847,5.8156492501190025,5.4378352042325995,472070.21649484534,5,E01000308,7,1,7,3,2,3,5.406194461019416,5.34176351626714,5.432244086474703,5.073545345088892,5.249188492172642,5.7382486661275225,5.368290502774088,603994.4824561403,3,7,2,7,2,1,1,1.0,-2,0,1,0,-1,-1,-2
304,5.686056997854385,5.350360980615929,5.459389356940005,4.90512988433032,5.47900222780559,6.0776360482677045,5.722047427450547,470316.1784037559,5,E01000309,6,2,5,5,6,8,5.610373434977294,5.327897516311024,5.480493559556849,5.077934145388021,5.341750842413751,6.004492636719441,5.6786435135888835,601711.6470588235,5,7,2,7,4,5,6,1.0,0,1,0,2,-1,-1,-2
305,5.421924702475004,5.382992164553883,5.423916666307182,5.039253523973661,5.322033749005505,5.896482619726769,5.545121619634539,464786.58411214955,2,E01000310,7,2,7,1,3,5,5.3376049452680885,5.366332356038132,5.379632251534035,5.188923643856514,5.150733999605102,5.796759722194051,5.401438878803718,594691.6829268293,2,7,1,8,0,1,2,1.0,0,0,-1,1,-1,-2,-3
306,5.671822886980936,5.284171999571566,5.546145307803583,4.835847365642023,5.459924718576991,6.124287365439409,5.620689342835706,462203.41916167666,5,E01000311,5,4,4,4,7,6,5.6879288900911416,5.1129836101157995,5.6988264953388885,4.826403573447583,5.451765806846369,6.102346248876035,5.576059328185187,591253.6013071896,6,3,6,2,6,7,5,1.0,1,-2,2,-2,2,0,-1
307,5.625323111102695,5.543083095834369,5.453733668440864,4.846764764615467,5.455627491076787,6.024206607114701,5.543025949171612,472492.1785714286,5,E01000312,9,2,4,4,5,5,5.568277595043182,5.447241826057434,5.486908712387085,4.877662668228149,5.3385357403755185,5.956102240085602,5.579074599742889,604440.78,5,8,2,3,3,4,5,1.0,0,-1,0,-1,-1,-1,0
308,5.442366501431406,5.392408037627185,5.337494955386645,5.114430535722662,5.3018858476921364,5.8308626825426835,5.4482577398971275,471085.16049382713,2,E01000313,7,1,8,1,2,3,5.3057189231569115,5.350069862875071,5.3193689774383195,5.173259389671412,5.126330781389367,5.751568908041174,5.339874814857136,602678.7215909091,2,7,0,8,0,1,1,1.0,0,0,-1,0,-1,-1,-2
309,5.706462157228605,5.1566050547719655,5.692662924365267,4.8995340443699735,5.515759813329561,6.088310151803689,5.7375545078288015,469529.7431693989,5,E01000314,3,6,5,5,6,8,5.378798855992848,5.122999247676598,5.619508347825376,5.082238646324523,5.258685486045426,5.914721369029519,5.498150273711381,600587.4191616767,2,3,5,7,2,3,3,1.0,-3,0,-1,2,-3,-3,-5
310,5.497398619381887,5.598336566731615,5.308900464255855,5.063300860377978,5.363336830206637,5.840443138806325,5.310062430939585,409972.53301886795,3,E01000315,9,1,8,2,2,1,5.458474822044373,5.552787835862901,5.232460683186849,5.132806355688307,5.190546740955777,5.832535814709134,5.4443485175238715,523195.3155555556,3,9,0,8,1,2,2,1.0,0,0,-1,0,-1,0,1
311,5.714248187717844,5.386786236626203,5.433441133284178,4.898696844206482,5.4114178111318685,5.9436548313156505,5.404663544209277,452573.73360655736,6,E01000316,7,2,5,3,4,2,5.626193432826695,5.374360312627056,5.364242745196726,4.996399171709076,5.2259939796342625,5.950648915110611,5.515785136560756,579033.2007874015,6,7,1,5,1,4,4,1.0,0,0,-1,0,-2,0,2
312,6.014433055877686,5.140093505859375,5.8435181026458745,4.706846278190612,5.622726963043213,6.314511499404907,5.7481517400741575,455517.544,8,E01000317,3,8,1,8,9,8,5.752118003460788,5.168275296226028,5.722392488819684,4.854254586752071,5.454655508662379,6.181592787883078,5.857654888500539,583013.3100775194,7,4,7,2,6,8,9,1.0,-1,1,-1,1,-2,-1,1
313,5.828394203734913,5.177057810824552,5.776281512898507,4.827522302703034,5.6463006280309,6.2315436781739155,5.729287114932383,440902.1726618705,7,E01000318,3,7,3,8,8,8,5.622532202980735,5.251926518931533,5.686085268222924,4.939338733933189,5.3698314312732585,6.170678075154623,5.734924543265141,567863.9515151515,6,5,6,4,4,8,7,1.0,-1,2,-1,1,-4,0,-1
314,6.0557984153429665,5.0914293540848625,5.953587055206299,4.673888859483931,5.663227846887376,6.447062659263611,5.791541797584958,455626.0777777778,9,E01000319,2,9,1,8,9,8,5.786432227492332,5.116477650403977,5.772158944606781,4.8031443566083905,5.441491061449051,6.31243808567524,5.928520466387272,583148.4875,7,3,7,1,6,9,9,1.0,-2,1,-2,0,-2,0,1
315,6.141051116405717,5.048498643324679,5.955698539746687,4.613645790407322,5.82527501951128,6.43978328832844,5.947796051134199,453209.80536912754,9,E01000320,1,9,0,9,9,9,5.83647865535569,5.100056808360302,5.772115024336933,4.827134046241315,5.536339899049188,6.150796023598553,5.732558892591157,579978.9562043796,8,3,7,2,8,8,7,1.0,-1,2,-2,2,-1,-1,-2
316,5.729060670603877,5.1029001660968945,5.765060083762459,4.778591054418813,5.534502435767132,6.187483119964599,5.65945129290871,453426.37391304347,6,E01000321,2,7,2,6,8,7,5.5265504421887695,5.162078498126744,5.71744801614668,4.947967826069652,5.398084487114753,6.022933091317023,5.618705399386533,580273.7482517483,4,4,7,4,5,6,5,1.0,-2,2,0,2,-1,-2,-2
317,6.105557798407972,5.209126278758049,5.829046554863453,4.629882010631263,5.633520163595676,6.309215813875198,5.766991266980767,452719.46875,9,E01000322,4,8,0,8,9,8,5.730187306532988,5.304736390307143,5.628223969324215,4.86584812080538,5.454933154421884,6.102775262819754,5.702328187388343,579529.527027027,7,6,5,3,6,7,7,1.0,-2,2,-3,3,-2,-2,-1
318,5.78100615421931,5.094963165124257,5.858040334383647,4.8248962648709615,5.528274463017781,6.131532939275106,5.656879010200501,454717.18,6,E01000323,2,8,3,6,7,7,5.512865303560745,5.091931530209475,5.691772832426914,5.0178527478561845,5.342285814673402,5.919345808583636,5.525777365579161,582035.3488372093,4,3,6,6,4,4,4,1.0,-2,1,-2,3,-2,-3,-3
319,5.921085018325936,5.186607939275828,5.7739493440498,4.767394380135969,5.635397624563087,6.241457104682922,5.740494291213426,442723.67045454547,8,E01000324,3,7,2,8,8,8,5.630379460015139,5.185914374969818,5.706077744672586,4.886099548785241,5.3734575896472725,6.140036000000252,5.641771192079062,567753.956043956,6,4,6,3,4,8,6,1.0,-2,1,-1,1,-4,0,-2
320,5.555010285428775,5.488485122239718,5.53979689587829,4.951957771214106,5.435952219270891,5.964579173313674,5.542057621863581,377440.4516129032,4,E01000325,8,3,6,3,4,5,5.567344844341278,5.279675388604067,5.651485270328736,4.89213035816557,5.492324267210585,6.071870343069012,5.604035992300912,483531.8370786517,5,6,5,3,7,7,5,1.0,1,-2,2,-3,4,3,0
321,5.506651763147956,5.253051288175903,5.474246685936947,5.112913476540738,5.40259911389959,5.949566865127359,5.605895179230095,377231.8926174497,3,E01000326,4,2,8,3,4,6,5.4217536522917555,5.261266848812364,5.54804447089156,5.109841826843889,5.382220481356529,5.97294118633009,5.5991856023056865,483259.15753424657,3,5,3,7,5,5,5,1.0,0,1,1,-1,2,1,-1
322,5.546396983796685,5.498974413421023,5.459952803393501,4.908995235144203,5.403681848772723,5.992220285520031,5.5898665942955965,377473.9701492537,4,E01000327,8,2,5,3,4,6,5.466582380946557,5.402705481303996,5.5294425954770805,5.069550081713116,5.339644465015162,5.9998416672998935,5.7299087233279815,483473.5728643216,4,8,3,7,3,5,7,1.0,0,0,1,2,0,1,1
323,5.595971834950331,5.474699753086742,5.415616333193896,4.994601761422506,5.428047863448539,5.933046139740362,5.557074149643503,379391.47804878047,4,E01000328,8,2,6,3,3,5,5.5309213485473245,5.369215715237153,5.556424244856223,4.8885054337672695,5.420825991263756,6.022009371488522,5.691207890021495,485819.6615384615,4,7,4,3,6,6,7,1.0,0,-1,2,-3,3,3,2
324,5.528120093792677,5.4653746545314785,5.448508647829295,5.022673957049847,5.396412885934114,5.996886537969113,5.470560636371374,381558.125,3,E01000329,8,2,7,3,4,4,5.352231290233269,5.385227818837326,5.470577185073595,5.055259636948618,5.307826109146804,5.9518104510360885,5.531357583035244,488396.82584269665,2,8,2,6,3,4,4,1.0,-1,0,0,-1,0,0,0
325,5.333444001124455,5.516104021439186,5.373024283922636,5.073186075993073,5.309633076496613,5.8863430255498645,5.324321220471309,378146.3076923077,1,E01000330,8,1,8,1,3,1,5.314600448968799,5.458082818014677,5.406554524288621,5.145243838082912,5.223092576792074,5.841154939906541,5.446733016607373,484309.6046511628,2,8,1,8,1,2,2,1.0,1,0,0,0,0,-1,1
326,5.804228740907365,5.505719694182103,5.304966284607171,4.915625935398651,5.423923124599086,5.908977802625426,5.481295931663959,380950.12062256807,7,E01000331,8,0,5,3,3,4,5.808520871024149,5.388008535129873,5.341276151096954,4.875960514447946,5.4557803213374765,5.99465949296065,5.6219416289524515,485805.3308550186,8,8,1,3,6,5,5,1.0,1,0,1,-2,3,2,1
327,5.463284962399062,5.504515173130257,5.235512148502261,5.058892526598864,5.356300795494124,5.7573207187098125,5.383393130330152,367791.6976744186,3,E01000332,8,0,8,2,1,2,5.5545568640312455,5.330773851844702,5.439426031675231,4.924026391479407,5.338691810543618,5.936568487896008,5.63287094134963,470877.7696629214,5,7,2,4,3,4,6,1.0,2,-1,2,-4,1,3,4
328,5.3108246535200125,5.399209981689805,5.407978034788562,5.060470340438702,5.34312515928998,5.74664554837662,5.228736511023913,366543.1013824885,1,E01000333,7,1,8,2,1,0,5.440362981305673,5.301410413705385,5.51601531700446,4.945970746760185,5.377404997555109,5.870734729445898,5.472323939777338,469542.3653846154,3,6,3,4,4,3,3,1.0,2,-1,2,-4,2,2,3
329,5.2805536815098355,5.636387760298593,5.335226077692849,5.078097813470023,5.232208614689963,5.7503837704658505,5.269075605698994,364459.77857142856,1,E01000334,9,1,8,0,1,1,5.148830686436325,5.506519467127128,5.3116686031466624,5.273559281083404,5.189969770243911,5.841506832935771,5.500332741463771,466823.0655737705,0,9,0,9,1,2,3,1.0,-1,0,-1,1,1,1,2
330,5.239243492094751,5.710878183892674,4.982064869794597,5.2599267172417,5.1266077807850055,5.611599003617384,5.036294008094171,368777.9596199525,1,E01000335,9,0,9,0,0,0,5.386050236537467,5.578855858879839,5.109024059824548,5.219661939872925,5.148635817407,5.662420994850225,5.231914195951936,472463.9257641921,3,9,0,9,0,0,0,1.0,2,0,0,0,0,0,0
331,5.215272746235132,5.493785559386015,5.331943826377392,5.120070364326239,5.250629191845656,5.699792045354843,5.17839016392827,366015.45625,0,E01000336,8,1,8,0,0,0,5.300399878403035,5.31436344545062,5.444639585367063,4.993133438069646,5.285560828156587,5.843715654640663,5.389317053847197,468723.2195121951,1,6,2,5,2,2,1,1.0,1,-2,1,-3,2,2,1
332,5.263057322235581,5.50356914389948,5.367938226054174,5.078670874885891,5.278629133419961,5.826370280721913,5.281328447857258,364144.5652173913,1,E01000337,8,1,8,1,2,1,5.3764782620083755,5.332596861632767,5.46786304795818,5.035594429939416,5.274350745662762,5.821183298044144,5.510437930465504,466331.7452229299,2,7,2,6,2,2,3,1.0,1,-1,1,-2,1,0,2
333,5.483236718844701,5.427688140135545,5.465517464217606,4.94736489882836,5.350060130332733,5.924550524958364,5.437864993835663,367011.62237762235,3,E01000338,7,2,6,2,3,3,5.445858752316442,5.268933049563704,5.496244005499215,4.935570855798392,5.348834455424342,5.942149499367023,5.505756679074517,469738.55862068967,3,6,3,4,4,4,3,1.0,0,-1,1,-2,2,1,0
334,5.650649850416666,5.472033683097724,5.55845797302747,4.855052562073023,5.60948648777875,6.098523561400596,5.484619382053915,299679.99494949495,5,E01000339,8,4,4,7,6,4,5.630067062495377,5.35276567818496,5.572216726876245,4.8440437851281,5.476141123936094,6.179849549467341,5.721116531658643,384682.4088669951,6,7,4,2,7,8,7,1.0,1,-1,0,-2,0,2,3
335,5.320007187704886,5.434554483941806,5.5047653259769564,5.0573144497409945,5.359916710084485,5.909869500385818,5.412320738197655,385446.5752688172,1,E01000340,7,3,8,2,3,3,5.169342200913115,5.361402562278474,5.5018536844653285,5.114293191961186,5.2829059919197405,5.950113119479425,5.519884328642291,493483.0479041916,0,7,3,7,2,4,4,1.0,-1,0,0,-1,0,1,1
336,5.457482906693187,5.512699113211818,5.456619242716102,4.99332901219416,5.420080091034234,5.963476408793274,5.428474797882847,384831.9888268156,3,E01000341,8,2,6,3,4,3,5.39905253390676,5.408530865133423,5.45176861519666,5.005557473172846,5.342429266762488,5.998199187603193,5.5783558967187235,492666.1649484536,3,8,2,5,4,5,5,1.0,0,0,0,-1,1,1,2
337,5.566666313710104,5.422469832514989,5.703177256438568,4.8626381941424075,5.507930067659334,6.090961918576073,5.66473336984183,385103.5801526718,4,E01000342,7,6,4,5,6,7,5.606944327769072,5.335771866466688,5.595439758853636,4.892321485540141,5.406271547511004,6.109646874925365,5.722169476142828,493021.7173913043,5,7,4,3,5,7,7,1.0,1,0,-2,-1,0,1,0
338,5.502765386744782,5.360153772212841,5.641139164015099,4.909664150741365,5.487328849456929,6.038055776445954,5.573546044252537,383988.52314814815,3,E01000343,6,5,5,5,5,5,5.474175172760373,5.252628797576541,5.6279217220488045,4.898340997809456,5.445561428864797,6.122138829458327,5.725089140165419,491615.4619047619,4,5,5,3,6,7,7,1.0,1,-1,0,-2,1,2,2
339,5.541364472845326,5.3643723452313345,5.574162232949867,4.894301724730071,5.482745499344346,6.0761617014867175,5.419454316174762,314490.5403726708,4,E01000344,6,4,5,5,6,3,5.529159834053343,5.285623877253753,5.535291678068654,4.844801779614379,5.350821701896112,6.143844293442783,5.720886978882038,398970.940397351,4,6,3,2,4,8,7,1.0,0,0,-1,-3,-1,2,4
340,5.661695393939946,5.306667827119763,5.627321096074661,4.832587507747164,5.634502959731441,6.163624070634778,5.596652306166272,313845.9865771812,5,E01000345,5,5,4,8,7,6,5.729314970619538,5.200329036397092,5.690344668486539,4.752980623175116,5.514472528415568,6.278573123847737,5.84189526210813,406895.9632352941,7,4,6,1,8,9,9,1.0,2,-1,1,-3,0,2,3
341,5.545390366327645,5.3013977479226515,5.64234478048759,4.909560080802087,5.533719340173325,6.1954881035455385,5.558024466627895,379031.099009901,4,E01000346,5,5,5,6,8,5,5.561195140820371,5.336645163417433,5.578109916887786,4.94847327898564,5.469626904104315,6.149698900263846,5.654503194338967,486965.9186602871,5,7,4,4,7,8,6,1.0,1,2,-1,-1,1,0,1
342,5.480050940539956,5.297151779601587,5.719136746548816,4.932551040175212,5.579994833271806,6.078061700525863,5.651567212125873,382798.9502762431,3,E01000347,5,6,5,7,6,7,5.361104989181394,5.231173606022544,5.726680841134942,4.997219229521959,5.414046136581379,6.141560842161593,5.784876078367233,490124.45108695654,2,5,7,5,5,8,8,1.0,-1,0,1,0,-2,2,1
343,5.761344659669058,5.366155039923532,5.549328565597534,4.840203860146659,5.5151870168958395,6.0858112335205075,5.707223971911839,377314.9942857143,6,E01000348,6,4,4,5,6,7,5.47785280935863,5.323231158171885,5.518152818877316,4.888257070405949,5.343337201507839,6.032190582455968,5.809615157059664,487873.1656804734,4,7,3,3,4,6,8,1.0,-2,1,-1,-1,-1,0,1
344,5.592012973105321,5.51307011432335,5.375330697806155,4.944863130323222,5.385018757132233,5.898049443471627,5.4452322037493595,387209.4713114754,4,E01000349,8,1,6,2,3,3,5.462269756960314,5.424740376583365,5.411584287466005,5.021588696989903,5.307697314439818,5.991774861757145,5.678757287180701,495796.4511627907,4,8,1,6,3,5,6,1.0,0,0,0,0,1,2,3
345,5.7567933209334745,5.370163785505898,5.686838590646092,4.731111052670056,5.6332329783258555,6.283659699596936,5.749638736248016,355672.82911392406,6,E01000350,6,6,2,8,9,8,5.770377879018907,5.268463511745651,5.709286273299874,4.750865113425564,5.578439994291826,6.312977035324295,5.928837232001416,459733.2727272727,7,6,6,1,9,9,9,1.0,1,0,0,-1,1,0,1
346,5.5751518368721005,5.444371449246126,5.568285006635329,4.87821035525378,5.433303985876195,6.078944115077748,5.59720009284861,339032.8058823529,4,E01000351,7,4,4,3,6,6,5.450251096238692,5.408339074502389,5.504818996414542,5.115121180191636,5.303146753460169,5.993339419364929,5.68106684833765,439070.7916666667,3,8,3,7,3,5,7,1.0,-1,1,-1,3,0,-1,1
347,5.3680133504867555,5.619551077365875,5.272904500961304,5.1124609484672545,5.213855521678925,5.7873066487312315,5.359003867149353,381830.38,2,E01000352,9,0,8,0,1,2,5.339975648185834,5.479025946182459,5.301358432996841,5.13911987405245,5.203089464278448,5.868743331253934,5.455332993650112,488774.64285714284,2,9,0,8,1,3,2,1.0,0,0,0,0,1,2,0
348,5.449966180793062,5.49045214434378,5.43236370482299,5.043417517274748,5.388834698231459,5.936574612121915,5.554793610843508,373848.5982532751,3,E01000353,8,2,7,3,3,5,5.253086384922389,5.431148852831051,5.367883353566927,5.152220202080997,5.258897095060152,5.9178396340750865,5.659283474149037,478934.670781893,1,8,1,8,2,3,6,1.0,-2,0,-1,1,-1,0,1
349,5.395643477892354,5.431225352043653,5.423186023740003,4.983888846244255,5.32995429178224,6.010295307549247,5.407020478353013,373298.70802919706,2,E01000354,7,2,6,1,5,3,5.244942596578222,5.483337013740239,5.390772237552433,5.103673433694314,5.168855085147648,5.962784145760724,5.598000630619019,478007.6535433071,1,9,1,7,0,4,5,1.0,-1,2,-1,1,-1,-1,2
350,5.4346283575923175,5.50198638131938,5.390496719743788,5.090211132138045,5.31339610053092,5.879853840955754,5.467040834353142,373922.3969072165,2,E01000355,8,1,8,1,3,4,5.403730721674233,5.482173861187195,5.367215696339295,5.090687765696338,5.255819022655487,5.89762425534079,5.53465529468572,479426.9672897196,3,9,1,7,2,3,4,1.0,1,1,0,-1,1,0,0
351,5.242028393786707,5.377131967833548,5.4388029554705595,5.027725372995649,5.323657138007028,5.945705335377615,5.554308007805894,376998.5974025974,1,E01000356,6,2,7,1,4,5,5.156661300409224,5.36121610816448,5.3891882781059515,5.1727675189895015,5.208563046589974,5.923855441231882,5.5703107248390875,482853.7983870968,0,7,1,8,1,4,4,1.0,-1,1,-1,1,0,0,-1
352,5.3145479585370445,5.245546707740197,5.634720433471549,5.070539303314992,5.3837382548894634,6.083551311085367,5.659470313634628,379423.7094017094,1,E01000357,4,5,8,2,6,7,5.286097778993494,5.23051368388809,5.703581519487526,5.044943924711532,5.331881398914241,6.046831978469336,5.655708573445552,485879.18487394956,1,5,6,6,3,6,6,1.0,0,1,1,-2,1,0,-1
353,5.433579737040663,5.3110286151806925,5.535277188750746,5.0048159848840745,5.371919108795996,6.034839074228712,5.48698870938059,376611.01554404147,2,E01000358,5,3,7,2,5,4,5.207327658300242,5.40256596797079,5.481552812275965,5.11569724359565,5.225549295462297,5.988533619359053,5.565725885043487,482449.0607734807,1,8,2,7,1,5,4,1.0,-1,3,-1,0,-1,0,0
354,5.1509119756519794,5.380439617484808,5.411963273584843,5.112427596747875,5.281628916412592,5.9066576436161995,5.473907803744078,370865.175,0,E01000359,7,1,8,1,3,4,5.283257869225514,5.304553863368457,5.520735870433759,5.063545961168748,5.224803256837627,5.977962386759022,5.693946532056302,475340.63924050634,1,6,3,7,1,5,7,1.0,1,-1,2,-1,0,2,3
355,5.2376157617394306,5.359314729005862,5.38265431189275,5.10837327735328,5.222667770944672,5.759722167318994,5.2921134141775275,378582.7802197802,0,E01000360,6,1,8,0,1,1,5.231497961772631,5.29630259087641,5.4320754751767195,5.118058904801329,5.210332136039865,5.7746856653527034,5.250349723721204,484857.22602739726,1,6,2,7,1,1,0,1.0,1,0,1,-1,1,0,-1
356,5.376117065252847,5.429252516354946,5.415128966830424,5.062405045458813,5.283883742938768,5.926965067718203,5.418113380867914,380670.93377483444,2,E01000361,7,2,8,1,3,3,5.330998074156898,5.306265463999339,5.4842206767627175,5.0384023462023055,5.285899343660899,5.964358052185603,5.542946416991097,488294.42142857146,2,6,2,6,2,4,4,1.0,0,-1,0,-2,1,1,1
357,5.384391977673485,5.436372487059919,5.4258417938694805,5.092269710648112,5.2840276915273625,5.882235512588963,5.50450002992308,382926.8614718615,2,E01000362,7,2,8,1,3,4,5.311339368636005,5.426004920394636,5.49066779541867,5.1492225110786665,5.282220001896052,5.9499833675924805,5.604092764240478,490285.5407725322,2,8,2,8,2,4,5,1.0,0,1,0,0,1,1,1
358,5.567155797397141,5.459938199646705,5.359291988136494,4.961689509121718,5.306806369692878,5.905635521475193,5.447142698068534,384138.99115044245,4,E01000363,8,1,6,1,3,3,5.462753175652545,5.3639204491739685,5.346195835134258,5.0508377007816145,5.256887554085773,5.918312302879666,5.5167573260224385,491700.0956521739,4,7,1,6,2,4,4,1.0,0,-1,0,0,1,1,1
359,5.782652510729703,5.518599143895236,5.3883079320734195,4.868238609053872,5.419252452850341,5.920088370063088,5.421526323665272,387358.48,6,E01000364,8,1,4,3,3,3,5.683453767891698,5.491300226857998,5.33246302844694,4.910758486930156,5.374456108416487,6.003592226329266,5.657015816477321,495612.0,6,9,1,3,4,5,6,1.0,0,1,0,-1,1,2,3
360,5.496212551047682,5.481730814086658,5.415115093385707,4.984432796526222,5.329410245298673,5.938246745637009,5.367214368708307,377989.68156424584,3,E01000365,8,2,6,1,4,2,5.319806393311948,5.405585923365185,5.457369618878072,5.088845684212082,5.253557151677657,5.886240297434282,5.468705388356228,484128.10204081633,2,8,2,7,2,3,3,1.0,-1,0,0,1,1,-1,1
361,5.4699448563835835,5.407360681875504,5.491925327535619,5.058254350952923,5.327736505850114,5.9911444875645765,5.529067606211983,377829.91978609626,3,E01000366,7,3,8,1,4,5,5.255978169699608,5.396702465165425,5.473372493471418,5.135301623438379,5.258768664205015,5.927468719153569,5.408610202408776,483893.4827586207,1,8,2,8,2,4,2,1.0,-2,1,-1,0,1,0,-3
362,5.247081721961165,5.542694990861349,5.328342585590299,5.08528983393195,5.228954092750336,5.857682368608827,5.263944612535019,372291.5251396648,1,E01000367,9,1,8,0,2,1,5.375203175422473,5.272644687921573,5.530340543160071,4.913028736603565,5.392584394797301,6.015785988783225,5.603533831009498,477381.38974358974,2,6,3,3,5,5,5,1.0,1,-3,2,-5,5,3,4
363,5.397261220709722,5.5148727069223735,5.405733486763517,4.929953484606922,5.252870258532073,5.834591820724029,5.3028183279180885,375791.72180451127,2,E01000368,8,1,5,0,2,1,5.487001936565074,5.318504972975384,5.460324087808298,4.933429389036903,5.460813696994338,6.03041039880856,5.595444399257039,481433.57364341087,4,6,2,4,7,6,5,1.0,2,-2,1,-1,7,4,4
364,5.175554973541657,5.476206594119871,5.342086338583445,5.033786345079455,5.261067374593261,5.83252296420191,5.380097546329388,370125.4913294798,0,E01000369,8,1,7,0,2,2,5.195181488305673,5.373959385800636,5.416420237771396,5.113912824241594,5.240387241045634,5.929889381616965,5.556430933119237,474189.7126436782,1,7,1,7,1,4,4,1.0,1,-1,0,0,1,2,2
365,5.586514554879604,5.438296548525492,5.454510410015399,4.8371910963303,5.496113607210991,6.056953184421246,5.469160241347093,374636.1384615385,4,E01000370,7,2,4,5,6,4,5.620592256610313,5.271840630622393,5.571695031744711,4.871537923812866,5.560602918099821,6.116537226719803,5.661679753426755,479548.0393258427,6,6,4,3,8,7,6,1.0,2,-1,2,-1,3,1,2
366,5.2794348183201585,5.38685105123171,5.4731195590844965,5.028653405061582,5.30616676007829,5.9406139298183165,5.545086163573149,376520.98780487804,1,E01000371,7,2,7,1,4,5,5.371860993390827,5.227581864836588,5.558101124846178,5.155415973222325,5.344960463529377,5.972702488044783,5.6811087503598605,482250.5260115607,2,5,4,8,4,5,7,1.0,1,-2,2,1,3,1,2
367,5.4487107813013775,5.459807571648173,5.46958371807385,4.9860662435520595,5.40030288007218,5.977787694490025,5.375043349458992,367223.1040462428,3,E01000372,8,2,6,3,4,2,5.55293975647758,5.368598911341499,5.5252568258958705,4.930634276305928,5.443260859040653,6.115913232635049,5.618085249732522,470301.1,5,7,3,4,6,7,5,1.0,2,-1,1,-2,3,3,3
368,5.327707189983792,5.361111887296041,5.357150151994493,5.004769677586026,5.2344695991939965,5.840109968185425,5.279541577233209,372546.84444444446,1,E01000373,6,1,7,0,2,1,5.2418048593305775,5.321711240276214,5.550685305749217,5.076517706917178,5.2897427908835875,5.913189588054534,5.305577278137207,478383.0806451613,1,7,4,7,2,3,1,1.0,0,1,3,0,2,1,0
369,5.006716473422833,5.781226016514337,5.043773555755616,5.315800992766423,5.038529181480408,5.552557073422332,5.042240227870087,375044.5492537313,0,E01000374,9,0,9,0,0,0,5.051943295824844,5.609467485309702,5.118390897733975,5.360312915129647,5.033330422587099,5.630918646984044,5.151759171907881,480308.7168141593,0,9,0,9,0,0,0,1.0,0,0,0,0,0,0,0
370,5.064996944296928,5.673847087791988,5.10709818133286,5.35009705452692,5.094418280181431,5.610672925199781,5.109366189865839,380027.82738095237,0,E01000375,9,0,9,0,0,0,5.143181749458971,5.5390698642566285,5.196898667291663,5.227780233854535,5.190084362167052,5.745745462932806,5.273404719500706,486598.7816091954,0,9,0,9,1,1,0,1.0,0,0,0,0,1,1,0
371,5.227954170038534,5.489821355703265,5.385625293781591,5.1219185847182604,5.28597461553507,5.814734866452771,5.3965277269829155,378706.43604651163,0,E01000376,8,1,8,1,2,2,5.315669113275956,5.338911606340992,5.547247100038593,5.041954197851168,5.297310744013105,5.9463817854316865,5.5353035788957765,484564.0816326531,2,7,3,6,2,4,4,1.0,2,-1,2,-2,1,2,2
372,5.509304965584024,5.556590853385555,5.2667696348671775,5.0428119996219,5.324170091777172,5.79100760441382,5.285745504411679,379269.1213592233,3,E01000377,9,0,7,1,1,1,5.535852020695096,5.34782072078614,5.368777739434015,4.930779383296058,5.351087443601518,5.991152302424113,5.62464154958725,485696.3904761905,4,7,1,4,4,5,6,1.0,1,-2,1,-3,3,4,5
373,5.421479445952241,5.459623372042051,5.294233254207078,5.030411851982916,5.326611049393172,5.732441658614784,5.238727755764479,383601.40860215056,2,E01000378,8,0,7,1,1,1,5.381333723342676,5.383862093198213,5.323028799441221,5.095496733125737,5.243660511730386,5.755444591851544,5.394859199329532,489868.51318944845,3,8,0,7,1,1,2,1.0,1,0,0,0,0,0,1
374,5.567464913091352,5.4523007862029536,5.504073887486611,4.994605926544436,5.391397048581031,6.019438680525749,5.544598521724824,382347.2387096774,4,E01000379,8,3,6,3,5,5,5.702601476803722,5.215512499713258,5.602023447920012,4.877934911907119,5.4793337175510075,6.110737426168966,5.739892312344288,489511.44295302016,7,5,4,3,7,7,7,1.0,3,-3,1,-3,4,2,2
375,5.313656239320111,5.649224616044404,5.160678865104321,5.184413626493997,5.172839359731864,5.7039410720597825,5.334630645663533,376332.1854304636,1,E01000380,9,0,9,0,0,1,5.338580669920429,5.430467943740047,5.299265411944171,5.039788807918823,5.227703852591172,5.850407685329712,5.535340196166942,482105.13071895426,2,8,0,6,1,2,4,1.0,1,-1,0,-3,1,2,3
376,5.868430855502821,5.596940113746957,5.272658552862193,4.813938557285152,5.542479341324062,5.8770101050808,5.3944196658591705,299638.7095890411,7,E01000381,9,0,3,6,2,2,5.91290702807006,5.44032566810167,5.323378421606556,4.787977448714677,5.452568571093262,5.910522434019273,5.467422691404178,384618.84139784944,8,8,0,1,6,3,3,1.0,1,-1,0,-2,0,1,1
377,5.863743152985206,5.474534694353739,5.52049144475888,4.820644587736863,5.613097108938756,6.134000312365019,5.693923345590249,302236.8051282051,7,E01000382,8,3,3,8,7,7,5.824109441840772,5.334414851419704,5.544066776934359,4.7894715666770935,5.5743307360668775,6.137345826502928,5.801742304846184,387683.8453608247,8,7,3,1,9,8,8,1.0,1,-1,0,-2,1,1,1
378,5.636661091400066,5.701727838104308,5.159881137116417,4.928658048519914,5.443042230855732,5.834355090925206,5.313185561701889,306624.97643979057,5,E01000383,9,0,5,4,2,1,5.779241838126347,5.538907644940519,5.26197662819391,4.9194727626340145,5.419407762604198,5.932787001818076,5.362617792480293,395003.016091954,7,9,0,4,6,4,1,1.0,2,0,0,-1,2,2,0
379,5.765617548250685,5.319281559364469,5.605160519967671,4.84192779329088,5.52116501565073,6.099150919446759,5.608505806112601,305856.4117647059,6,E01000384,5,4,4,6,6,6,5.672054459522297,5.163691224215866,5.731263114260389,4.82791012835193,5.484801156954332,6.127764975869811,5.683848494833166,392639.52597402595,6,4,7,2,7,7,7,1.0,0,-1,3,-2,1,1,1
380,5.438014405186166,5.5424921306376715,5.318475695099005,5.049112116234212,5.346120631141502,5.851608308558726,5.346771969070917,312231.7848101266,2,E01000385,9,1,7,2,2,2,5.455856094064639,5.408536201299623,5.430701362532239,4.987105506335118,5.415966136510982,5.935528137887171,5.3903848288595215,401026.5465116279,3,8,2,5,5,4,2,1.0,1,-1,1,-2,3,2,0
381,5.465913870610481,5.629506052525575,5.132876585830342,5.08146846146623,5.289923840317845,5.617672517279948,5.17521008873774,309558.7727272727,3,E01000386,9,0,8,1,0,0,5.471700913279596,5.5213781403799125,5.100149878185161,5.123645056338206,5.212108282712254,5.68412738603397,5.293338337083803,397450.2773722628,4,9,0,8,1,0,0,1.0,1,0,0,0,0,0,0
382,5.407907664775848,5.449939828603826,5.444300916600735,5.007248749758335,5.446166714455219,5.90413000482194,5.4098141129980695,300212.3510638298,2,E01000387,8,2,7,4,3,3,5.426072473327319,5.360369433338444,5.528039563447237,4.956939382478595,5.439549880723159,5.98008801912268,5.585955249766509,385370.5208333333,3,7,3,4,6,5,5,1.0,1,-1,1,-3,2,2,2
383,5.5871710809071855,5.415644702911377,5.395065658887227,5.016506660249498,5.382916050487094,5.964915298885769,5.471482151349385,382389.64444444445,4,E01000388,7,1,7,2,4,4,5.407789627890781,5.278220173999735,5.468985539216262,4.997257624816031,5.33702777737406,5.967468642541187,5.49187708656173,489529.5113122172,3,6,2,5,3,4,3,1.0,-1,-1,1,-2,1,0,-1
384,5.670332645621535,5.416242087903044,5.473056127137667,4.929458462603958,5.377071959020846,6.015974144229975,5.544847828390353,380413.9192825112,5,E01000389,7,2,5,2,5,5,5.559370883911715,5.353662342768613,5.499546476543752,4.992855444082765,5.402054962021353,6.011607373241886,5.630121418713454,487089.87443946186,5,7,3,5,5,5,6,1.0,0,0,1,0,3,0,1
385,5.5185030012914575,5.615024329320481,5.242852192491157,5.0386972242294386,5.235682070527447,5.763821365626435,5.436143918124508,381402.2876712329,3,E01000390,9,0,7,0,1,3,5.39633788424057,5.452038757970643,5.30716760487736,5.084869853123461,5.191261690032033,5.863664530311169,5.474356904688241,488239.230125523,3,8,0,7,1,2,3,1.0,0,-1,0,0,1,1,0
386,5.202774024492985,5.678755570102382,5.204111267586012,5.302432259997806,5.178504721538441,5.716595113277435,5.260377686571431,383135.1554054054,0,E01000391,9,0,9,0,1,1,5.1255744611515714,5.546544929111705,5.27902747112162,5.268970014768488,5.023894272131078,5.811674190970028,5.433322516609641,490532.20588235295,0,9,0,9,0,2,2,1.0,0,0,0,0,0,1,1
387,5.2533779797783815,5.394225990197745,5.411993464791631,5.127623808671193,5.263904325933342,5.819367726883256,5.336238173835249,382049.4698795181,1,E01000392,7,1,8,1,2,2,5.174840512822886,5.261539526324454,5.478891507523959,5.141664803353815,5.235375107311811,5.805950791457963,5.361088959897151,489161.6612021858,0,6,2,8,1,2,1,1.0,-1,-1,1,0,0,0,-1
388,5.565682729085286,5.291928347894701,5.5753957699921175,4.922250393420289,5.417389986878734,6.02596270162507,5.609138094099228,381419.94350282487,4,E01000393,5,4,5,3,5,6,5.462595052980072,5.296827812099931,5.582384984884689,4.966392257320347,5.306548198657249,6.0193908226430715,5.591263615669896,488319.75124378107,4,6,4,5,3,6,5,1.0,0,1,0,0,0,1,-1
389,5.486257994567955,5.420852257000221,5.415798846836928,5.077703971129197,5.338989198862851,5.897468853782821,5.451020951454456,378787.6868131868,3,E01000394,7,2,8,2,3,3,5.323210351641586,5.370255052752611,5.440474841652847,5.144682007882653,5.3316241415535535,5.955021926833362,5.523900460033882,485006.09268292686,2,7,2,8,3,4,4,1.0,-1,0,0,0,1,1,1
390,5.607386695562735,5.349629503030044,5.616937339658568,4.951264074568212,5.434299574095822,6.137983312268229,5.805918666738025,385664.8461538461,4,E01000395,6,5,6,3,7,8,5.466014942815227,5.296698026503286,5.555343401047491,4.9784463128735945,5.389642935414468,6.16347331846914,5.907426595687866,493843.5741935484,4,6,4,5,5,8,9,1.0,0,0,-1,-1,2,1,1
391,5.606716728210449,5.256179024433267,5.722850602248619,4.912715382411562,5.453592376051278,6.159182783652996,5.821896567015813,385504.29655172414,4,E01000396,4,6,5,4,7,9,5.47079354635677,5.273110011349553,5.66670234603171,4.905934148693677,5.379696302532409,6.157721743080186,5.952690214103794,493728.9689440994,4,6,6,3,4,8,9,1.0,0,2,0,-2,0,1,0
392,5.422742280652447,5.59071787095839,5.412630964094593,4.974944599982231,5.328898523699853,6.019716539690571,5.378047300923255,373291.03225806454,2,E01000398,9,2,6,1,5,2,5.410678369658334,5.278022024461201,5.597348870549883,4.957834832157407,5.379361177342279,6.1122050353458945,5.619436134610857,477992.7642857143,3,6,4,4,4,7,5,1.0,1,-3,2,-2,3,2,3
393,5.55216592956673,5.38144321671941,5.462170461362058,5.0114298591559585,5.419135636904023,6.05042359910228,5.578172814439643,384036.20454545453,4,E01000399,7,2,7,3,5,5,5.47860538175968,5.338886089168244,5.497474630114058,5.023257589676011,5.3639678809564435,6.045042045799219,5.648282700301336,491863.92488262913,4,7,3,6,4,6,6,1.0,0,0,1,-1,1,1,1
394,5.420685155638333,5.366407018283318,5.484426508004638,5.058101096372495,5.317406233014731,5.972906449745441,5.5890295395905945,381183.1781609195,2,E01000400,6,3,8,1,4,6,5.340178079605103,5.352989030679067,5.508366406758626,5.011088564395904,5.337281088829041,5.979948662122091,5.668020702997843,488017.58,2,7,3,6,3,5,6,1.0,0,1,0,-2,2,1,0
395,5.259360179382285,5.503281280784409,5.40348604676637,5.111282415340601,5.261914276706122,5.835265205314123,5.431058448831035,383109.3212435233,1,E01000401,8,1,8,1,2,3,5.272339668179968,5.331863068594721,5.49674657060595,5.018981852554923,5.328457758344453,5.8794514944987935,5.36576389561733,490514.6502463054,1,7,3,6,3,3,1,1.0,0,-1,2,-2,2,1,-2
396,5.453353229363759,5.456387683550517,5.289154756863912,5.052220233281454,5.326247494220734,5.803306509653727,5.309548551241557,369014.2266666667,3,E01000402,8,0,7,1,1,1,5.626956877885042,5.2744730799286454,5.490869399941998,4.893369087466487,5.400614724483019,6.001918666156722,5.590991686891626,472723.0925925926,6,6,2,3,5,5,5,1.0,3,-2,2,-4,4,4,4
397,5.34428070637327,5.540554944279922,5.246350588437472,5.150288457347581,5.210168994437932,5.6863137576972225,5.177868970380439,373097.78851174936,1,E01000403,9,0,9,0,0,0,5.313296281048472,5.514158415850869,5.266163531637869,5.17513827774762,5.1945249475009065,5.750664243200944,5.352315367398104,477915.30568720377,2,9,0,8,1,1,1,1.0,1,0,0,-1,1,1,1
398,5.357880364145552,5.481980219057628,5.380154568808419,5.0765094067369185,5.2794817345482965,5.858325302600861,5.392298374005726,368576.47857142857,2,E01000404,8,1,8,1,2,2,5.3074292034134825,5.448458183976941,5.37737951153203,5.115528655231447,5.208230572535579,5.836959487513492,5.408577132942085,472499.2631578947,2,8,1,7,1,2,2,1.0,0,0,0,-1,0,0,0
399,5.407461094487574,5.4850675955261154,5.184992868261239,5.04436850179102,5.288470260261261,5.699370575934341,5.215431283429726,367604.74742268043,2,E01000405,8,0,7,1,0,0,5.512876116684851,5.4997917716273195,5.248116440579371,5.1334225132985765,5.16222368763183,5.805121495639007,5.376630223342005,470829.43654822337,4,9,0,8,0,1,1,1.0,2,1,0,1,-1,1,1
400,5.531637028163793,5.323224067687988,5.473621881738001,4.93181987562958,5.384088434126912,5.888376587507676,5.300559978095853,368326.28571428574,3,E01000406,6,2,5,2,3,1,5.584583899611799,5.332613987687194,5.4705777251671375,4.926354239506977,5.360682378089968,5.9705317564952525,5.576900280061572,471551.53497942386,5,7,2,4,4,5,5,1.0,2,1,0,-1,2,2,4
401,5.721934573624724,5.371443667719441,5.458145210819859,4.818049744893146,5.488924566776522,5.909620549089166,5.5130051034753045,367773.70430107525,6,E01000407,6,2,3,5,3,4,5.608367138633541,5.318877449222639,5.4478005042263105,4.893523968902289,5.443465086759305,5.966293504425123,5.665970454613368,471036.25,5,6,2,3,6,4,6,1.0,-1,0,0,0,1,1,2
402,5.0812697618056895,5.688822430495316,4.944941367019946,5.336138556488847,5.061237010632293,5.469404456186435,4.987507412918901,368484.75516224187,0,E01000408,9,0,9,0,0,0,5.2450395089456405,5.607406457265218,5.054523724934151,5.2309847248011625,5.000053620886528,5.585862777356444,5.154414122132049,471854.3132183908,1,9,0,9,0,0,0,1.0,1,0,0,0,0,0,0
403,5.302541169253263,5.425224177765124,5.539948826486414,5.110729418017647,5.3776039571473095,5.9967203122196775,5.597863950512626,383812.5984848485,1,E01000409,7,3,8,2,4,6,5.309199783053711,5.209389178422246,5.654319942432599,5.130267262458801,5.308761165089851,6.013884243303842,5.654317779262571,491347.2773722628,2,5,5,8,3,5,6,1.0,1,-2,2,0,1,1,0
404,5.535594644033321,5.131400281003772,5.6402482922301695,4.925232685734873,5.507846305723148,6.166856900458913,5.78812550750014,384882.1748878924,4,E01000410,2,5,5,5,7,8,5.496321430022113,5.108625700033786,5.707976410828946,4.956666485434438,5.425527936910867,6.190258205192795,5.923750217380442,492725.7639484978,4,3,6,4,6,8,9,1.0,0,1,1,-1,1,1,1
405,5.378633316357931,5.308160374381325,5.56459510976618,5.08480400316643,5.3873223564841535,6.049139282920144,5.6103762958989,383842.6424242424,2,E01000411,5,4,8,3,5,6,5.254704440932676,5.288911953029863,5.530701588435345,5.092083409608128,5.287236826965608,6.034339236207755,5.684343451476959,491445.2409638554,1,6,3,7,2,6,7,1.0,-1,1,-1,-1,-1,1,1
406,5.481917640024966,5.336112797260284,5.525474507700313,4.996797836639664,5.343150937421755,6.009041444144466,5.6196416629986325,385970.7159090909,3,E01000412,6,3,7,2,5,6,5.4208784745838825,5.2872847975371124,5.64301330957584,5.042157807036074,5.301346067183032,6.106388544608019,5.780855438666429,494207.0898203593,3,6,5,6,3,7,8,1.0,0,0,2,-1,1,2,2
407,5.305610461668535,5.546469227834181,5.2758187037525754,5.216172025059208,5.099916376850822,5.7826885225796945,5.41210397927448,384371.2373737374,1,E01000413,9,0,9,0,1,3,5.458014599399863,5.438374821386189,5.4005462765076,5.143185895341666,5.217259836320433,5.888643120236965,5.611002169124821,492090.7512953368,3,8,1,8,1,3,5,1.0,2,-1,1,-1,1,2,2
408,5.196803239718923,5.292615820776741,5.5425799938867675,5.148216523651807,5.298217464730425,5.803628665096355,5.3582591808067175,383350.4575471698,0,E01000414,5,3,9,1,1,2,5.23871420649595,5.172826581223067,5.601886209221774,5.110000727343005,5.282108443282372,5.872504554792892,5.447350097257037,490787.4279069767,1,4,4,7,2,3,2,1.0,1,-1,1,-2,1,2,0
409,5.547901179668677,5.366428183813165,5.660515003830847,4.922455316042378,5.522713144330213,6.193566339729476,5.738224309726353,384228.39416058396,4,E01000415,6,5,5,6,8,8,5.477862558820668,5.211197742644479,5.6693368133376625,4.954060931416119,5.451875309733784,6.174122319501989,5.855020833366058,491887.9044117647,4,5,6,4,6,8,9,1.0,0,-1,1,-1,0,0,1
410,5.079638636473454,5.6552153464519614,5.325252876137242,5.19657775759697,5.2171209183606235,5.6205012373852,5.149597260085019,366052.7196969697,0,E01000416,9,1,9,0,0,0,5.015227077780543,5.528728092844422,5.289994848741068,5.350721913415033,5.077362244193618,5.5717447102069855,5.092492072968869,468790.1824324324,0,9,0,9,0,0,0,1.0,0,0,-1,0,0,0,0
411,5.781730024795222,5.395732370333943,5.330500668626491,4.812116418912159,5.507661914922358,5.882816626773617,5.5033852356236155,366014.7520325203,6,E01000417,7,1,3,5,3,4,5.882326585105342,5.349671287923797,5.331210592873076,4.817422056300009,5.448211752451384,5.919237818473425,5.578026692072551,468772.6196581197,8,7,1,2,6,4,5,1.0,2,0,0,-1,1,1,1
412,5.323137950036943,5.514161127129781,5.30827503228925,5.104058007604068,5.312105490374811,5.798622761805033,5.2604846573367565,365613.4639175258,1,E01000418,8,0,8,1,1,1,5.394775262585393,5.465698703886971,5.305806240076741,5.096213968973311,5.244281597869106,5.837844519388108,5.4870646088211625,468283.51851851854,3,9,0,7,1,2,3,1.0,2,1,0,-1,0,1,2
413,5.244818806648254,5.482068794369698,5.40436114192009,5.101909907460213,5.292574619054794,5.854050903916359,5.3831730759143825,365817.74,1,E01000419,8,1,8,1,2,2,5.2090690563886595,5.391496394842099,5.4432053284767346,5.122200651657887,5.1335823334180395,5.86208902383462,5.708048742245405,468522.58974358975,1,8,2,8,0,2,7,1.0,0,0,1,0,-1,0,5
414,5.383211662540328,5.547635069674691,5.4129145199296165,5.059639983931504,5.34779594308239,5.8558213320155605,5.440920951676234,364906.27118644066,2,E01000420,9,2,8,2,2,3,5.284222807603724,5.435200642136967,5.454442686193129,5.0594841003417965,5.221257129837485,5.899275182275211,5.639576631433823,467347.5411764706,1,8,2,6,1,3,6,1.0,-1,-1,0,-2,-1,1,3
415,5.092006912065107,5.499803703884746,5.338026262993036,5.241192681844844,5.1829251376695415,5.795005282690359,5.332261121550272,365143.488372093,0,E01000421,8,1,9,0,1,1,5.0350948855644315,5.463549566705052,5.39442462019804,5.218283469357142,5.08639405558749,5.822341740131378,5.632016778719135,467623.1219512195,0,9,1,9,0,2,6,1.0,0,1,0,0,0,1,5
416,5.120797809687528,5.642146177725358,5.248756894198331,5.249399737878279,5.236233726414767,5.607960349863226,5.139222632754933,366193.4727272727,0,E01000422,9,0,9,0,0,0,4.847107339989055,5.657125004313209,5.232944428920746,5.454122853550044,5.144470373337919,5.368339282545176,5.063301644542,469048.0681818182,0,9,0,9,0,0,0,1.0,0,0,0,0,0,0,0
417,5.592889277104339,5.463162089904509,5.409089975227598,4.951160574390878,5.482804778474488,6.0437430019292355,5.485319706109854,302032.29864253395,4,E01000423,8,1,6,5,5,4,5.720642640122345,5.350829529442957,5.548003163188696,4.868874301335642,5.572869354060718,6.125718229583332,5.638908209545272,387543.57589285716,7,7,3,3,9,7,6,1.0,3,-1,2,-3,4,2,2
418,6.046198163277063,5.305972331609482,5.78876176124964,4.718500078641451,5.739959572523068,6.235904394051968,5.777016511941567,301548.89743589744,9,E01000424,5,7,1,9,8,8,5.931611157626641,5.231819980900462,5.716523133836142,4.795378335510812,5.630381502756259,6.244308390268466,5.824589203043682,387005.86341463414,9,5,7,1,9,9,8,1.0,0,0,0,0,0,1,0
419,5.830263519844814,5.295433222201833,5.703084308501572,4.678020809826098,5.732801277037949,6.322999269641631,5.699504299470556,301108.2456140351,7,E01000425,5,6,1,9,9,7,5.843151544059455,5.195379674767649,5.778944317854982,4.606260138516985,5.70022106836628,6.3851297061536565,5.9735433076347055,386491.14525139664,8,4,7,0,9,9,9,1.0,1,-1,1,-1,0,0,2
420,5.621497779264363,5.518366611878807,5.38631950988682,5.0002316422418716,5.404918696902214,5.897506387955552,5.402054148529648,302001.8532110092,5,E01000426,8,1,7,3,3,2,5.6699110842668095,5.405284654062528,5.413279369473457,5.00581521082383,5.373676676016587,5.960025755258707,5.560950701053326,387504.5,6,8,1,5,4,4,4,1.0,1,0,0,-2,1,1,2
421,5.653043627282212,5.585716876947103,5.355197568506116,4.928186608457017,5.391515395193721,5.984577829353654,5.538002427510375,302548.5019157088,5,E01000427,9,1,5,3,4,5,5.60228404583353,5.461979345841841,5.362879755370544,4.926032677744374,5.398884599859064,6.005347427996722,5.558142838152972,388194.79545454547,5,9,1,4,5,5,4,1.0,0,0,0,-1,2,1,-1
422,5.681943716674016,5.662193164058115,5.174073718745133,5.021529817718199,5.368982184207303,5.791893391088507,5.307406316200892,305947.75,5,E01000428,9,0,7,2,1,1,5.65009384850661,5.617969922445439,5.14127106440288,5.034868907321383,5.2832780941217035,5.815024322381726,5.349237802679892,392916.39814814815,6,9,0,6,2,2,1,1.0,1,0,0,-1,0,1,0
423,5.377487765522454,5.637394279006898,5.167716501265999,5.269251839382442,5.243716077541742,5.748760121075187,5.286486271798141,374420.88188976375,2,E01000429,9,0,9,0,1,1,5.267639576959953,5.548423136738564,5.205609117480491,5.281051264392386,5.248595690555709,5.7513789718957256,5.299013630091715,479542.7841726619,1,9,0,9,2,1,0,1.0,-1,0,0,0,2,0,-1
424,5.213550746267113,5.7923725249120865,4.852016189007996,5.369790566905942,5.039191132384208,5.386871769198871,5.068079171305842,416728.4635568513,0,E01000430,9,0,9,0,0,0,5.089502554575602,5.687152107238769,4.897168434143066,5.397282585461935,5.009252812067667,5.465512756347656,5.067701076507569,535312.1573333333,0,9,0,9,0,0,0,1.0,0,0,0,0,0,0,0
425,5.282394109233733,5.583502636801812,5.306814444641913,5.179614709269616,5.149040967226028,5.702947230108323,5.205505296107261,374931.87903225806,1,E01000431,9,0,9,0,0,0,5.144961410209913,5.488518610721877,5.301533376469331,5.234471910140094,5.162775338196955,5.733014498438154,5.309708545187942,480265.5882352941,0,9,0,9,0,1,1,1.0,-1,0,0,0,0,1,1
426,5.314504735540636,5.547776794669652,5.3177822126020295,5.150708380312023,5.1806367027877585,5.754138778932024,5.278145232413075,374222.1683168317,1,E01000432,9,1,9,0,1,1,5.2379654327759875,5.442344082771121,5.351947040171237,5.147372352915841,5.224349229319675,5.848880419054547,5.430681637815527,479280.52364864864,1,8,1,8,1,2,2,1.0,0,-1,0,-1,1,1,1
427,5.448628499565355,5.5864582507007094,5.340289959706456,5.080912521086543,5.276272873562503,5.777008800621492,5.265455942556082,374963.7108433735,3,E01000433,9,1,8,1,1,1,5.332865215209593,5.4831513518310455,5.2986824627382205,5.11880138767771,5.275810310639531,5.837442398071289,5.41342730479068,480290.7409638554,2,9,0,7,2,2,2,1.0,-1,0,-1,-1,1,1,1
428,5.198940380130495,5.605305579730443,5.16573458484241,5.266052342312676,5.158657430750983,5.637283811398915,5.166569722550256,373977.47857142857,0,E01000434,9,0,9,0,0,0,5.253748408704996,5.513617948442698,5.250489500164986,5.252826399356127,5.1398081704974174,5.739875976741314,5.3452746696770195,478832.95625,1,9,0,9,0,1,1,1.0,1,0,0,0,0,1,1
429,5.246233425588689,5.548085084328284,5.295697913210616,5.105038305633088,5.270574944651025,5.806712949377859,5.259205226205353,375263.9743589744,1,E01000435,9,0,8,1,2,1,5.204293430828657,5.455050834866821,5.345226495969491,5.113140407155772,5.1998112406887,5.8534734620422615,5.417051118905427,480670.0,1,8,1,7,1,2,2,1.0,0,-1,1,-1,0,0,1
430,5.415116200399636,5.367506753152876,5.619944099170058,4.998534893515098,5.458005624624034,6.112646872724467,5.509010963772067,364624.1343283582,2,E01000436,6,5,7,4,7,4,5.446355660017146,5.362436548499174,5.6160578239795775,4.962685261770736,5.376967706236728,6.106236755016238,5.739660520331804,466900.92093023256,3,7,5,4,4,7,7,1.0,1,1,0,-3,0,0,3
431,5.3628715565975975,5.4135937094688416,5.558425319545409,4.9972567496930855,5.427358088247916,6.08200476099463,5.552162606926525,369790.0661764706,2,E01000437,7,4,7,3,6,5,5.490062159962124,5.2591163652914545,5.616606919853775,4.892348553516246,5.4504439036051435,6.030088652504815,5.702986775504218,473686.93333333335,4,5,5,3,6,6,7,1.0,2,-2,1,-4,3,0,2
432,5.489469213292778,5.323333849107599,5.629898093339336,4.955388876055017,5.3795492876471815,6.04385887542901,5.421002656738193,368639.6069364162,3,E01000438,6,5,6,2,5,3,5.570783453751664,5.095772356618175,5.607126972293327,4.8483130707925195,5.353982463067408,6.104410145164195,5.663812221084511,472187.6961325967,5,3,5,2,4,7,6,1.0,2,-3,0,-4,2,2,3
433,5.339476690147862,5.380511751078596,5.512618527267918,5.075877593623267,5.28789591488212,5.838707980483469,5.364708833020143,367972.13636363635,1,E01000439,7,3,8,1,2,2,5.390762190528328,5.211238705567297,5.58536081991825,5.027078931101688,5.35064949783577,5.962296537941483,5.4644222090086965,471336.4263959391,3,5,4,6,4,4,3,1.0,2,-2,1,-2,3,2,1
434,5.2484180521082,5.569069498556631,5.392776027432195,5.096643269503558,5.362494166692098,5.8645011124787505,5.42272722809403,368650.4962962963,1,E01000440,9,1,8,2,2,3,5.322951164315729,5.371191009002573,5.450008096063838,5.104541174629155,5.315828069167979,5.950134973315632,5.66276612702538,472207.66911764705,2,7,2,7,3,4,6,1.0,1,-2,1,-1,1,2,3
435,5.291212212729763,5.446759501060882,5.399252998364436,5.118447813120755,5.309935801214986,5.898306691801393,5.379315518713617,368818.2922077922,1,E01000441,8,1,8,1,3,2,5.487622116781344,5.318821067263366,5.482005040357067,4.994906512035686,5.388173145093735,5.981601926171855,5.498660098974872,472346.6942675159,4,6,2,5,5,5,3,1.0,3,-2,1,-3,4,2,1
436,5.189646210903074,5.554539012908935,5.324558067903286,5.153940209528295,5.279823542804253,5.864249951664994,5.4606134025062,367369.6780487805,0,E01000442,9,1,9,1,2,3,5.209011880944415,5.486829548928796,5.396090810473372,5.13616008293338,5.24929320986678,5.881671615926231,5.6839512278394,470528.6975609756,1,9,1,8,2,3,7,1.0,1,0,0,-1,1,1,4
437,5.699178174239438,5.37714218687849,5.527394374211629,4.918680656523931,5.519973930047483,6.123280526829415,5.606616793846597,299605.55782312923,5,E01000443,6,3,5,6,7,6,5.658401160626798,5.298895246273762,5.666210967141229,4.868282694268871,5.539219931170747,6.195837636251707,5.811867363549568,384638.4256756757,6,6,6,3,8,8,8,1.0,1,0,3,-2,2,1,2
438,5.722266836055917,5.663991658383815,5.194185305746366,4.963614717413559,5.410028382617995,5.81247127194202,5.421894687943477,346289.40154440154,6,E01000444,9,0,6,3,2,3,5.7596797230653465,5.50328632351011,5.26476835180074,4.97524373838678,5.422335899900645,5.92016171477735,5.559430870227516,443220.02734375,7,9,0,5,6,4,4,1.0,1,0,0,-1,3,2,1
439,5.528665711680256,5.436740615453378,5.494663516363775,4.956641179631906,5.47930951992354,6.031511531883027,5.613923781896492,298796.88047808764,3,E01000445,7,3,6,5,5,6,5.483753320882139,5.29489309370785,5.556226037008345,4.9343353766496945,5.344431189678175,6.0131673460049475,5.7688947140903215,383562.2197309417,4,6,4,4,4,5,8,1.0,1,-1,1,-2,-1,0,2
440,5.482722848276548,5.292955354044709,5.670342356343813,4.884070320219934,5.479683513882794,6.167226391502574,5.777967858918106,299258.36708860757,3,E01000446,5,6,5,5,7,8,5.431067530397345,5.119284961860218,5.659907217425202,5.14470114133745,5.321175846129812,6.20130274932422,5.980265344000611,383930.56544502615,3,3,6,8,3,8,9,1.0,0,-2,0,3,-2,1,1
441,5.463197093774841,5.462106999276848,5.335020157664302,4.960181663874473,5.301919878546288,5.8311093431284,5.3110245616769625,348443.4027303754,3,E01000447,8,1,6,1,2,1,5.462223323524421,5.371606835236786,5.354203099054648,5.062820750348111,5.229894102887904,5.832458244993331,5.4291457051926475,441841.28368794324,4,7,1,7,1,2,2,1.0,1,-1,0,1,0,0,1
442,5.789956147330148,5.436422773088728,5.584401106153216,4.807449900763375,5.599999185289655,6.108602113723755,5.605156848771231,310530.8914285714,6,E01000448,7,4,3,7,6,6,5.774670787759729,5.318711712553695,5.57891197655652,4.8271063985051335,5.5053691400064,6.1217376219259725,5.797747456060874,395225.0054054054,7,6,4,2,8,7,8,1.0,1,-1,0,-1,1,1,2
443,5.852889060974121,5.515993975290732,5.43765594328151,4.859652373470178,5.433160720753069,5.957381481883907,5.498130227838244,377182.59663865546,7,E01000449,8,2,4,3,4,4,5.734139253111446,5.458568625089501,5.374614513220907,4.971394786814682,5.3184037173495575,5.986480864657073,5.6562753214555626,479658.30672268907,7,8,1,5,3,5,6,1.0,0,0,-1,1,0,1,2
444,5.403766350926094,5.417741877477874,5.4790847526406345,5.021591997746402,5.42226968246436,5.980174856365852,5.467694891323833,371200.77358490566,2,E01000450,7,2,7,3,4,4,5.206239233046402,5.46487029393514,5.394692264957192,5.160104817814297,5.261914276046517,5.908538020687339,5.632483761987569,475158.05555555556,1,9,1,8,2,3,6,1.0,-1,2,-1,1,-1,-1,2
445,5.432768050090287,5.240896304448445,5.545857987662618,5.081956680430922,5.46136444298796,6.079649437305539,5.556507380433785,374599.03100775194,2,E01000451,4,4,8,4,6,5,5.29860357093811,5.293919779777527,5.472823932647705,5.228287263870239,5.28348074054718,5.99639368057251,5.738935085296631,479027.12,1,6,2,9,2,5,7,1.0,-1,2,-2,1,-2,-1,2
446,5.377337945289299,5.11388706476962,5.6015276381226835,5.0591750819174965,5.463176793739444,6.10086320267349,5.669044424275883,377471.2295081967,2,E01000452,2,4,8,4,6,7,5.269346293221172,4.9587897021546326,5.684830484227238,5.110467250530537,5.391807185278998,6.193672086438562,5.824843247731526,483774.7008547009,1,1,6,7,5,8,8,1.0,-1,-1,2,-1,1,2,1
447,5.327612856112489,5.206718113444267,5.5090690993387765,5.097088575363159,5.429659789855327,6.0312939062031035,5.603727156962823,381256.97247706424,1,E01000453,4,3,8,3,5,6,5.4055839538574215,4.963096482413156,5.645763549350557,5.0645049322219124,5.326075699215844,6.093700020653861,5.711118183817182,488113.1142857143,3,1,5,7,3,7,7,1.0,2,-3,2,-1,0,2,1
448,5.332842886025179,5.218135704385474,5.504754884023193,5.101873561845603,5.318301063902835,5.931172825765948,5.40626216442027,381840.27659574465,1,E01000454,4,3,8,1,3,2,5.19940814605126,5.129031044805152,5.527722613424317,5.052958365179535,5.317596802344689,5.914632128854083,5.566273054506024,488846.7008547009,1,3,3,6,3,3,4,1.0,0,-1,0,-2,2,0,2
449,5.4189565260678725,5.141971087613642,5.584990659296907,4.950094909067975,5.36305345131072,6.110296704121772,5.547596748301525,382138.67549668875,2,E01000455,3,4,6,2,7,5,5.374320903586017,5.048321627908283,5.662922637330161,5.052657723426819,5.34126163356834,6.021763692299525,5.567885609136687,489211.06944444444,2,2,6,6,3,6,4,1.0,0,-1,2,0,1,-1,-1
450,5.251509144089439,5.27367952411825,5.576605983213945,5.057944050702182,5.3096902760592375,6.068540874394503,5.5675819797949355,381358.3181818182,1,E01000456,5,4,8,1,6,5,5.327878652938774,5.149291878300054,5.658919598375048,5.201077786939485,5.230988475893225,6.12417114845344,5.662749181900706,488287.83035714284,2,4,6,9,1,7,6,1.0,1,-1,2,1,0,1,1
451,5.434774214730544,5.363762683728162,5.546172177090364,5.031756281268363,5.43919823976124,5.883098044816186,5.398191672329809,302044.0931372549,2,E01000457,6,4,7,4,3,2,5.511794541881292,5.2932124147771304,5.510020435103737,5.024762249091848,5.350520839829662,5.893647013858146,5.459739805751816,387632.3153526971,4,6,3,6,4,3,3,1.0,2,0,-1,-1,0,0,1
452,6.059885471682005,5.321027140074138,5.681512974485567,4.679596671575232,5.729783305638953,6.241421806661388,5.86719281839419,301637.2974683544,9,E01000458,6,6,1,9,8,9,5.860727766823899,5.277671363184361,5.6634832464280676,4.811475281506939,5.582725676682477,6.222471104293573,5.892931674998966,387109.12021857925,8,6,6,2,9,9,9,1.0,-1,0,0,1,0,1,0
453,5.85195627900743,5.285020872489693,5.673072476976926,4.785050117477928,5.615992657917062,6.165357599553373,5.733121731232122,302596.1907216495,7,E01000459,5,6,3,8,7,8,5.680679670286394,5.257285448760468,5.594348595692561,4.85609021337863,5.484361455451309,6.092531587743112,5.671871880600356,388300.5248868778,6,5,4,2,7,7,6,1.0,-1,0,-2,-1,-1,0,-2
454,6.189807465761015,5.338422458360691,5.64142896043192,4.513771256597916,5.797473252409755,6.264198050640597,5.786070696788259,298399.5891089109,9,E01000460,6,5,0,9,8,8,6.080878807652381,5.242748519425751,5.5918007127700315,4.604990639994221,5.69767282342398,6.255957711127497,5.904202392024379,383082.1397849462,9,5,4,0,9,9,9,1.0,0,-1,-1,0,0,1,1
455,5.7902186306511485,5.291017074701263,5.681690556828569,4.8110976765795455,5.605752326221001,6.226852135541963,5.834047754217939,300451.5804878049,6,E01000461,5,6,3,7,8,9,5.768847941724878,5.245561553302564,5.644293693492287,4.7726144878487835,5.522032532566472,6.281576182967738,5.906674385698218,385643.72105263156,7,5,5,1,8,9,9,1.0,1,0,-1,-2,1,1,0
456,5.683323034553028,5.305570096428218,5.58466422349605,4.819499926275562,5.583157313963211,6.0001454566764,5.4921736982712055,300595.4104803493,5,E01000462,5,4,3,7,5,4,5.581860538932585,5.285106342165701,5.543455968460729,4.917914340572972,5.437858270541314,6.0010261506803575,5.621125489954026,385750.2943548387,5,6,3,4,6,5,5,1.0,0,1,-1,1,-1,0,1
457,5.5883030704597925,5.292538307495971,5.5941303870571195,4.900848741851636,5.537476842083148,6.1040859631638025,5.456446951004996,300727.41791044775,4,E01000463,5,4,5,6,6,3,5.615347120299268,5.266960804142169,5.631962738819976,4.8921217331245765,5.443677092666056,6.226071683328543,5.854268141646884,386005.08208955225,5,6,5,3,6,9,9,1.0,1,1,1,-2,0,3,6
458,5.255123864049497,5.554726239563762,5.372768244881561,5.11600811585136,5.310518415077873,5.545880139737889,5.053938779278078,365275.3043478261,1,E01000464,9,1,8,1,0,0,4.939453002653624,5.553282188741784,5.241034488928945,5.382265897173631,5.117075996963601,5.433048990211989,5.0685281282977055,467944.5789473684,0,9,0,9,0,0,0,1.0,-1,0,-1,1,-1,0,0
459,5.454842463616402,5.491492084918484,5.266507944753093,5.018882638985111,5.408939746118361,5.772520055693965,5.2357003265811555,364671.82258064515,3,E01000465,8,0,7,3,1,1,5.403710610477637,5.510866156706573,5.386546058857695,5.114189825159438,5.394314351656758,5.809311219140993,5.318240087928501,466994.1843971631,3,9,1,7,5,2,1,1.0,0,1,1,0,2,1,0
460,5.400959944853219,5.791551331038116,4.929242891970501,5.192599003353426,5.227646127823861,5.5888901195859395,4.965814153994283,364584.7768817204,2,E01000466,9,0,9,0,0,0,5.517792654154923,5.789219138070281,4.970860412848994,5.194346795234774,5.192862449608413,5.6855541241580045,5.118010947856997,467307.35221674875,4,9,0,8,1,0,0,1.0,2,0,0,-1,1,0,0
461,5.6095106509225126,5.518067008462445,5.316691930951743,4.922528024377494,5.437788130908177,5.802276562000143,5.270871972215587,226371.58620689655,4,E01000467,8,1,5,4,1,1,5.654072438677152,5.3238362262646355,5.363780729969343,4.891677542527517,5.450298277537028,5.9085669875144955,5.4028678864240645,278257.55833333335,6,7,1,3,6,3,2,1.0,2,-1,0,-2,2,2,1
462,5.410285031454904,5.581279557091849,5.2595648751940045,5.08543736730303,5.352605970246452,5.784758814402989,5.319624210085188,228208.84,2,E01000468,9,0,8,2,1,1,5.407672267309658,5.3606423283122595,5.29925122560631,5.044080558247591,5.281437504353947,5.87525416668797,5.411425050640606,301022.0732984293,3,7,0,6,2,3,2,1.0,1,-2,0,-2,0,2,1
463,5.476647747387676,5.623700180893424,5.153993500853485,5.0502686792949465,5.345485439840353,5.759993262260965,5.189805539898902,360996.5786163522,3,E01000469,9,0,7,2,1,0,5.577336192804541,5.481824577864954,5.321467009641356,4.963330906663237,5.37964244414184,5.939813589645644,5.497351381064808,464125.16949152545,5,9,0,5,4,4,3,1.0,2,0,0,-2,2,3,3
464,5.458824417893848,5.696565880661919,4.93927829700803,5.088191959593031,5.251635525907789,5.581543065252758,5.102987734098283,363152.5714285714,3,E01000470,9,0,8,0,0,0,5.160919652709478,5.709040078935744,4.8870431909078285,5.2950925193255465,5.070115852959549,5.509257572361186,5.176071440117268,465117.9746835443,0,9,0,9,0,0,0,1.0,-3,0,0,1,0,0,0
465,5.481480321081558,5.45377497507794,5.360267540015797,4.985965901082105,5.294870659856513,5.994414131240089,5.4040502451434,415098.11881188117,3,E01000471,8,1,6,1,4,2,5.231712019804752,5.295617310687749,5.42225556542175,5.121370260161583,5.24091097562,5.904290146297878,5.31162414647112,529977.4848484849,1,6,1,8,1,3,1,1.0,-2,-2,0,2,0,-1,-1
466,5.117308100064595,5.594639503488354,5.237829729038126,5.312993628721611,5.141861303764231,5.655409244930043,5.108088374137878,415479.3137254902,0,E01000472,9,0,9,0,0,0,5.124960513578521,5.4168927216971365,5.2853944527882115,5.250068370942716,5.097425224052535,5.6156120206470845,5.278022266648434,530450.0324074074,0,8,0,9,0,0,0,1.0,0,-1,0,0,0,0,0
467,5.34440553041152,5.134706864386429,5.6923516694410345,5.038045043562666,5.359453603073403,5.902807903878482,5.405462708738115,413746.6728395062,1,E01000473,3,6,7,2,3,2,5.208360458357951,5.112038094006228,5.571667115340072,5.096910847037026,5.245166962066393,5.854819632648082,5.434761747215571,528147.9775280899,1,3,4,7,2,2,2,1.0,0,0,-2,0,0,-1,0
468,5.591349913661642,5.254662243943465,5.678673373129135,4.911105176559965,5.460678270884922,6.216667465697554,5.667462063911266,413213.76691729325,4,E01000474,4,6,5,4,8,7,5.387474164366722,5.2283042187199875,5.590724775019814,5.068612588679089,5.3597047854872315,6.040719204089221,5.570353080244625,527402.7352941176,3,5,4,7,4,6,4,1.0,-1,1,-2,2,0,-2,-3
469,5.51626898430206,5.424139293340536,5.486757303332235,5.069896339060186,5.402646444656036,5.862050826732929,5.28564435178107,413765.0164835165,3,E01000475,7,3,8,3,2,1,5.310084507016852,5.387990243364088,5.428897109952303,5.13532693374275,5.236388903443176,5.760162944250768,5.390721611457296,528220.801980198,2,8,2,8,1,1,2,1.0,-1,1,-1,0,-2,-1,1
470,5.406527625710777,5.296422582663847,5.596963377481096,5.058645593986083,5.351974960123555,6.0043017274878,5.402710621276598,413651.23595505615,2,E01000476,5,4,8,2,5,2,5.24916439648916,5.237113419369128,5.451767546890755,5.110971242013062,5.223190514999028,5.811270885213593,5.382689250996832,527900.3668639053,1,5,2,7,1,2,1,1.0,-1,0,-2,-1,-1,-3,-1
471,5.441917046278465,5.365379305446849,5.390196125547425,5.120606974894259,5.334026735369899,5.784420209772446,5.299246273120912,415675.6302521008,2,E01000477,6,1,8,2,1,1,5.267111561979566,5.340897196957044,5.377717985851424,5.174293878674507,5.164317605325154,5.706779705626624,5.333804551192692,530480.4464285715,1,7,1,8,0,0,1,1.0,-1,1,0,0,-2,-1,0
472,5.315765385400681,5.302827601205735,5.501149613516671,5.033382760910761,5.377953777994429,6.032284421012515,5.4647119499388195,414471.0761904762,1,E01000478,5,3,7,2,5,4,5.164783986345414,5.198130719123348,5.453781908558261,5.221232575754965,5.213589420241695,5.9076494161159765,5.451522826187072,529064.5483870967,0,4,2,9,1,3,2,1.0,-1,-1,-1,2,-1,-2,-2
473,5.8620962562845715,5.321788824612821,5.589125215710692,4.7657104831429855,5.603614458397253,6.1124572694598145,5.707755422710779,59565.845771144275,7,E01000479,6,4,2,7,7,7,5.8928065461533095,5.280980130779409,5.574264145343103,4.845293735789362,5.535459527345461,6.095192586150125,5.780117452144623,87685.43925233645,8,6,4,2,8,7,8,1.0,1,0,0,0,1,0,1
474,5.939849173150411,5.375054382211793,5.539693641468761,4.763538662495652,5.657412249867509,6.127124747609704,5.612022020952488,31336.841463414636,8,E01000480,6,3,2,8,7,6,5.805556966669888,5.224938084889655,5.531448537834518,4.914911945494648,5.5212058222942275,6.124163108889528,5.622360429005643,40831.04184100418,8,5,3,4,8,7,5,1.0,0,-1,0,2,0,0,-1
475,5.8664548621549235,5.469407532122228,5.438006613935743,4.810405654566629,5.572076384897356,6.0606924512169575,5.575701564937443,29764.94155844156,7,E01000481,8,2,3,7,6,5,5.8757778345868825,5.355204877558719,5.452953038590677,4.895330262987801,5.433755993843079,6.040283442883009,5.555632500166304,38805.43820224719,8,7,2,3,6,6,4,1.0,1,-1,0,0,-1,0,-1
476,5.325252729273857,5.476534403638637,5.375405498768421,5.1786570056955865,5.2805272421938305,5.710868524490519,5.1093169846433275,82547.09787234043,1,E01000482,8,1,9,1,0,0,5.301180027827188,5.4048769266278915,5.4444287377274385,5.108693795580092,5.266876533813002,5.759536141676527,5.179154977264246,97697.16182572614,2,8,2,7,2,1,0,1.0,1,0,1,-2,1,1,0
477,5.31753251656242,5.5906888246536255,5.3178621219552085,5.182336875666743,5.278851141100344,5.697486989394478,5.095959809552069,415948.5652173913,1,E01000483,9,1,9,1,0,0,5.31551329647341,5.413011571091991,5.383625490050162,5.131509778961059,5.238526551954208,5.702214560201091,5.070491647528064,528301.3145161291,2,8,1,8,1,0,0,1.0,1,-1,0,-1,0,0,0
478,5.397409233961019,5.576106200347075,5.377214575673009,5.016518825883264,5.360487892821029,5.94951910800762,5.359947121895112,28990.954954954956,2,E01000484,9,1,7,2,4,2,5.5887539952692356,5.377261366507019,5.512969876780654,5.023214465439922,5.433625076756333,5.960008175686152,5.505351852889013,37996.83838383838,5,7,3,6,6,4,3,1.0,3,-2,2,-1,4,0,1
479,5.371181984939198,5.58426306743433,5.36329970737495,5.036459525032799,5.318453243463346,5.917839003081369,5.406153242186744,29232.287128712873,2,E01000485,9,1,7,1,3,2,5.491271380486527,5.392876419594617,5.550621666559359,5.02658770142532,5.331485944065621,6.047744588154118,5.4397986119355615,38039.16260162602,4,8,4,6,3,6,2,1.0,2,-1,3,-1,2,3,0
480,5.705196151679212,5.421561642803929,5.5079974735325035,4.8544598485935815,5.598759247498079,6.109940052032471,5.410551753233779,30437.238636363636,5,E01000486,7,3,4,7,7,3,5.820552966096899,5.330543128343729,5.49984766624786,4.838859137597975,5.514643745107965,6.1339528770237175,5.559917836398869,39628.653846153844,8,7,3,2,8,8,4,1.0,3,0,0,-2,1,1,1
481,5.628761306555584,5.361236258588656,5.505928143106326,4.910978249829225,5.505492539718897,6.024529376415291,5.466544448727309,30724.641414141413,5,E01000487,6,3,5,5,5,4,5.648903091748555,5.285855922628851,5.499311026404886,4.99444023066876,5.40298324472764,6.001517912920783,5.543311664871141,40069.33823529412,6,6,3,5,5,5,4,1.0,1,0,0,0,0,0,0
482,5.877056241035461,5.080479302189567,5.844965655695308,4.717654913663864,5.647756896235726,6.231458514928818,5.778325289487839,489401.875,7,E01000488,2,8,1,8,8,8,5.607251172370099,5.063210796802602,5.716834524844555,4.940620844668531,5.377493221709069,6.205175752335406,5.916652129051533,625804.2659574468,5,2,7,4,4,8,9,1.0,-2,0,-1,3,-4,0,1
483,6.025817551783153,5.198694695319448,5.744354695081711,4.728964091766448,5.673846075932185,6.211326241493225,5.841303012200764,489154.49404761905,8,E01000489,3,7,2,9,8,9,5.700670823454857,5.112240311097015,5.642156013033607,4.952821114523844,5.473136252977631,6.112943821332672,5.758387574418024,625404.9715909091,7,3,5,4,7,7,8,1.0,-1,0,-2,2,-2,-1,-1
484,6.021686575629494,5.011019414121455,5.869267073544589,4.636561548555052,5.712789783230075,6.221569841558283,5.863653018877104,489274.4675324675,8,E01000490,1,8,0,9,8,9,5.8690150217576464,4.975213175470179,5.871049118764473,4.893324366121581,5.489412351088091,6.085204543489398,5.6899125955321574,625614.1818181818,8,1,8,3,7,7,7,1.0,0,0,0,3,-2,-1,-2
485,6.039754897775785,5.160210761385904,5.77816648718337,4.6743471756787365,5.670824780430593,6.226686009218995,5.903001383156844,489333.73943661974,9,E01000491,3,7,1,8,8,9,5.750296902300707,5.077214777469635,5.672843458047554,4.86591917632231,5.407757878303528,6.120098154936263,5.763379890527299,625560.6119402985,7,2,6,3,5,7,8,1.0,-2,-1,-1,2,-3,-1,-1
486,5.884092190478108,5.097705740739803,5.861360599498938,4.770403189234214,5.58476728259927,6.336651098610151,5.9470629904529835,489590.85148514854,7,E01000492,2,8,2,7,9,9,5.791912895961873,5.080165124633937,5.7322207029583385,4.996102430288074,5.4748445459939905,6.263225604029535,5.986256692016009,625950.5242718447,7,2,7,5,7,9,9,1.0,0,0,-1,3,0,0,0
487,6.049801005833391,5.084755647873533,5.777580815812816,4.674820975117061,5.6047205890434375,6.31605256985927,5.890468172405077,490554.50724637683,9,E01000493,2,7,1,7,9,9,5.832025753546365,5.172912893416006,5.623518886445444,4.978098153313504,5.38919178443619,6.152260262754899,5.80722050953515,627146.0189873418,8,4,5,5,5,8,8,1.0,-1,2,-2,4,-2,-1,-1
488,6.212689971337553,5.016175759620354,5.887942515435766,4.512846413205882,5.793538605580564,6.30428593471402,6.031045428065003,487923.7786885246,9,E01000494,1,8,0,9,9,9,5.928074055870107,5.079974957760548,5.715861693324658,4.794354357175379,5.573250492147151,6.184401846572056,5.869815563195504,624164.7718120805,9,2,7,1,9,8,9,1.0,0,1,-1,1,0,-1,0
489,6.158924186101523,5.047010348689172,5.8354659670142714,4.620325815293096,5.75490419069926,6.331197356665006,5.90596188781082,488284.93548387097,9,E01000495,1,8,0,9,9,9,5.796036591335219,5.0624295874517795,5.679317759007824,4.836085595646683,5.431719086608108,6.051707946524328,5.691821797769897,624363.6734693878,7,2,6,2,6,6,7,1.0,-2,1,-2,2,-3,-3,-2
490,5.259151649706572,5.356236561409478,5.4722397304275665,5.069401522284573,5.314247908522781,5.869863889171082,5.448728925973466,465483.9514563107,1,E01000497,6,2,8,1,2,3,5.109947995166873,5.312760579052256,5.440809584375637,5.17305221249215,5.069320160951188,5.765156901297877,5.426379648607169,595677.3084577115,0,6,2,8,0,1,2,1.0,-1,0,0,0,-1,-1,-1
491,5.017841272649512,5.571375844752894,5.339346547042374,5.22135132076466,5.141178974008138,5.630176057857749,5.190486844662017,471399.3628318584,0,E01000498,9,1,9,0,0,0,5.0205921195447445,5.409162782132626,5.458410867800315,5.267761453986168,5.027231692026059,5.688215556244056,5.385994978249073,603064.8229166666,0,8,2,9,0,0,1,1.0,0,-1,1,0,0,0,1
492,4.970710060889261,5.642987844818517,5.160381887670149,5.363679299438209,5.0451739122993065,5.521127959719875,5.1677985057496185,470128.5298245614,0,E01000499,9,0,9,0,0,0,4.927996563636604,5.5810208076702414,5.161204749981334,5.446299677279909,4.903690855166411,5.507563314451608,5.203065883185746,601360.4726224784,0,9,0,9,0,0,0,1.0,0,0,0,0,0,0,0
493,5.46618480005382,5.3568314122565,5.4473589040614945,4.9217193700649124,5.470921682722775,5.894242513326951,5.432836189682101,470155.0740740741,3,E01000501,6,2,5,4,3,3,5.395884646766487,5.272369009324874,5.4029146035512285,4.988463592255252,5.22712283298887,5.78530077550603,5.454407678253349,601536.4022988506,3,6,1,5,1,1,2,1.0,0,0,-1,0,-3,-2,-1
494,5.869059033691883,5.197292822812285,5.674662419727871,4.760449685156345,5.568161234259605,6.213364694799695,5.7456362183604925,473195.83928571426,7,E01000502,3,6,2,7,8,8,5.6422357474054605,5.209638413574014,5.6398352810314725,4.976778866989272,5.392532132565975,6.0361057839223315,5.65002536454371,605371.8571428572,6,5,5,5,5,6,6,1.0,-1,2,-1,3,-2,-2,-2
495,5.658085246629353,5.309684025335915,5.466889320295068,4.953908896144433,5.447738447521306,6.03718988352184,5.604284032990661,470677.2784810127,5,E01000503,5,2,6,4,5,6,5.361929710350889,5.252771805118582,5.54098074329632,4.979989623224269,5.226622929120197,5.939149547555593,5.507823784924086,602180.6927374302,2,5,3,5,1,4,3,1.0,-3,0,1,-1,-3,-1,-3
496,6.064204001426697,5.012376506328582,5.847507282495498,4.661718345880509,5.579323627948761,6.375008533000946,5.854996497631073,487774.33,9,E01000504,1,8,1,7,9,9,5.801848377500262,4.988390379718372,5.801494259919439,4.886168437344687,5.4438512453011105,6.285756743380001,5.8463646950466295,623749.7857142857,8,1,8,3,6,9,9,1.0,-1,0,0,2,-1,0,0
497,5.683130515249152,5.071707396130813,5.749563062400148,4.808799783388774,5.578017510865864,6.252253097400331,5.7576832949069505,488126.93859649124,5,E01000505,2,7,3,7,8,8,5.51228779505107,5.138357716158402,5.663185264453415,5.058187964533971,5.294295334618939,6.088843830360854,5.683317884925969,624233.2561983471,4,3,6,6,2,7,7,1.0,-1,1,-1,3,-5,-1,-1
498,5.2841044762241305,5.373933316166721,5.318291423036091,5.102827856789774,5.252709961649197,5.768724164856014,5.290703272641594,415362.98507462686,1,E01000506,6,1,8,0,1,1,5.2608714949253,5.1762568188268085,5.421398968890656,5.097722876210545,5.20417607315751,5.746017479619314,5.345804696166238,534419.9941860465,1,4,1,7,1,1,1,1.0,0,-2,0,-1,1,0,0
499,5.888983866361182,5.048799122412373,5.7896077933273915,4.8021832141350576,5.625034689903259,6.340295581367072,5.822433314924165,487244.2992125984,7,E01000507,1,7,3,8,9,9,5.571547145274148,5.122396015409214,5.597245096270718,5.060384132079224,5.318311362124201,6.117272469534803,5.663897311509545,623302.0447761194,5,3,4,7,3,7,6,1.0,-2,2,-3,4,-5,-2,-3
500,5.555002722126699,5.285783847870185,5.442201482622247,4.979132135011996,5.354812518197891,5.905781467058505,5.2778765750907315,412363.23391812865,4,E01000508,5,2,6,2,3,1,5.418099961382278,5.260819291814845,5.5139242968660716,5.072300127212038,5.234050139467767,5.8599678569651665,5.27204514627761,526344.2021276596,3,5,3,7,1,2,0,1.0,-1,0,1,1,-1,-1,-1
501,5.497202186845243,5.197592176496983,5.67210597731173,4.973068474791944,5.426954742521048,6.01760277338326,5.601227821782231,474180.703125,3,E01000509,3,6,6,3,5,6,5.302058547520809,5.125832938461852,5.68060055739588,5.139373090627382,5.285784396336233,5.8549693282559625,5.457198786220962,606717.5107913669,2,3,6,8,2,2,3,1.0,-1,0,0,2,-1,-3,-3
502,5.376088982460483,5.0892392556939345,5.640546426677064,4.996332246185149,5.33300911180125,5.925188883839038,5.591118258117829,461604.92617449665,2,E01000510,2,5,6,1,3,6,5.343239090442657,5.112990719477335,5.6273298819859825,5.152872188091278,5.2345167843500775,5.88455082098643,5.547097494602204,589349.5133333333,2,3,5,8,1,3,4,1.0,0,1,0,2,0,0,-2
503,5.83012436976475,5.125755983116353,5.76000532850755,4.819023613381175,5.561327155712432,6.224652655356754,5.7881347679458885,413981.99115044245,7,E01000511,2,7,3,6,8,8,5.6056537136198985,5.086009148567442,5.679102241046845,4.919594805392008,5.414982125872657,6.138114584816827,5.640170577026549,526834.1349206349,5,3,6,4,5,8,6,1.0,-2,1,-1,1,-1,0,-2
504,6.110908843576908,4.917126091463225,5.953171770487513,4.622904536979539,5.63588164959635,6.356565916112491,5.974349691399506,479477.02678571426,9,E01000512,0,9,0,8,9,9,5.790635824203491,4.938765281438828,5.854836509625117,4.841555264592171,5.407049639026324,6.247282747427622,5.855574474732081,614239.9666666667,7,1,8,2,5,9,9,1.0,-2,1,-1,2,-3,0,0
505,5.670080669828363,5.321076166790885,5.535672406892519,5.023814625031239,5.486406905425562,6.071415503282805,5.645122048017141,472321.88513513515,5,E01000513,6,3,7,5,6,6,5.417184479534626,5.221567587720023,5.543957549664709,5.13450455168883,5.382526313265164,5.841069844033983,5.45766016592582,604255.4166666666,3,5,3,8,5,2,3,1.0,-2,-1,0,1,0,-4,-3
506,5.592399626385932,5.284810694993711,5.510088151576472,5.0499837585524014,5.481999175221312,6.022184883846956,5.542027515523574,468343.59803921566,4,E01000514,5,3,7,5,5,5,5.480822961226753,5.224992329141368,5.508467000463734,5.075264697489531,5.342834117101586,6.0133151593415635,5.527508969928907,599084.4347826086,4,5,3,7,4,5,4,1.0,0,0,0,0,-1,0,-1
507,5.629270363010858,5.484366986312364,5.407993653887196,4.981246883931913,5.38705274541127,5.94525913658895,5.375901508488153,260693.69078947368,5,E01000515,8,1,6,3,4,2,5.563513407873553,5.342099313819131,5.47541573990223,5.022331030562866,5.318890491197275,5.929537854915441,5.536256965509681,332107.4069767442,5,7,2,6,3,4,4,1.0,0,-1,1,0,0,0,2
508,5.251318717304664,5.365334507785266,5.426883038086228,5.164138411419301,5.296492449090451,5.869902865796149,5.405777679968484,469930.11392405065,1,E01000516,6,2,9,1,2,2,5.234369126165876,5.278008243312007,5.540570919558128,5.147289568593043,5.286423424015874,5.8006198776434665,5.379713841106581,601502.6770186336,1,6,3,8,2,1,1,1.0,0,0,1,-1,1,-1,-1
509,5.44616647053482,5.314043993340399,5.475925458104987,5.1574286580982065,5.359980532101223,5.961484602519444,5.493907094898081,29592.842105263157,3,E01000517,5,2,9,2,4,4,5.420564798421638,5.247617212376853,5.527073923007462,5.100601831147837,5.36081541139026,5.925138380176337,5.476266836935236,38626.17054263566,3,5,3,7,4,4,3,1.0,0,0,1,-2,2,0,-1
510,5.615403150229176,5.402863727022179,5.481268913756572,4.942097150156851,5.432987958326468,6.022488005492719,5.4561881275989546,469151.58295964124,4,E01000518,7,2,6,3,5,3,5.538087440638983,5.367512456008366,5.502663413015735,4.954846480814349,5.326721062680252,5.931381551157527,5.504345262250981,600280.7647058824,4,7,3,4,3,4,3,1.0,0,0,1,-2,0,-1,0
511,5.852964647687399,5.421695528122095,5.499391819995183,4.794980452610896,5.550973617113554,6.039676124086747,5.508308019775611,447840.76923076925,7,E01000519,7,3,3,6,5,4,5.6995609552037925,5.401908702945,5.37382762781148,5.00263874702359,5.39571928386357,5.938918755013061,5.464409673184378,585990.4441687345,6,8,1,5,5,4,3,1.0,-1,1,-2,2,-1,-1,-1
512,5.69491518388583,5.252609478207085,5.424562275879026,4.92339927662076,5.5393456023509104,6.066117513836838,5.603854109921794,451413.9527559055,5,E01000520,4,2,5,6,6,6,5.606635027072009,5.299224545850473,5.426108771387269,4.9702310158925895,5.412273060749559,5.968247704646167,5.503693641985164,512950.125,5,6,2,5,5,4,3,1.0,0,2,0,0,-1,-2,-3
513,5.832166542830291,4.975658633973864,5.8382577966760705,4.81626419932754,5.495886456524884,6.097489604243526,5.736703106209084,414990.5851851852,7,E01000521,1,8,3,5,6,8,5.6843317438372605,5.028133988380432,5.813125678961225,4.987050919224032,5.390639358287235,6.058855243724027,5.684786772556442,529777.4316546762,6,2,8,5,5,6,7,1.0,-1,1,0,2,0,0,-1
514,5.576672401921503,5.316636977524593,5.658274469704463,4.954534564895192,5.395207577738269,6.05789608242868,5.51858092039481,419838.5977011494,4,E01000522,5,5,6,3,6,4,5.463943953514099,5.259945553541184,5.547071938514709,5.004312028884888,5.202299102544784,5.931742150783538,5.421834696531295,537726.39,4,5,3,5,1,4,2,1.0,0,0,-2,-1,-2,-2,-2
515,5.922333792088524,4.9931272400750055,5.971273815821087,4.735314567883809,5.5086662996382945,6.242022292954581,5.65326033887409,415404.85714285716,8,E01000523,1,9,2,5,8,7,5.7293732453109625,4.889329873529592,5.898121348897317,4.78765779061425,5.364226326906591,6.1452253761148095,5.760893405828261,530372.5714285715,7,0,9,1,4,8,8,1.0,-1,-1,0,-1,-1,0,1
516,5.757627815291995,4.922335781369891,5.941106535139538,4.743239544686817,5.534206056594849,6.228058267775036,5.7472088393710905,416331.58095238096,6,E01000524,0,9,2,6,8,8,5.701648073289001,4.875057756322102,5.891116295046019,4.866744390969138,5.410903334617615,6.098119485725477,5.643136334650725,531450.0970873786,7,0,8,3,5,7,6,1.0,1,0,-1,1,-1,-1,-2
517,5.8628683015704155,5.011273203417659,5.78862439095974,4.747720797546208,5.492938743904233,6.188797827810049,5.6860598949715495,416377.3515625,7,E01000525,1,7,2,5,8,7,5.807253711259187,4.885145496076612,5.747798101225896,4.839432504639697,5.402082903171653,6.170989992013618,5.745565573670971,531509.4701492537,8,0,7,2,5,8,8,1.0,1,-1,0,0,0,0,1
518,5.394519768311427,5.31808277460245,5.529336535013639,4.986348179670481,5.372522291770348,5.907131605881911,5.495762328001169,412401.5307692308,2,E01000526,5,3,6,2,3,4,5.220575460310905,5.363391690869485,5.4960142981621525,5.150166441548255,5.1592194203407535,5.842938760019118,5.320777523902155,526411.406451613,1,7,3,8,0,2,1,1.0,-1,2,0,2,-2,-1,-3
519,5.907244838633627,4.996594917099431,5.820418315113716,4.7940506766427236,5.469190526683375,6.3619343627173945,5.697278839237285,412772.6320754717,8,E01000527,1,7,3,4,9,7,5.703772130711325,4.9283139294591445,5.834933537861397,4.88319020949561,5.3799427470256544,6.207112817928709,5.65505224158024,526862.5862068966,7,1,8,3,4,8,6,1.0,-1,0,1,0,0,-1,-1
520,5.392573430214399,5.261341769018291,5.395635631349352,5.156891220881615,5.284583500873896,5.855762646522051,5.474058073243977,412626.3827160494,2,E01000528,5,1,9,1,2,4,5.28195832325862,5.219140820450836,5.592495983773535,5.106149433733343,5.223324256938892,5.866223458405379,5.30127577991276,526718.6923076923,1,5,4,7,1,3,0,1.0,-1,0,3,-2,0,1,-4
521,5.883943911961147,5.124359537873949,5.808953429971423,4.801261501652854,5.48806061233793,6.3187846081597465,5.827629003354481,486165.57857142854,7,E01000530,2,7,3,5,9,9,5.693350667501018,5.0491453504910435,5.817187471111326,4.925170639135541,5.377383795967938,6.246507877851054,5.8445460578821,623654.2846715328,6,2,8,4,4,9,9,1.0,-1,0,1,1,-1,0,0
522,5.783568973290293,4.8749656338440746,5.932372243780839,4.807139879778812,5.483438275989733,6.176918740021555,5.577802680668078,325313.64210526313,6,E01000531,0,9,3,5,7,5,5.746676470643731,4.779861360467891,5.979379871840118,4.760021231507742,5.349781866996519,6.2104649389943765,5.705318330436625,409619.27956989245,7,0,9,1,4,8,7,1.0,1,0,0,-2,-1,1,2
523,5.5803623927964106,5.056169678767522,5.724750335569735,4.808650694511555,5.457899868488312,6.082742088370853,5.411669089838311,258373.19444444444,4,E01000532,2,6,3,4,6,3,5.8142722359410035,4.993692101151855,5.7966873877578315,4.653485827975803,5.275735727062932,6.194415277904934,5.736973759200838,342741.1574074074,8,1,8,0,2,8,7,1.0,4,-1,2,-3,-2,2,4
524,6.164193538017571,5.000272181816399,5.997878562659025,4.6868017967790365,5.663435336202383,6.366659354418516,5.812819743528962,465101.90625,9,E01000533,1,9,1,8,9,9,5.933410363298067,4.972184140917281,5.885934225270446,4.780855615374068,5.529770940961972,6.279094882414374,5.865293848682457,595509.5,9,1,8,1,8,9,9,1.0,0,0,-1,0,0,0,0
525,6.132905109544819,5.1414677480633335,5.9531152275171175,4.673463998215921,5.585763549536802,6.45571756362915,5.911688449677457,491312.1235955056,9,E01000534,3,9,1,7,9,9,5.999654155307346,5.061196276876662,5.891552315817939,4.7655994044409855,5.50824287864897,6.3926992946200905,6.005667328834534,628009.7888888889,9,2,8,1,8,9,9,1.0,0,-1,-1,0,1,0,0
526,5.708387681539508,5.0735188558481745,5.840441342713176,4.751146117846171,5.390730942504994,6.169148249902587,5.67711501536162,430409.50724637683,6,E01000535,2,8,2,3,7,7,5.611037174580803,5.069728490332483,5.804079658548597,4.929180397953786,5.342064995161245,6.085455959951374,5.634916412158751,540768.838028169,5,2,8,4,4,7,6,1.0,-1,0,0,2,1,0,-1
527,5.737532094352604,5.28699471110507,5.514982106154447,4.916264281989379,5.491837407640842,6.059044809539083,5.556541311926175,28072.891191709845,6,E01000536,5,3,5,5,6,5,5.756489290683358,5.207122812116587,5.637942029922097,4.879004479006484,5.543042374981774,6.115449028434576,5.741839030826533,36774.125,7,5,5,3,8,7,7,1.0,1,0,2,-2,3,1,2
528,5.7827462795234865,5.360237388383775,5.6136263353484015,4.836390425051961,5.623966380953789,6.165146623338972,5.758250967377708,28826.434523809523,6,E01000538,6,5,4,8,7,8,5.887254275642075,5.207038876060006,5.76849842571712,4.817943000293278,5.75884296510603,6.191874270672565,5.818446294411079,37716.244755244756,8,5,7,2,9,8,8,1.0,2,-1,2,-2,1,1,0
529,5.746421356839458,5.335158178186792,5.59039368216447,4.806784976185776,5.586822507888313,6.158385719839982,5.775477530449394,29634.165354330707,6,E01000539,6,4,3,7,7,8,5.757431789906356,5.252420780432486,5.6303114542995925,4.925407442733319,5.562029237294719,6.14553570225291,5.715168359505869,38672.57664233576,7,5,5,4,8,8,7,1.0,1,-1,1,1,1,1,-1
530,5.769035512508626,5.252147438805863,5.618848138015363,4.7952940743728725,5.5797784008793325,6.1298090106282155,5.633933912442383,29875.86592178771,6,E01000540,4,5,3,7,7,6,5.761437048886549,5.1718061206175046,5.695370299293396,4.822914544911308,5.575983640344385,6.154549703241032,5.85630209050714,39027.50802139037,7,4,6,2,9,8,9,1.0,1,0,1,-1,2,1,3
531,5.695156108843137,5.3189014506666625,5.508901470328031,4.880391096415585,5.540749741743689,5.98815993740134,5.599778718327823,27086.13698630137,5,E01000541,5,3,4,6,4,6,5.5866956097739084,5.281879585129874,5.594553514889308,4.919506085770471,5.454150554112026,6.048538569041661,5.6343558149678366,35487.4,5,6,4,4,6,6,6,1.0,0,1,1,0,0,2,0
532,5.439539525243971,5.346106266663744,5.520974128074895,4.994723084705328,5.4006287459454505,5.927670881639119,5.592429917622236,27621.359477124184,2,E01000543,6,3,6,3,3,6,5.412951526994055,5.296244814991951,5.525871732018211,5.033668459816412,5.349297871643847,5.944061337546869,5.7138025171377445,36158.02272727273,3,6,3,6,4,4,7,1.0,1,0,0,0,1,1,1
533,5.313950909508599,5.249920860169426,5.69625180865091,5.02139033022381,5.3217064426058815,5.808178258320642,5.342679905512976,164873.90476190476,1,E01000544,4,6,7,1,2,2,5.346127044070851,5.047251179362789,5.692511782501683,5.049627069270972,5.216228300874883,5.64541735793605,5.488497658209368,237836.86363636365,2,2,6,6,1,0,3,1.0,1,-2,0,-1,0,-2,1
534,5.994274767962369,4.6835716204209765,6.155227887166011,4.690767261889074,5.67158225604466,6.252385232355688,5.743985197760842,489078.74025974027,8,E01000545,0,9,1,8,8,8,5.703926068260556,4.6043618258975805,6.113616325741723,4.778127739543007,5.4921998614356635,6.0692769777207145,5.682893255778722,625296.2380952381,7,0,9,1,7,7,7,1.0,-1,0,0,0,-1,-1,-1
535,6.087039904317994,4.771974245707194,6.029095705004706,4.5790125909058945,5.646981014721636,6.293384876804075,5.9473073689833935,489714.6956521739,9,E01000546,0,9,0,8,9,9,5.949082584942088,4.793986415863037,6.039381546132705,4.713604976149166,5.512940720950856,6.247145902409273,5.8406130412045645,626153.3411764706,9,0,9,0,8,9,9,1.0,0,0,0,0,0,0,0
536,6.038505209982395,4.854957355558872,6.114412254095077,4.755788342654705,5.563171389698982,6.434977367520332,5.866463221609592,489828.4125,9,E01000547,0,9,2,7,9,9,6.076455375552177,4.676809079945087,6.093813508749008,4.629233518242836,5.42245481312275,6.341411074995994,5.815193983912468,626277.975,9,0,9,0,6,9,8,1.0,0,0,0,-2,-1,0,-1
537,5.655445344307843,4.7517904996871945,6.057919157252592,4.761137280744665,5.496912839833428,6.103272853178137,5.671801095850327,489878.22352941177,5,E01000548,0,9,2,5,6,7,5.566732696273871,4.703469130030849,6.0963540139951204,4.771418867404001,5.385511617911489,6.001276898802373,5.659107030483714,626434.2719298246,5,0,9,1,5,5,6,1.0,0,0,0,-1,0,-1,-1
538,6.370607137680054,4.71953743554297,6.213369616440365,4.476075442064376,5.707684687205723,6.558449052629017,6.06123822927475,490113.2261904762,9,E01000549,0,9,0,9,9,9,6.101384537194365,4.747750892434069,6.050043726480135,4.684378098416072,5.47941497577134,6.413106128733645,5.912107149759929,626622.5268817204,9,0,9,0,7,9,9,1.0,0,0,0,0,-2,0,0
539,5.75258771284127,5.045700055581552,5.849061536200253,4.760605401462978,5.4703235861695845,6.01214078914972,5.671527301823652,490387.7530864198,6,E01000550,1,8,2,4,5,7,5.47846148787318,5.005537662957166,5.761255547807023,4.998385508318205,5.322828300901361,5.8811087253931404,5.4748336286158175,627615.6621621621,4,2,7,5,3,3,3,1.0,-2,1,-1,3,-1,-2,-4
540,5.20412778598006,5.353474454213214,5.5426325644216226,5.089913531016278,5.329623952988656,5.749930617629841,5.275256103084933,485472.5053763441,0,E01000551,6,3,8,1,1,1,5.156152248382568,5.173712611198425,5.643610034326111,5.179562934721359,5.2473913611787735,5.776493527672508,5.397556200171962,621111.7474747475,0,4,5,8,2,1,2,1.0,0,-2,2,0,1,0,1
541,5.36594420671463,5.2722789963086445,5.621352934837342,5.027617824077606,5.414368029435476,5.764699586232504,5.47867017587026,311687.76666666666,2,E01000552,5,5,7,3,1,4,5.352231975396474,5.169391616185506,5.593135778109232,5.180948950184716,5.233303475379944,5.741753432485792,5.453759246402317,459012.5333333333,2,4,4,8,1,1,2,1.0,0,-1,-1,1,-2,0,-2
542,5.868051422219122,5.044797407042596,5.877036494593466,4.824280714796435,5.413052466607863,6.27274824534693,5.670047132238265,473780.2419354839,7,E01000553,1,8,3,3,8,7,5.74612931753027,5.045970125445004,5.821785536305658,4.88287331626333,5.3032792909392,6.150686571310306,5.628856864468805,606186.5344827586,7,2,8,3,3,8,6,1.0,0,1,0,0,0,0,-1
543,6.013367610176404,5.02084680100282,5.823742594321569,4.755904982487361,5.5164478600025175,6.353029984235763,5.834729734063148,474292.80833333335,8,E01000554,1,8,2,5,9,9,5.8429210904900355,5.073818477965493,5.757056219887187,4.858108802606131,5.331279452520472,6.2795068435086545,5.7273720457353665,606754.4198473282,8,2,7,2,3,9,7,1.0,0,1,-1,0,-2,0,-2
544,5.95845709849095,5.1806091260218965,5.824052784753882,4.749294376027757,5.531561328017193,6.335552415985992,5.992873274761697,480635.4202898551,8,E01000555,3,8,2,6,9,9,5.771523921026124,5.055854765077432,5.744016238384777,4.952131146358119,5.462101836999257,6.242030580838521,5.987183286084069,615569.7847222222,7,2,7,4,7,9,9,1.0,-1,-1,-1,2,1,0,0
545,5.900411270913624,4.808134030728113,5.999188224474589,4.78601703331584,5.4580841319901605,6.214333667641594,5.827230178174519,477852.8095238095,8,E01000556,0,9,3,4,8,9,5.754055979459182,4.8660247338854745,5.9875011780987615,4.82718229164248,5.46658358755319,6.142591305401014,5.75419612682384,610594.6521739131,7,0,9,2,7,8,8,1.0,-1,0,0,-1,3,0,-1
546,6.11747175768802,4.918657244820344,6.052848041057587,4.634852889337037,5.6445410345730025,6.4730111956596375,5.918184983102899,480955.5131578947,9,E01000557,0,9,0,8,9,9,5.918010329091271,4.905186951160431,5.956284290136293,4.791772357253141,5.502164006233215,6.29107480548149,5.9814282212146495,615368.9302325582,8,1,9,1,7,9,9,1.0,-1,1,0,1,-1,0,0
547,6.400589656829834,4.904320280118422,6.080787160179832,4.51053691777316,5.739428166909652,6.495525973493403,6.146960503404791,486770.86363636365,9,E01000558,0,9,0,9,9,9,6.132371838028367,4.921518705986641,5.920268683820157,4.7881707028225735,5.526921417262103,6.3649882840680645,6.052143966829455,622560.3333333334,9,1,9,1,8,9,9,1.0,0,1,0,1,-1,0,0
548,6.2878819392277645,4.759408826094408,6.198976524059589,4.476530992067778,5.813030451994676,6.572819453019362,6.166454828702486,486685.3230769231,9,E01000559,0,9,0,9,9,9,6.096391348771646,4.779615340098529,6.138732765761899,4.726773478615452,5.57099603599226,6.455555069614464,6.004017430292049,622512.6338028169,9,0,9,0,9,9,9,1.0,0,0,0,0,0,0,0
549,6.330821039676667,4.890447062253952,6.1081166839599605,4.42398881316185,5.8225087285041806,6.54034318447113,6.166216037273407,487096.99,9,E01000560,0,9,0,9,9,9,6.176617337054894,4.9149281431417,5.9914314395091575,4.706813685229568,5.573643735197724,6.426480461339482,6.066625411393212,623038.0983606557,9,1,9,0,9,9,9,1.0,0,1,0,0,0,0,0
550,6.32718389439133,4.910865677977508,6.056021375476189,4.586793721846814,5.788936668971799,6.360806375179651,6.054222277875216,486905.22641509434,9,E01000561,0,9,0,9,9,9,5.8955320191383365,5.030551743507385,5.817304930686951,4.787557764053345,5.495236377716065,6.124158387184143,5.702009670734405,622846.3,8,2,8,1,7,7,7,1.0,-1,2,-1,1,-2,-2,-2
551,5.799608361498218,5.416417497340764,5.6046851862256775,4.825014083741982,5.593491155410481,6.183991291812647,5.705593402697661,47906.0,7,E01000562,7,4,3,7,8,7,5.619869511635577,5.4507706035030346,5.446059696009902,4.980350825304542,5.4225577402636,6.066570784876255,5.660334379295183,59493.92349726776,6,8,2,5,6,6,6,1.0,-1,1,-2,2,-1,-2,-1
552,5.959445965356667,5.313624714339912,5.630584197337401,4.768408171291457,5.631477598371452,6.262194377749992,5.733720600937998,32988.21787709497,8,E01000563,5,5,2,8,8,8,5.714168076115753,5.27326747634648,5.526258026742187,4.973922297592562,5.44816356741321,6.085412628363565,5.64819302733656,44210.83769633508,7,6,3,5,6,7,6,1.0,-1,1,-2,3,-2,-1,-2
553,5.704492713522724,5.190175048009617,5.588078716608483,4.951988004324004,5.549344986442506,6.127493497893566,5.604497469316318,32131.937007874014,5,E01000564,3,4,6,6,7,6,5.513575770723538,5.1560441480846855,5.598951835331954,4.9810667178762245,5.434765288210291,5.985915512550534,5.62143131879371,41870.44881889764,4,4,4,5,6,5,5,1.0,-1,1,0,-1,0,-2,-1
554,5.877740425656932,5.263566482898801,5.691392972487812,4.77586447453314,5.693773375001064,6.235506288765013,5.6512246852697325,32698.100775193798,7,E01000565,5,6,2,9,8,7,5.690724210631578,5.216582318893949,5.5645499892700885,5.004751629399178,5.412649601921999,6.020187718527658,5.726020657030263,42590.66917293233,6,5,4,5,5,6,7,1.0,-1,0,-2,3,-4,-2,0
555,5.802363204140948,5.246625877853132,5.701275222321861,4.817992084046715,5.61446723774967,6.314388142691718,5.780341504985451,31896.324786324785,7,E01000566,4,6,3,8,9,8,5.650113449014467,5.1963386607581175,5.656422985011134,4.952917707377467,5.4848534423729465,6.171380550696932,5.73272112422976,41551.206896551725,6,4,5,4,7,8,7,1.0,-1,0,-1,1,-1,-1,-1
556,5.918974993465183,5.34655406024005,5.601228573300817,4.835577824094274,5.620986044943869,6.2141218593528675,5.589012559469755,33804.76576576577,8,E01000567,6,4,4,8,8,6,5.680442699214868,5.375026958030567,5.415159208732739,4.978187623776887,5.362487282669335,6.082705485193353,5.642055018952019,43961.429824561405,6,7,1,5,4,7,6,1.0,-2,1,-3,1,-4,-1,0
557,5.523804927573485,5.408590163202847,5.419687848231372,4.974803215615889,5.331779341136708,5.875826511663549,5.503895198597627,29529.858823529412,3,E01000568,7,2,6,1,2,4,5.498430700863109,5.296924819283307,5.3969671974845115,5.031222224235535,5.2135628104847385,5.944664721820444,5.58826737352871,39260.25133689839,4,6,1,6,1,4,5,1.0,1,-1,-1,0,0,2,1
558,6.0035498162277605,5.148209841311479,5.715561516144696,4.687385651243835,5.687697444643293,6.346077197740058,5.7966517781009195,30750.756302521007,8,E01000569,3,6,1,9,9,8,5.835194178061052,5.1137061910195785,5.597023656151512,4.792227193442258,5.536676367846402,6.138864634253762,5.899817332354459,40095.29090909091,8,3,4,1,8,8,9,1.0,0,0,-2,0,-1,-1,1
559,5.770341165286979,5.284175699519128,5.539153429650769,4.924107812114598,5.535285996407578,6.214288770538015,5.627841509494585,33074.865979381444,6,E01000570,5,3,5,6,8,6,5.514405420848301,5.243952617758796,5.549943946656727,5.029749900102615,5.277198476450784,5.9875720256850835,5.43978486884208,43094.47619047619,4,5,4,6,2,5,2,1.0,-2,0,1,1,-4,-3,-4
560,6.045992295185249,5.14084545866458,5.686863894947988,4.736587534407656,5.68163877618527,6.333371799149199,6.003504099960098,33267.622754491014,9,E01000571,3,6,2,9,9,9,5.835705399513245,5.138620702212289,5.612290403186875,4.950691905597712,5.515602578252754,6.217336392242636,5.893022863656882,43304.845637583894,8,3,5,4,8,8,9,1.0,-1,0,-1,2,-1,-1,0
561,5.936061430568538,5.113010177927569,5.611412414834519,4.694289009433147,5.660860707937193,6.277030332029359,5.934225537560203,30646.00826446281,8,E01000572,2,5,1,8,8,9,5.945109160259516,4.939930369155576,5.843812944913151,4.785770375319202,5.716265057072495,6.348264516002,5.955700806897096,40014.10101010101,9,1,8,1,9,9,9,1.0,1,-1,3,0,1,1,0
562,5.617780205644207,5.184584293100569,5.687189677615224,4.881364504496257,5.522040340635511,6.22469374427089,5.723466528050693,30941.882716049382,5,E01000573,3,6,4,6,8,8,5.49555873505177,5.008564582631632,5.746156854863547,4.941105832351497,5.527667656997962,6.161731594179305,5.562704239886231,40374.25766871166,4,2,7,4,8,8,4,1.0,-1,-1,1,0,2,0,-4
563,5.6308835335075855,5.274224078903596,5.611759287615617,4.8336246982216835,5.548510861893495,6.177804293731849,5.662838292618592,30989.614583333332,5,E01000574,5,5,4,6,7,7,5.573438347710503,5.158210445774926,5.692486434512668,4.989684271812439,5.453012463781569,6.157840802934435,5.587221137682596,40441.96666666667,5,4,6,5,6,8,5,1.0,0,-1,1,1,0,1,-2
564,5.632259919695611,5.279469982550962,5.554153632943648,4.9419736609841785,5.484387780628065,6.120816002797036,5.636656790754221,31231.934306569343,5,E01000575,5,4,6,5,7,6,5.5362187566428345,5.206695901114365,5.632899863144447,5.032419327209736,5.385568694410653,6.060043476367819,5.688811114738727,40750.020689655175,4,4,5,6,5,6,7,1.0,-1,-1,1,0,0,-1,1
565,5.826083561121407,5.136679259397216,5.7515174110056995,4.776614405341068,5.570614471273907,6.285007959705288,5.897623975398177,31817.771186440677,7,E01000576,3,7,2,7,9,9,5.844418474606106,5.031796410304158,5.8410559361722285,4.9274639913014004,5.519003347188485,6.303308671262084,5.958662386701889,41470.361344537814,8,2,8,4,8,9,9,1.0,1,-1,1,2,1,0,0
566,5.29100502720316,5.504318234574704,5.3148585193939795,5.191851198218251,5.155275496817727,5.6921940241151185,5.287476705230829,31908.534351145037,1,E01000577,8,1,9,0,0,1,5.237152679077047,5.364140967659603,5.4459696771293284,5.1412472519653525,5.165869930722066,5.77360013778636,5.3761565487905845,41498.62913907285,1,7,2,8,0,1,1,1.0,0,-1,1,-1,0,1,0
567,5.875116504887317,5.303741177345844,5.60797876246432,4.80416413507563,5.592902428926306,6.106596818629732,5.6775051957749305,32466.659574468085,7,E01000578,5,5,3,7,6,7,5.646562295007001,5.183546165527381,5.6673497695640975,4.958803394157898,5.344100393685214,6.026880906720467,5.586234502604443,42266.793103448275,6,4,6,4,4,6,5,1.0,-1,-1,1,1,-3,0,-2
568,6.092215193078873,4.927694217955812,6.023064187232484,4.652930491782249,5.58740152450318,6.495975613594055,5.770875848354177,175849.1914893617,9,E01000579,0,9,1,7,9,8,6.098394063503846,4.911388940137366,6.077497956545456,4.685539316871892,5.42848629536836,6.357480686643849,5.810040196646815,228667.29347826086,9,1,9,0,6,9,8,1.0,0,1,0,-1,-1,0,0
569,6.083679860448602,4.991178581867312,5.882605283718391,4.6409369102252525,5.678652009353262,6.281679180455325,5.871310170060895,490145.5911330049,9,E01000580,1,8,0,9,9,9,6.014641731033498,4.979274584157435,5.7873108478692865,4.79835765178387,5.477169885354884,6.177954404062815,5.792770017326148,626690.9321266968,9,1,8,1,7,8,8,1.0,0,0,0,1,-2,-1,-1
570,6.178961860890291,4.900308532374246,6.049464992114475,4.62972229719162,5.675281626837594,6.430388404398548,6.0219345506356685,490386.64285714284,9,E01000581,0,9,0,9,9,9,5.9824887300792495,4.888930177688598,5.862210840927927,4.775094447637859,5.500774711056759,6.233352743951898,5.942144539481715,626921.7368421053,9,0,8,1,7,9,9,1.0,0,0,-1,1,-2,0,0
571,6.3361672698043465,4.922221276703782,6.14171705471249,4.533745479396009,5.7255801009380916,6.508147369219563,6.070805012710451,475580.7007874016,9,E01000582,0,9,0,9,9,9,6.171858597885478,5.0259000929919155,5.943658668344671,4.673533140529286,5.480458591201089,6.298006385022943,5.993958512219516,594202.9636363636,9,2,9,0,7,9,9,1.0,0,2,0,0,-2,0,0
572,5.845983067425815,4.97027066042929,5.9237824382204,4.7555610526691785,5.53292404160355,6.180927200028391,5.718395212202362,486188.7515151515,7,E01000583,1,8,2,6,7,7,5.7390688706559745,4.895376639756543,5.937925830919143,4.823627201437253,5.415352309656422,6.083220692405924,5.730555127238669,623603.5555555555,7,0,9,2,5,7,7,1.0,0,-1,1,0,-1,0,0
573,6.108713900601423,4.8882900005505405,6.053967914463561,4.569084963680785,5.604041908994133,6.606505417529448,6.052974868703772,491488.9012345679,9,E01000584,0,9,0,7,9,9,5.891399911192597,4.851753635484664,5.982233067027858,4.734535000363334,5.421955573754232,6.5115357656947905,6.0381281766735135,628291.6229508197,8,0,9,0,6,9,9,1.0,-1,0,0,0,-1,0,0
574,6.162091819015709,4.8799211866146806,6.073079347610474,4.621191155266118,5.626840810518007,6.451035225713575,5.78120827997053,358770.9864864865,9,E01000585,0,9,0,8,9,8,6.068258007367452,4.734227587779363,6.101815534962548,4.687289377053578,5.39843655957116,6.425715847147836,5.780336012442906,446801.93055555556,9,0,9,0,5,9,8,1.0,0,0,0,0,-3,0,0
575,5.514266602000835,5.02383149558713,5.734997758213778,4.978363139288766,5.372948721328878,5.8663802058059975,5.430376757746157,264005.2360248447,3,E01000586,1,6,6,2,2,3,5.438882538250515,4.944995854582105,5.7757837275664015,4.9407541418359395,5.353289956138248,5.901030463831765,5.497834998227301,328725.47023809527,3,1,7,4,4,3,3,1.0,0,0,1,-2,2,1,0
576,5.48579077086141,5.357318694553068,5.52929913420831,5.118359862796722,5.395095909795454,5.986003271995052,5.512697695724426,77351.70161290323,3,E01000587,6,3,8,3,4,4,5.3831846158307295,5.2684991646530035,5.545317056483793,5.137442087768612,5.347526777955823,5.930385806506738,5.658828861731336,126713.94736842105,3,6,3,8,4,4,6,1.0,0,0,0,0,1,0,2
577,5.161541398690671,5.457289254178806,5.33518096987082,5.218668094094919,5.2467642900895095,5.726994277263175,5.307436443713247,431131.39285714284,0,E01000588,8,1,9,0,1,1,5.087379932955459,5.353860298240626,5.415679828988181,5.296651712722248,5.103305284071852,5.78904684053527,5.344461813017174,553723.0555555555,0,7,1,9,0,1,1,1.0,0,-1,0,0,0,0,0
578,5.458061434762895,5.258469661255054,5.518581544337251,5.031322297493973,5.39034111617392,6.0393033957802125,5.6960479475457575,26943.139013452914,3,E01000589,4,3,7,3,5,7,5.451968131595188,4.991168140835232,5.724486328230964,5.075762669775221,5.361130135324267,6.076394874784682,5.76018464618259,35463.26222222222,3,1,7,7,4,7,8,1.0,0,-3,4,0,1,2,1
579,5.571585499859871,5.364745063350556,5.481421404696525,4.907984573156275,5.41549766000281,6.072291587261444,5.519310534000397,106401.71808510639,4,E01000590,6,2,5,3,6,4,5.559083195293651,5.269199099961449,5.624851419645197,4.942877784196068,5.384744996183059,6.104656685099882,5.5521389828008765,150507.05294117646,5,6,5,4,5,7,4,1.0,1,0,3,-1,2,1,0
580,5.47616064613992,5.229228248962989,5.628494143486023,5.0157672854570245,5.374601369375711,6.0561826137396,5.597970936979566,28095.917582417584,3,E01000591,4,5,7,2,6,6,5.292117415787931,5.2493566988471025,5.576460837604043,5.151318594367204,5.278709912728407,5.88522004224583,5.614956174781937,36919.023952095806,1,5,4,8,2,3,5,1.0,-2,1,-1,1,0,-3,-1
581,5.554991678549693,5.320567776759465,5.507637801842812,4.952597413307581,5.420405456653008,5.950264035127102,5.467708367567796,204817.44871794872,4,E01000592,6,3,6,3,4,4,5.431943448043309,5.206879567514899,5.540509185908031,5.023950431244505,5.353013060575614,5.908171873882504,5.5444416999816895,284722.50306748465,3,4,3,6,4,3,4,1.0,-1,-2,0,0,1,-1,0
582,5.614403334530917,5.308065154335716,5.574082394579907,5.048734529035075,5.538387545338877,6.067082305054565,5.6272968295570855,31999.3006993007,4,E01000593,5,4,7,6,6,6,5.532078516861749,5.425629639436329,5.549761316132924,5.003017575967879,5.481426585288275,5.995322464004396,5.558744323632074,42014.02380952381,4,8,4,5,7,5,4,1.0,0,3,0,-2,1,-1,-2
583,5.360585751900306,5.350830298815018,5.438470850846707,5.0682201006473635,5.354266035862458,5.846522942567483,5.446286798134828,31645.266666666666,2,E01000594,6,2,8,2,2,3,5.289923900824327,5.294849009391589,5.474035295461997,5.118399228805151,5.2777614636298935,5.843518938162388,5.47148240223909,41594.73333333333,1,6,2,7,2,2,3,1.0,-1,0,0,-1,0,0,0
584,5.812561719463422,5.131774152700718,5.684702657736265,4.764787928416179,5.496398448944092,6.149094750101749,5.648475948434609,414971.9711538461,7,E01000595,3,6,2,5,7,7,5.710080058528827,5.018758286650364,5.712491567318256,4.890787830719581,5.313335113800489,6.050514432100149,5.650114468657053,529315.6442307692,7,2,6,3,3,6,6,1.0,0,-1,0,1,-2,-1,-1
585,5.432256567403206,5.483869569856416,5.388252628674297,5.032754829094845,5.335385220605622,5.844945784634764,5.314884007351953,414818.59748427675,2,E01000596,8,1,7,2,2,1,5.320051241587926,5.399050284098912,5.394164305466872,5.140412778287501,5.161951014211962,5.792264991706902,5.272972604611537,529188.4685314685,2,8,1,8,0,1,0,1.0,0,0,0,1,-2,-1,-1
586,5.17258568379012,5.365942178802057,5.455746973102743,4.975408869710836,5.196104489944198,5.719830773093483,5.172007105567238,417248.125,0,E01000599,6,2,6,0,1,0,5.076049433109608,5.25394554975185,5.546320811231086,5.109392342415262,5.157522887625593,5.7069076527940465,5.276352636357571,532597.1170212766,0,5,3,7,0,0,0,1.0,0,-1,1,1,0,-1,0
587,5.1653886762091785,5.6871621374515335,5.079740756895484,5.300279445926026,5.10094684023198,5.5470628709327885,5.059940884914502,418711.2100271003,0,E01000600,9,0,9,0,0,0,5.144753322897658,5.570606702061022,5.165601716337904,5.298689254663758,5.009209590712509,5.567552100871242,5.144426649842559,534694.0271186441,0,9,0,9,0,0,0,1.0,0,0,0,0,0,0,0
588,5.083670594402261,5.722189041005598,4.976807808956584,5.368024744294785,4.963368362268886,5.45991623119728,5.049081739944381,401522.04054054053,0,E01000601,9,0,9,0,0,0,5.010736840874402,5.666348290087572,5.0385314839989395,5.439852885049374,4.900457564871109,5.466323575866756,4.995714129500128,514759.58457711444,0,9,0,9,0,0,0,1.0,0,0,0,0,0,0,0
589,5.203806419599624,5.464722833179292,5.381033300218128,5.136744174503145,5.187420544170198,5.76088475953965,5.310175541469029,410713.4095238095,0,E01000602,8,1,9,0,1,1,5.080954302538623,5.4526362505045025,5.399185462040944,5.311966620050035,5.036636139895465,5.671190427230285,5.182544057433669,524239.4054054054,0,8,1,9,0,0,0,1.0,0,0,0,0,0,-1,-1
590,5.602693910722609,5.332299117918138,5.49235221782288,4.964365683592759,5.404974593744649,5.936431095197603,5.596418752298726,412035.2077922078,4,E01000603,6,3,6,3,3,6,5.317067744515159,5.3976064920425415,5.377732443809509,5.173898266662251,5.139951739527962,5.788164979761297,5.334590182521127,525874.1363636364,2,8,1,8,0,1,1,1.0,-2,2,-2,2,-3,-2,-5
591,5.250334751715354,5.692410103771665,5.254582872084521,5.28285632220977,5.113141437189294,5.736701899712239,5.204805675996553,414545.84403669724,1,E01000604,9,0,9,0,1,0,5.22900390625,5.590713410505226,5.281661801040173,5.385565273463726,5.049182539539678,5.731802210211754,5.191728983606611,529624.2589285715,1,9,0,9,0,1,0,1.0,0,0,0,0,0,0,0
592,5.27667171221513,5.582262685665717,5.184739462076089,5.144960375932547,5.181671014963052,5.723400284082461,5.275098281793105,418584.60256410256,1,E01000605,9,0,9,0,1,1,5.180367746105084,5.622794320128556,5.197245601973782,5.237578068854492,4.96992620636273,5.668497143453256,5.066772535357172,534328.7456647399,0,9,0,9,0,0,0,1.0,-1,0,0,0,0,-1,-1
593,5.869364226857821,5.073647413402796,5.754125967621803,4.808603275567293,5.5760417232910795,6.253501549363136,5.4392834305763245,45632.958333333336,7,E01000606,2,7,3,7,8,3,5.529798123443011,5.217436484920168,5.609824449113272,5.093556466611844,5.361878755023178,6.083656554083222,5.501508998639375,57969.087378640776,4,5,5,7,4,7,3,1.0,-3,3,-2,4,-3,-1,0
594,5.781950722467031,5.351680161937183,5.666461456690403,4.791128961455743,5.688571284148867,6.286711531759098,5.552034939361723,33923.44370860927,6,E01000607,6,5,3,9,9,5,5.621016351482536,5.328334211548673,5.456977154635176,5.007528770573532,5.336274666122243,6.114038243323942,5.568298277221149,44127.829113924054,6,7,2,5,3,7,4,1.0,0,1,-3,2,-6,-2,-1
595,5.612264395829273,5.366557830652314,5.553621880142144,4.981985191593256,5.522902375379485,6.003704753157269,5.490874161100174,33858.88340807175,4,E01000608,6,4,6,6,5,4,5.520402562769154,5.342108809998267,5.490227393963166,5.061464206075869,5.338741494633477,5.918118015120301,5.515690801012868,44179.88185654009,4,7,2,7,3,3,4,1.0,0,1,-2,1,-3,-2,0
596,5.726495395387922,5.269492700270244,5.6073687842914035,4.940431278944016,5.57198737348829,6.111497700214386,5.408806807654244,34114.014285714286,6,E01000609,5,5,6,7,7,3,5.46429654389997,5.285056624985948,5.4520190041276475,5.127032406722443,5.380302002912836,5.916661841959893,5.5312640184088595,44269.08860759494,4,6,2,8,4,3,4,1.0,-2,1,-3,2,-3,-4,1
597,5.735056009362726,5.36181396596572,5.5937871792737175,4.884898426778176,5.571963641573401,6.101921134135303,5.455249653143041,37091.19852941176,6,E01000610,6,4,5,7,6,3,5.586276843939742,5.312100155712807,5.515458998614794,5.021934644816673,5.299603822296613,5.930237497368904,5.502273589780886,44645.75342465754,5,6,3,6,3,4,3,1.0,-1,0,-1,1,-4,-2,0
598,5.447131027346072,5.294943565907686,5.497564163760862,5.071768190549768,5.390057591424472,5.975746020026829,5.202704488367274,89262.49275362318,3,E01000611,5,3,8,3,4,0,5.174615516382105,5.346460355029387,5.496633941986982,5.189113116264343,5.159149628527024,5.929862891926485,5.3527677998823275,112905.98823529412,0,7,3,8,0,4,1,1.0,-3,2,0,0,-3,0,1
599,5.709323020868523,5.420060274905937,5.520113739856454,4.904333151357118,5.512039586555126,6.074363475622133,5.436791522558345,358626.25581395347,6,E01000612,7,3,5,5,6,3,5.610453296102872,5.47421430619382,5.3667225231781845,5.068979466159041,5.342660056951955,5.97313366673928,5.483186146172371,450621.78453038674,5,9,1,7,4,5,3,1.0,-1,2,-2,2,-1,-1,0
600,5.636708012380098,5.412371846249229,5.644605538719579,4.9059205394042165,5.583665616888749,6.113257591347946,5.453552894843252,32811.85263157895,5,E01000613,7,5,5,7,7,3,5.569468156578615,5.266509709898958,5.5071099615588635,5.039039239440997,5.316838416856589,6.046417064273481,5.6395047817033594,42722.85567010309,5,6,3,6,3,6,6,1.0,0,-1,-2,1,-4,-1,3
601,4.900949137239921,5.619630288787004,5.109941144905439,5.37392120572125,5.059097344918949,5.464712416616882,4.952031860991222,55845.80487804878,0,E01000615,9,0,9,0,0,0,4.939193291424294,5.528709294880636,5.243743850281958,5.439277040182486,5.056304126448885,5.506461585767171,5.122062301847357,72658.86686390532,0,9,0,9,0,0,0,1.0,0,0,0,0,0,0,0
602,5.898107031981151,5.149022298057874,5.5805712878704075,4.733430352807045,5.535380052526792,6.149412894248963,5.718026291330656,34028.691666666666,7,E01000616,3,4,2,6,7,7,5.718746371672187,5.209868436128321,5.626579823628278,4.881056793139014,5.305819215069355,6.012602908510558,5.576686369701171,44301.07042253521,7,5,5,3,3,5,5,1.0,0,2,1,1,-3,-2,-2
603,5.792335720385536,5.255782960498401,5.628582084246275,4.751374255465922,5.622697598516604,6.227724624892413,5.696774180326084,107589.64971751413,7,E01000617,4,5,2,8,8,7,5.648395934971896,5.078428287217111,5.644820374431032,4.926711021770131,5.418466208920334,6.0762910727298625,5.655241363698786,92011.8303030303,6,2,5,4,6,7,6,1.0,-1,-2,0,2,-2,-1,-1
604,5.7427796587463495,5.1694587653921555,5.699492229047672,4.754903277685476,5.693990435711173,6.311692753503489,5.831995303316634,309981.488372093,6,E01000618,3,6,2,9,9,9,5.637080653147264,5.141542719169096,5.653728093161727,5.0190168646248905,5.501837228283738,6.155966906836539,5.754793958230452,391585.3409090909,6,3,5,6,7,8,8,1.0,0,0,-1,4,-2,-1,-1
605,5.484869053383835,5.327541862215314,5.653864832485423,4.93208083385179,5.463897167133684,6.187825152853958,5.71484684843977,196079.17647058822,3,E01000619,6,5,5,4,8,7,5.285979559927275,5.184298983728043,5.662882757909371,5.173198194214792,5.395761103341074,6.1096209805421156,5.477412300880509,287468.4646464646,1,4,6,8,5,7,3,1.0,-2,-2,1,3,1,-1,-4
606,5.377259311920557,5.452135592240554,5.2902997768842255,5.146686239120288,5.283723307267214,5.753561595770029,5.40991402161427,416398.8256410256,2,E01000620,8,0,9,1,1,3,5.168898983668256,5.3704991065045835,5.214002928426189,5.319357389403928,5.088231133517398,5.65870782572736,5.260231369926084,531874.9408602151,0,7,0,9,0,0,0,1.0,-2,-1,0,0,-1,-1,-3
607,5.513148133571331,5.287108624592806,5.649507352174857,4.920826081282053,5.4705040707038,6.050126301936614,5.630220556106323,418820.3782051282,3,E01000621,5,5,5,4,5,6,5.3689807195489,5.245547879032973,5.6027650731365854,5.09982190190292,5.237592516875848,5.907885842207001,5.515868396293826,534986.2073170731,2,5,4,7,1,3,4,1.0,-1,0,-1,2,-3,-2,-2
608,5.730858300803998,5.334881514584253,5.526338297292726,4.886426609590513,5.45547642401599,6.0977949483678975,5.609958346830595,471449.80733944953,6,E01000622,6,3,5,4,6,6,5.6750402867377225,5.280879340805374,5.501407180632745,4.933745174141197,5.327443351278772,6.038609934853507,5.465159058570862,602246.3566433566,6,6,3,4,3,6,3,1.0,0,0,0,-1,-1,0,-3
609,5.734307354810286,5.219952922289063,5.718559586271947,4.861634039554466,5.496893105863714,6.207787285045701,5.747553088227097,415047.57823129254,6,E01000623,4,6,4,5,8,8,5.618365470273995,4.975971232961725,5.7234995070798895,4.926222346447132,5.448279533857181,6.1403454983675925,5.848821610580256,544324.1419753087,5,1,7,4,6,8,9,1.0,-1,-3,1,0,1,0,1
610,5.4082860607786225,5.4605483675971245,5.504395073440475,4.882720469823344,5.37678453099304,6.0578048870648225,5.48269533566412,471033.22335025383,2,E01000624,8,3,4,2,6,4,5.401797330441252,5.317060607084956,5.530665223462594,4.95922775280908,5.303363693810497,6.026091219847684,5.502741036019795,603016.3523316062,3,6,3,4,3,6,3,1.0,1,-2,0,0,1,0,-1
611,5.781110180275781,5.345535728903044,5.53040683056627,4.949657599131267,5.477866056419554,6.0004680170899345,5.5830822097403665,463428.8154761905,6,E01000625,6,3,6,4,5,5,5.730965151758251,5.188323179404892,5.67448825464991,4.875384916088538,5.474499910891413,6.117005411022437,5.72607195305967,589356.1916167665,7,4,6,3,7,7,7,1.0,1,-2,3,-3,3,2,2
612,5.385112837604854,5.393129882605179,5.4031779753125235,5.054257464149724,5.326240241527557,5.8340332404426904,5.278178646512654,469998.9347826087,2,E01000626,7,1,7,1,2,1,5.347194486608108,5.320392969995737,5.424997508525848,5.141993321478367,5.232050760338704,5.817719381302595,5.443162852277358,601094.2916666666,2,7,2,8,1,2,2,1.0,0,0,1,1,0,0,1
613,5.328048759644185,5.438397181690286,5.372971160149356,5.184471436596792,5.226642446780423,5.8090783975539955,5.357883766156818,468666.8623853211,1,E01000627,7,1,9,0,2,2,5.233155131592055,5.3714463620054795,5.417671750010194,5.1968017884591164,5.137855785845702,5.7544641681251765,5.371149279350458,598293.5158562368,1,7,1,9,0,1,1,1.0,0,0,0,0,0,-1,-1
614,5.406355583419402,5.334613732372721,5.403118556365371,5.165289850284656,5.32730046659708,5.9200442501654225,5.5861780898024636,427312.9166666667,2,E01000628,6,1,9,1,3,6,5.3912453693786855,5.247173890849661,5.5165342818662,5.150978898639001,5.291938310347232,5.932977917230674,5.5103641197766144,546169.2842639594,3,5,3,8,2,4,3,1.0,1,-1,2,-1,1,1,-3
615,5.49904188811779,5.1999254010617735,5.528455999493599,4.938388253748417,5.378995048254728,6.003488801419735,5.451773010194302,470092.55,3,E01000629,3,3,6,2,5,3,5.334252921695059,5.1643778871406205,5.519458054141565,5.135535735975612,5.218416062268344,5.876545619558204,5.429416930133646,601171.6306818182,2,4,3,8,1,3,2,1.0,-1,1,0,2,-1,-2,-1
616,5.557889921743362,5.127062543493802,5.716865827802752,4.950219089867638,5.507415640549581,6.106547766044492,5.589926992283493,346959.7704918033,4,E01000630,2,6,6,5,6,6,5.401101002469659,5.1058244071900845,5.683631921187043,5.001502376049757,5.397690460085869,5.973772745579481,5.399725250899792,446936.8125,3,3,6,5,5,5,2,1.0,-1,1,0,-1,0,-1,-4
617,5.745564039548238,5.154915922880173,5.766489128271739,4.919504160682361,5.575702408949534,6.31807898680369,5.803234174847603,370714.19166666665,6,E01000631,3,7,5,7,9,8,5.633527478506399,5.1737413970074915,5.73088938321254,4.9525647828745285,5.4703102037888165,6.24467470479566,5.778830930244091,469384.8914728682,6,4,7,4,7,9,8,1.0,0,1,0,-1,0,0,0
618,5.624816076031753,5.148013055324554,5.785466688019889,4.958104594477585,5.548190677804606,6.254731521010399,5.869757819388594,413356.96428571426,5,E01000632,3,7,6,6,8,9,5.518615932787879,5.140733055138992,5.702114293130777,5.023115542985625,5.397125368401156,6.162541807708093,5.711570862996376,527619.3389830509,4,3,6,6,5,8,7,1.0,-1,0,-1,0,-1,0,-2
619,5.547753528872533,5.05733463034701,5.822292870550013,4.868770280880715,5.506728204328622,6.120367804569985,5.567438418295846,367067.53731343284,4,E01000633,2,8,4,5,7,5,5.527422608624042,5.02962407259874,5.823212652139261,4.990722879557542,5.43723816015351,6.031331018662788,5.521202900879819,465037.09154929576,4,2,8,5,6,6,4,1.0,0,0,0,1,1,-1,-1
620,5.510551663867214,5.179256716318298,5.589743871437876,4.880421819394095,5.405425979380022,6.045717963001184,5.490788471280482,47412.087719298244,3,E01000634,3,4,4,3,5,4,5.445256593092433,5.123686084207499,5.628057844233963,5.001919738526614,5.227428841141035,5.934163676117951,5.419276845905016,62709.188679245286,3,3,5,5,1,4,2,1.0,0,0,1,1,-2,-1,-2
621,5.518498103053584,5.069158416952012,5.692482217887923,4.962381653703017,5.432431424973328,5.965427347690384,5.441761169819474,34633.73410404624,3,E01000635,2,6,6,3,4,3,5.462574702533171,4.960977819514147,5.693330280921039,4.9932905397313165,5.322603484526038,5.874903998910424,5.419116310257325,45064.82352941176,4,1,6,5,3,3,2,1.0,1,-1,0,-1,0,-1,-1
622,5.58763320424727,5.075976290873119,5.781838685274124,4.965550974011421,5.429102712443897,6.149056025913784,5.521394135696547,149029.60714285713,4,E01000636,2,7,6,3,7,4,5.334416823308976,4.969843745231628,5.786695445170168,5.028199787999763,5.31512650114591,6.00856165026055,5.553676449861682,178960.7213114754,2,1,8,6,3,5,4,1.0,-2,-1,1,0,0,-2,0
623,6.243254155948244,4.753811484780805,6.131758804978995,4.615607483633633,5.681974682314642,6.516736433423799,5.910766108282681,488358.775862069,9,E01000637,0,9,0,9,9,9,6.07762299378713,4.750225673119227,6.016910803318024,4.709906689325968,5.4568217178185785,6.413073126475016,5.808246781428655,624514.15,9,0,9,0,7,9,8,1.0,0,0,0,0,-2,0,-1
624,5.372975571853359,5.0980977096208715,5.703875210227036,5.055214386160781,5.330024835540027,5.933567529771386,5.376977183469912,484731.14634146343,2,E01000638,2,6,7,1,3,2,5.478087985515595,5.029958947499593,5.757737072308858,4.897561829619938,5.231144195132785,5.962859506077237,5.415497563944923,620249.7222222222,4,2,7,3,1,4,2,1.0,2,0,1,-4,0,1,0
625,6.127045841444106,4.920988968440464,5.992747951121557,4.59826547617004,5.606792452789488,6.476420808406103,5.863013852210272,487836.3095238095,9,E01000639,0,9,0,7,9,9,5.9908028740480725,4.910527941692306,5.983401916113245,4.7130084181406415,5.470388096499156,6.302482843399048,5.792122799229909,623929.8072289156,9,1,9,0,7,9,8,1.0,0,1,0,0,0,0,-1
626,5.538532028072758,4.976541728304143,5.77268508024383,4.93361738167311,5.444860630913785,5.973355496138857,5.486919204394023,488599.72807017545,4,E01000640,1,7,5,4,4,4,5.446113951780178,4.995761190299635,5.80285621130908,4.919182973879355,5.284407781230079,5.904692000812954,5.566439926624298,624764.074074074,3,1,8,4,2,3,4,1.0,-1,0,1,-1,-2,-1,0
627,5.758516601153782,4.919930778798603,5.835631770747049,4.798929322333563,5.47014152719861,6.182763159275055,5.736327628294627,483805.89285714284,6,E01000641,0,8,3,4,8,8,5.711364480886567,4.959476016880421,5.871616781427619,4.868184316024352,5.311462241612124,6.126053528839282,5.63192569137959,616733.9325842697,7,1,8,3,3,7,6,1.0,1,1,0,0,-1,-1,-2
628,5.8445791524785164,4.856100584714468,5.921316800226692,4.853141035742432,5.57027242747882,6.084651861481994,5.721125544482515,487423.98473282444,7,E01000642,0,8,4,7,6,7,5.753250045866906,4.8554523602316655,5.908885365800012,4.879255025447169,5.426060771640343,5.996865959107121,5.6500720381736755,623442.5506329114,7,0,9,3,6,5,6,1.0,0,0,1,-1,-1,-1,-1
629,5.812763922456382,5.2648530899038635,5.600897328289235,4.8613536167835845,5.520304716727584,6.044871150583461,5.693116678707842,489784.3623188406,7,E01000643,5,4,4,6,5,7,5.650149085558951,5.214885958936065,5.53723270772025,4.9585771737620234,5.372573713306338,6.003509096801281,5.67562444601208,626270.8046875,6,5,3,4,4,5,6,1.0,-1,0,-1,0,-2,0,-1
630,6.026831876663935,4.9252999141102745,5.9907986379805065,4.7513967383475535,5.589151521523793,6.309607173715319,5.818523608502888,488681.20238095237,8,E01000644,0,9,2,7,9,9,5.82928438271795,4.892592017139707,5.886583033062163,4.800132879189083,5.363575628825596,6.189314109938485,5.745996580237434,624869.619047619,8,0,8,1,4,8,8,1.0,0,0,-1,-1,-3,-1,-1
631,6.10385791460673,5.4728548547862905,5.300829316310827,4.61434269021746,5.6874784013163024,5.958212155508081,5.600847627561001,319682.18879056047,9,E01000645,8,0,0,9,4,6,6.073656069354777,5.326400771828517,5.478069758122684,4.69323562259323,5.607510356815315,6.013655557954238,5.584860043657338,410282.96319018403,9,7,2,0,9,5,5,1.0,0,-1,2,0,0,1,-1
632,6.0088800035846175,5.219406697138441,5.609560381679635,4.687918829044122,5.635821761261107,6.174375812420671,5.7351697258924315,319995.29842931934,8,E01000646,4,5,1,8,7,8,5.89345013791201,5.293732145611121,5.629163448907891,4.783394615260923,5.45284352801284,6.106232611500487,5.723599697862353,411536.35714285716,8,6,5,1,6,7,7,1.0,0,2,0,0,-2,0,-1
633,5.844361702884947,5.116919577121735,5.72015358039311,4.7647145220211575,5.50513938324792,6.257690599986485,5.768759049688067,331579.8214285714,7,E01000647,2,6,2,5,8,8,5.7249425609095566,5.137047161050394,5.676998730419444,4.8755479442829985,5.43026446160816,6.1477455314324825,5.832968358279897,425776.7074829932,7,3,6,3,6,8,8,1.0,0,1,0,1,1,0,0
634,5.744501300480055,5.283034239414233,5.57804644856476,4.786494517671889,5.543732875211227,6.079824092883419,5.63069114420149,323230.9130434783,6,E01000648,5,4,3,6,6,6,5.6243319247676204,5.2536227898260135,5.5255438949154545,4.906802129956473,5.393474330416823,5.9934761112770145,5.606803857647212,414741.3539823009,6,5,3,3,5,5,5,1.0,0,0,-1,0,-1,-1,-1
635,5.610236893217247,5.519751180367297,5.345759676163455,4.829820123781641,5.495101269469203,5.89252996516515,5.498072134443076,318236.0602409639,4,E01000649,8,1,3,5,3,4,5.824996239334874,5.356624709783927,5.474893859857638,4.847090869260257,5.535966975449105,6.0324550831811665,5.610704358512833,408273.92307692306,8,7,2,2,8,6,5,1.0,4,-1,1,-1,3,3,1
636,6.029195015221075,5.4264452812016515,5.485897713274861,4.684549629181708,5.711144071800513,6.107587023429763,5.669289752714357,318808.7025495751,8,E01000650,7,3,1,9,6,7,6.079997780530349,5.351911546743435,5.576297999076221,4.7310643986515375,5.66053358303464,6.170158469806546,5.634108160500941,409161.26086956525,9,7,4,0,9,8,6,1.0,1,0,1,-1,0,2,-1
637,5.902284005267472,5.283683850266839,5.54261386259801,4.724236322661578,5.621744405078349,6.161242291078729,5.714406377178127,320224.5084745763,8,E01000651,5,3,1,8,7,7,5.8102528130014734,5.283546316747864,5.622099371006091,4.842621743679047,5.487901234378417,6.057303216308355,5.620259431501229,411104.21875,8,6,5,2,7,6,5,1.0,0,1,2,1,-1,-1,-2
638,5.816872894245646,5.326710568821949,5.579195511859396,4.737226958896803,5.6384285584740015,6.24209158524223,5.750185777830041,319046.652173913,7,E01000652,6,4,2,8,8,8,5.876660378355729,5.260859568913777,5.627524124948602,4.799121186921471,5.543906876392532,6.252820852555726,5.808555287227296,409488.9736842105,8,5,5,1,8,9,8,1.0,1,-1,1,-1,0,1,0
639,6.139459843818958,5.319870071227734,5.469867565540167,4.598021421065697,5.706339667393611,6.048127520084381,5.681874530132,306012.6346153846,9,E01000653,6,2,0,9,5,7,6.057253299205284,5.280240275510928,5.559577164611196,4.710855823222214,5.672392098884273,6.0965748065855445,5.61858162356586,394224.7032520325,9,6,4,0,9,7,5,1.0,0,0,2,0,0,2,-2
640,5.74797057056427,5.467359239578247,5.255058658599854,4.905513453483581,5.466246094703674,5.7742470312118535,5.139874484062195,731668.488,6,E01000654,8,0,5,4,1,0,5.652506782895043,5.50231538216273,5.266624751545134,4.898864079089392,5.370261163938613,5.733969058309283,5.227331205492928,929157.0952380953,6,9,0,3,4,1,0,1.0,0,1,0,-2,0,0,0
641,5.558658131352671,5.489541949925723,5.305821177842733,4.8698222195351875,5.349908900427652,5.845957897759818,5.132238616476526,731666.3426573427,4,E01000655,8,0,4,2,2,0,5.50577309675384,5.638448671290749,5.267590112853468,5.013089852374897,5.301480806710427,5.6734762986501055,5.286111667490842,929197.0614035088,4,9,0,6,3,0,0,1.0,0,1,0,2,1,-2,0
642,5.810986721450514,5.581306861723707,4.98385408536984,4.888364802292787,5.403965521705606,5.6469690138525,5.086486045128661,692818.6120218579,7,E01000656,9,0,5,3,0,0,5.818371433153796,5.559384615858268,4.974806130507368,4.960131555124878,5.2729406314647465,5.668193576803545,5.112477062599452,877805.7459807073,8,9,0,4,2,0,0,1.0,1,0,0,-1,-1,0,0
643,5.62656505378381,5.452820897416892,5.377671842524747,4.95060911845406,5.420608774024138,5.808913633502567,5.256499184782084,732167.1794195251,5,E01000657,8,1,6,3,2,1,5.443159582009956,5.495483777416286,5.316419443977413,4.995199417000387,5.270980336772862,5.71975410162513,5.349863719584337,929940.276119403,3,9,0,5,2,1,1,1.0,-2,1,-1,-1,-1,-1,0
644,5.563428501598537,5.592892073560506,5.1717792777344584,5.064431772567332,5.372746399138123,5.783716780133545,5.251366097014397,702265.375,4,E01000658,9,0,8,2,1,1,5.590358625998539,5.4497761161981435,5.340989452547731,4.934689177348551,5.432653732531894,5.886032683659444,5.560535819129607,863669.8539823008,5,8,1,4,6,3,4,1.0,1,-1,1,-4,4,2,3
645,5.5855325556689905,5.52909397190402,5.316783514082061,4.9003081802996045,5.369556104174312,5.811192075658289,5.205027255952729,731565.9937888199,4,E01000659,8,1,5,2,2,0,5.571217565664223,5.544482065098626,5.314170124275344,4.948949591389725,5.314335489911692,5.8327528557607105,5.447518038962569,929054.0803571428,5,9,0,4,3,2,2,1.0,1,1,-1,-1,1,0,2
646,5.691404532230898,5.498496325530669,5.273097599655521,4.951846497699552,5.460176719968015,5.913323434964151,5.432049848959835,320210.18942731275,5,E01000661,8,0,6,4,3,3,5.817890389555903,5.461854399975473,5.387058415213581,4.8861326159388305,5.433767722350608,5.93574597482896,5.543496635565804,411477.3118971061,8,9,1,3,6,4,4,1.0,3,1,1,-3,2,1,1
647,5.747159511543984,5.428200147318286,5.514805331341056,4.857422678969627,5.550329787786617,6.155079842722693,5.793614865458289,318790.86511627905,6,E01000662,7,3,4,6,7,8,5.807411609390969,5.398014555093248,5.6413727173438435,4.892500097935017,5.531528584387621,6.198024834698511,5.788654897377076,409176.5870445344,8,8,5,3,8,8,8,1.0,2,1,2,-1,2,1,0
648,5.72892166446237,5.304461557023665,5.5849706130869246,4.794758983920603,5.6018660089548895,6.174923742518706,5.761244666576386,315739.75294117647,6,E01000663,5,4,3,7,7,8,5.883366710999432,5.277122597834643,5.690800828092239,4.93420542198069,5.62246579843409,6.310898731736576,5.929730426563936,405442.9588235294,8,6,6,4,9,9,9,1.0,2,1,2,1,2,2,1
649,5.760082500321524,5.413831254414149,5.555373081479754,4.840920257568359,5.616113115038191,6.157827505384173,5.651890011514936,322591.0857142857,6,E01000664,7,4,4,8,7,7,5.738952738574788,5.343558587605441,5.619249719607679,4.83817600675776,5.550697814060163,6.257423758506775,5.804815040359014,414710.2405063291,7,7,5,2,8,9,8,1.0,1,0,1,-2,0,2,1
650,5.7250530397682855,5.453705756706104,5.420728376873752,4.895833340444063,5.572874403836434,6.0239833626830785,5.393904579731456,327162.9684210526,6,E01000665,8,2,5,7,5,2,5.653810490906017,5.382731697373231,5.4600570941946325,4.891036436903432,5.440355319072766,6.023040424049122,5.667115285937228,420037.69516728626,6,8,2,3,6,6,6,1.0,0,0,0,-2,-1,1,4
651,6.075355624843455,5.537657744687419,5.10503507626501,4.816446818833993,5.557749947813766,5.789920166786911,5.295751909575934,343092.9740680713,9,E01000666,9,0,3,6,1,1,6.118513656843557,5.445967250010547,5.237146137853156,4.786556742508714,5.460164805499393,5.908424698900512,5.468646784131372,440761.04643962847,9,8,0,1,7,3,3,1.0,0,-1,0,-2,1,2,2
652,6.1036008034433635,5.442789937768664,5.465110654490335,4.688242059520313,5.686072708027703,6.0634661955492835,5.6021912212882725,339047.2392857143,9,E01000667,7,2,1,9,6,6,6.0550354835738895,5.391210772261634,5.443371428676208,4.70497026654072,5.606888496537314,6.072769762965783,5.724033251545783,435817.58359621454,9,8,2,0,9,7,7,1.0,0,1,0,-1,0,1,1
653,5.507735248208046,5.2636329972743985,5.549519723653793,4.974576521515846,5.434306293129921,6.0560492837429045,5.557201238870621,327319.085,3,E01000668,5,4,6,3,6,5,5.483604536723282,5.214886897701328,5.632566620737819,5.012062869334625,5.434821599620884,6.046406149864197,5.572563047631312,419496.55508474575,4,5,5,6,6,6,5,1.0,1,0,1,0,3,0,0
654,5.62125501036644,5.211596488952637,5.689831607043743,4.927478961646557,5.4963463973253965,6.223123263567686,5.584037279710174,320980.8984375,5,E01000669,4,6,5,5,8,6,5.5684782474329975,5.0844145308841355,5.742354161811598,4.94555367122997,5.478299982620008,6.109585357434822,5.554210928353396,411711.5227272727,5,3,7,4,7,7,4,1.0,0,-1,1,-1,2,-1,-2
655,6.06954643201828,5.267645734786988,5.71839870262146,4.726380688667297,5.634599771499634,6.23879463672638,5.857947847366333,333837.216,9,E01000670,5,6,2,8,8,9,5.9122188730384915,5.236096850366193,5.672643595322003,4.823474229515279,5.511039761082754,6.147050695274266,5.801391860378105,428697.56653992395,8,5,6,2,8,8,8,1.0,-1,0,0,0,0,0,-1
656,5.579393069179072,5.288767032540602,5.579279302861649,4.924644306215937,5.491401451860549,6.09870688074586,5.622792751802875,332790.15028901736,4,E01000671,5,4,5,5,6,6,5.509607372310875,5.216476783914081,5.620669802703427,5.024499029089502,5.33732239472664,6.0207787435607045,5.5938222273594915,427326.5310734463,4,5,5,6,3,6,5,1.0,0,0,1,1,-2,0,-1
657,5.931134912405121,5.379016783130303,5.609103006593297,4.791957475496142,5.612190510449785,6.071827090188359,5.653867645210095,263791.86516853934,8,E01000672,7,5,3,8,6,7,5.740292205739377,5.293578786043385,5.502393790738499,4.92960159339715,5.464313648233366,5.985933289599063,5.5311025298056915,338843.3383084577,7,6,3,4,7,5,4,1.0,-1,-1,-2,1,-1,-1,-3
658,5.957020941570666,5.2135558318809645,5.711975990667851,4.764614884669964,5.641212257407826,6.181178548632289,5.65414566683346,299573.68639053253,8,E01000673,4,6,2,8,7,7,5.8681420787086696,5.203593900749803,5.659486333751146,4.864456513740497,5.52255811771201,6.083394744542724,5.625524985723655,383931.04469273746,8,4,6,2,8,7,6,1.0,0,0,0,0,0,0,-1
659,5.832975907759233,5.234676204621792,5.67584237862717,4.726493795487014,5.597652599892833,6.065789347345179,5.611427964134649,298127.2215909091,7,E01000674,4,6,2,7,6,6,5.790067890974192,5.220436197060805,5.6079102980784885,4.866203850354903,5.476734859515459,6.064840155381423,5.586817378264207,379667.9641025641,7,5,5,3,7,6,5,1.0,0,1,-1,1,0,0,-1
660,5.629810697830801,5.1566213014869575,5.654714661158904,4.909895775617038,5.458873015451014,6.032602073847379,5.596889606370175,330056.472303207,5,E01000675,3,5,5,4,5,6,5.471846519323884,5.184524320736133,5.593077865857927,5.029344567546138,5.343099984857771,5.948158881651661,5.621236310434089,423466.3068783069,4,4,4,6,4,4,5,1.0,-1,1,-1,1,0,-1,-1
661,5.585730984071979,5.138184063637738,5.554900417413412,4.963268111104923,5.407573398453238,5.871025432385672,5.380560417880926,316696.13004484307,4,E01000676,3,4,6,3,2,2,5.513367605209351,5.14778183561105,5.5705787942959715,4.981516560682883,5.411110518070368,5.911143733904912,5.4714961239924795,406260.2,4,4,4,5,5,3,3,1.0,0,1,0,-1,2,1,1
662,5.695310598015785,5.3481839948892596,5.521626987457275,4.8674692225456235,5.464555425047874,5.921665168404579,5.440050686597824,331086.405,5,E01000677,6,3,4,4,3,3,5.584846428285043,5.240075224389632,5.614241104573011,4.934555318206549,5.408894835660855,5.952771894012888,5.4209535121917725,424823.796875,5,5,5,4,5,4,2,1.0,0,-1,2,0,1,1,-1
663,5.803766858648267,5.188364371745544,5.68264877725635,4.732591099993011,5.6039010483837695,6.24333397030125,5.757365369937829,332949.5562130177,7,E01000678,3,6,2,7,8,8,5.682981141278001,5.1333054506062155,5.725237440541794,4.903951336125859,5.475109203917081,6.199951848045725,5.736077809594368,427541.9344262295,6,3,7,3,7,8,7,1.0,-1,0,1,1,0,0,-1
664,5.396817597086558,5.258691738465589,5.517167279820242,5.035258766419873,5.432978688599821,6.038479850677673,5.5540515883953985,327613.90419161675,2,E01000679,4,3,7,3,5,5,5.384895196557045,5.190604710578919,5.615670059621334,5.0726590499281885,5.349469614773989,6.049269326776266,5.545945316553116,421104.2375,3,4,5,7,4,6,4,1.0,1,0,2,0,1,1,-1
665,6.083166222887554,5.591504645303197,4.909128710100327,4.827367249258848,5.361812216498555,5.643848586126857,5.140551800279422,351910.43947858474,9,E01000680,9,0,3,2,0,0,6.133938886313571,5.542862354884506,5.046218472624956,4.768972364456757,5.347873821206715,5.728531016191475,5.297974445367519,450849.37845849805,9,9,0,1,4,1,0,1.0,0,0,0,-2,2,1,0
666,5.566992210930791,5.575616379578908,5.406138573569813,4.921004615981003,5.482224215036151,6.008792420228322,5.533359398787049,337292.4597701149,4,E01000681,9,1,5,5,5,5,5.652111876010895,5.367310231261783,5.589537648359935,4.878644943237305,5.523450391822391,6.171590557363298,5.791986971431308,433029.68888888886,6,7,4,3,8,8,8,1.0,2,-2,3,-2,3,3,3
667,5.721500840746922,5.481982312221759,5.350845934891025,4.87351244133011,5.551898326468371,6.063195168730701,5.409520781474558,345058.0971659919,6,E01000682,8,1,4,6,6,3,5.900825240887886,5.302175852385434,5.596413711870998,4.727426387554358,5.600406275800437,6.190961018081539,5.7664780326126035,442759.2148760331,8,6,4,0,9,8,8,1.0,2,-2,3,-4,3,2,5
668,5.497262485136235,5.68344973731162,5.1768005124203444,5.113202427849552,5.367891962758176,5.760633549714451,5.234598901671202,338487.24365482235,3,E01000683,9,0,8,2,1,1,5.527450583432172,5.438244011595443,5.369187300914042,4.92067171496314,5.379946917456549,5.96851420144777,5.562770119228879,434440.6756756757,4,8,1,4,4,5,4,1.0,1,-1,1,-4,2,4,3
669,5.825132581076228,5.476548610325146,5.4894286277598905,4.808026858290336,5.631926784838052,6.133425149702488,5.56109532064065,348886.492481203,7,E01000684,8,3,3,8,7,5,5.863223513117377,5.428819682913007,5.549440697903903,4.742854756229328,5.563376270150239,6.20281224430732,5.876156084042675,447164.56226415094,8,8,4,1,8,8,9,1.0,1,0,1,-2,0,1,4
670,5.854570594122402,5.450202313606425,5.3561308528180644,4.830784664035268,5.444955179699799,5.94231908601374,5.497858201905926,345225.8185053381,7,E01000685,8,1,3,4,4,4,5.832435840446698,5.440713331103325,5.303002124554233,4.86486237652992,5.416384831463036,5.9248782576699,5.578125036860767,441970.6414473684,8,8,0,2,5,4,5,1.0,1,0,-1,-1,1,0,1
671,5.885736416813522,5.577292155262619,5.331953498033377,4.819324790434694,5.599824318519006,5.957576590636901,5.283396873984448,350971.1939799331,7,E01000686,9,1,3,7,4,1,6.004986070379426,5.40901430120951,5.471396569964252,4.709969042599956,5.5952467020553875,6.10782937233961,5.668015528328811,449338.9683544304,9,8,2,0,9,7,6,1.0,2,-1,1,-3,2,3,5
672,5.645242074118232,5.471482839452507,5.388759036767318,4.926084125096897,5.429024116784197,5.979630115394768,5.355867951147018,352920.75576036866,5,E01000687,8,1,5,3,4,2,5.586964891582239,5.403598633457403,5.405315096261071,4.992254911876116,5.321031980827207,6.015976931228012,5.641307480022555,452032.3893442623,5,8,1,5,3,5,6,1.0,0,0,0,0,0,1,4
673,6.033124504089355,5.45035300731659,5.385319036483764,4.679240150928497,5.671554831504822,6.060586108207703,5.5550098614692685,353161.86,8,E01000688,8,1,1,8,6,5,5.869669749186589,5.433907856798579,5.399214946816111,4.770964285247346,5.52435347972772,6.00848776458675,5.661287775915912,452396.49145299144,8,8,1,1,8,5,6,1.0,0,0,0,0,0,-1,1
674,5.884048408855593,5.475699905026166,5.353057981915557,4.743032457511549,5.611397118926737,5.990005865262423,5.61011463231434,311882.0867052023,7,E01000689,8,1,2,8,4,6,5.715129484301028,5.477256037186885,5.354400752247244,4.925134481727213,5.412548133428546,5.970525116160296,5.5102990563365,400957.6376811594,7,9,1,4,5,5,3,1.0,0,1,0,2,-3,1,-3
675,5.8708526676858375,5.33320514988481,5.637852681310553,4.765333770311367,5.669512815642775,6.273108747270372,5.8283616820274045,308710.8128654971,7,E01000690,6,5,2,8,8,9,5.875673717743641,5.295265271856978,5.636234229480898,4.856975698793256,5.627126397313298,6.217267521329828,5.795592373287356,392744.02702702704,8,6,5,2,9,8,8,1.0,1,0,0,0,1,0,-1
676,5.6466515861405915,5.351453321111714,5.574369499288454,4.833825031672519,5.4760975135616,6.104974872495499,5.65247051847493,356398.44171779143,5,E01000691,6,4,4,4,6,7,5.626426919148519,5.347503542135923,5.561853803121126,5.00602051615715,5.4318520579582605,6.062643374388035,5.577418803404539,455060.8012820513,6,7,4,5,6,6,5,1.0,1,1,0,1,2,0,-2
677,5.849543383627227,5.185374986041676,5.706084564478711,4.722893020721397,5.64946800289732,6.217481154384035,5.6391563969429095,306840.1515151515,7,E01000692,3,6,1,8,8,6,5.705774987108322,5.154912985568484,5.720312546954926,4.813474868062282,5.556996404864382,6.103407479790101,5.586473755961422,393831.4847161572,7,4,7,2,8,7,5,1.0,0,1,1,1,0,-1,-1
678,5.985759105879007,5.494321263635282,5.195068081322405,4.822415705808659,5.55942170736716,5.81267903453296,5.423419428547633,308602.07731958764,8,E01000693,8,0,3,6,2,3,6.0549777205859385,5.37076741874775,5.3442693887469925,4.747376558936645,5.525141602364656,5.940850706858056,5.526030470556188,396230.2359813084,9,7,1,1,8,4,4,1.0,1,-1,1,-2,2,2,1
679,6.007093652721919,5.350488285292391,5.50887936704299,4.65516262029694,5.7454023031214945,6.141387022077831,5.647743501052725,324600.9584775086,8,E01000694,6,3,1,9,7,7,6.067179931199938,5.326062005349445,5.629664756761131,4.699551709292168,5.731124655004012,6.1426207175754035,5.6564000061703075,414540.8916967509,9,7,5,0,9,8,6,1.0,1,1,2,-1,0,1,-1
680,6.142272111232773,5.344028533259524,5.499244091379994,4.547819968517319,5.759572888225443,6.02842490683125,5.637696788783818,320902.0253164557,9,E01000695,6,3,0,9,5,6,5.990297835720472,5.290695578106178,5.542931567538869,4.720239089540214,5.645823428946093,6.031963218342174,5.5557269547596455,411521.85950413224,9,6,3,0,9,6,4,1.0,0,0,0,0,0,1,-2
681,6.161669674024477,5.502143174999363,5.223938638299376,4.661633520335942,5.669849656440399,5.8838870779498595,5.516223577352671,308995.96483516484,9,E01000696,8,0,1,8,3,4,6.221968806801869,5.476508057388953,5.331233005345978,4.702311679443217,5.632374862706439,5.9637403796671835,5.483410100018756,396564.28985507245,9,9,1,0,9,4,3,1.0,0,1,1,-1,1,1,-1
682,6.1239701487801295,5.3493385007164695,5.471953475692056,4.672827828580683,5.652632715918801,5.951838019977917,5.593348188833757,315748.92727272725,9,E01000697,6,2,1,8,4,6,6.012924136525412,5.339416887449182,5.474877930803841,4.676289999764101,5.575271501190287,5.971181548160056,5.596383504644286,404967.9297658863,9,7,2,0,9,5,5,1.0,0,1,0,-1,1,1,-1
683,6.1240494549274445,5.429284192847483,5.340273160374526,4.745515197515488,5.749436001886021,6.012292732795079,5.4499376492969915,310545.1022727273,9,E01000698,7,1,2,9,5,3,6.329067579087089,5.3787620760062165,5.536119463689187,4.702416751314612,5.707308081143043,6.137570395189173,5.658167181207853,398708.35661764705,9,8,3,0,9,8,6,1.0,0,1,2,-2,0,3,3
684,5.780905953769026,5.07616113794261,5.824867062185002,4.729632470799588,5.534650407988449,6.235503193975865,5.678324219824254,307157.7011494253,6,E01000699,2,8,2,6,8,7,5.833172356304915,4.932683103758356,5.914133566877116,4.873806752588438,5.4684102068776665,6.2974081531814905,5.781029312506966,393937.04347826086,8,1,9,3,7,9,8,1.0,2,-1,1,1,1,1,1
685,5.691205364465714,5.205359401305516,5.646482944488525,4.964691215753556,5.471019503474236,6.103429474433264,5.4284408013025915,306314.93333333335,5,E01000700,4,5,6,4,6,3,5.603782252470652,5.105801511804263,5.572423946857453,4.913265842199325,5.381778396169344,6.104603722691536,5.560741794109345,393278.075,5,3,4,3,5,7,4,1.0,0,-1,-1,-3,1,1,1
686,5.869642704032188,5.081027536891227,5.912142811819565,4.649111487144648,5.760606485743855,6.411422535430553,5.924283760924672,305928.81395348837,7,E01000701,2,8,0,9,9,9,5.751513312134562,5.070692145371739,5.865523830244813,4.886549718772309,5.563455620898476,6.243767644785628,5.751199269596534,392761.7088607595,7,2,8,3,8,9,8,1.0,0,0,0,3,-1,0,-1
687,5.752428341885002,5.088885062811326,5.852587188993182,4.81146133554225,5.570867085943417,6.237886219608541,5.683903486144786,305771.7448979592,6,E01000702,2,8,3,7,8,7,5.533343578577042,4.9952602279186245,5.769895963668823,4.907050524950027,5.4902667045593265,6.133839762210846,5.666872323751449,392576.36,4,1,7,3,7,8,6,1.0,-2,-1,-1,0,0,0,-1
688,6.01685013386511,4.994507262014573,5.928283997504942,4.691899661864004,5.662484390504899,6.382846643078712,5.847796060962062,312562.0258064516,8,E01000703,1,9,1,8,9,9,5.93318926512137,4.988659618874274,5.812983030398216,4.733772833671796,5.550597602799094,6.288166836168639,5.856360132172263,402305.33136094676,9,1,8,0,8,9,9,1.0,1,0,-1,-1,0,0,0
689,5.679072811712627,5.172831668573267,5.641662441827114,4.788004052405264,5.5049973048415834,6.117921170066385,5.584508978463466,325588.24836601305,5,E01000704,3,5,3,5,7,6,5.601240925929126,5.089282788949855,5.578869544758517,4.8989328258177816,5.391290985135472,6.120274794802946,5.62564692847869,418634.3588235294,5,3,4,3,5,7,6,1.0,0,0,-1,0,0,0,0
690,5.884370698018021,5.08671967768937,5.773310911789369,4.742475170767709,5.522818203722493,6.251865169975195,5.638017411982076,323044.80898876407,7,E01000705,2,7,2,6,8,6,5.77820633334675,5.134287969819431,5.8205720282149045,4.881079358616095,5.474164692834876,6.198830985474861,5.786438354130449,415633.8390804598,7,3,8,3,7,8,8,1.0,0,1,1,1,1,0,2
691,5.5593875494870275,5.384519093686884,5.499733644182032,4.834806836735119,5.488361644744873,6.090040519020774,5.490437537973578,322538.4818181818,4,E01000706,7,3,4,5,6,4,5.531669129405105,5.2503388869135,5.530099113782247,4.931385796321066,5.3824881022436575,6.073209800218281,5.46859476963679,413221.56140350876,4,5,3,4,5,7,3,1.0,0,-2,0,0,0,1,-1
692,5.895962062958748,5.0139164993839875,5.827089369681573,4.702805488340316,5.631007705196257,6.381081802614274,5.678066948152358,325294.29032258067,7,E01000707,1,8,1,8,9,7,5.673077512107439,5.089108816729296,5.733981119706327,4.824685832798081,5.47179050013523,6.204750712285906,5.721477644555521,417930.19463087246,6,3,7,2,7,8,7,1.0,-1,2,-1,1,-1,-1,0
693,5.840752369432307,5.138477561189167,5.720627284761685,4.733254546549783,5.578672868102344,6.2608504544443155,5.758773557285764,326732.2388059702,7,E01000708,3,6,2,7,8,8,5.6400054386920395,5.122929356164402,5.768814151485761,4.856911413371563,5.453631959027714,6.151707039939033,5.812937439315849,419616.65972222225,6,3,7,2,6,8,8,1.0,-1,0,1,0,-1,0,0
694,5.788230393330256,5.332861320177714,5.551963007450103,4.790982311301761,5.553123217158848,6.064328814215131,5.548143335845736,304537.47777777776,6,E01000709,6,4,3,6,6,5,5.7506763088888455,5.328634277526579,5.531068050799592,4.892159658392476,5.412150233520745,6.009278320895575,5.675063015265786,391416.4870466321,7,7,3,3,5,5,6,1.0,1,1,-1,0,-1,-1,1
695,5.963531533347235,5.361598783599006,5.494937795003255,4.687969985538059,5.667710263994005,6.033000583648682,5.556624399820963,262260.7377777778,8,E01000710,6,3,1,8,5,5,5.949396180890804,5.329415478857395,5.581152877656582,4.7715937071795915,5.613718939582687,6.05632902486292,5.575808290982138,337649.1900452489,9,7,4,1,9,6,5,1.0,1,1,1,0,1,1,0
696,6.310091927727276,5.148799649534379,5.704912383288623,4.508759162642739,5.861793149601329,6.242087150002546,5.760259240706337,275437.8021390374,9,E01000711,3,6,0,9,8,8,6.199903307642256,5.2389973123868305,5.69669608161563,4.655698815413884,5.716293884458996,6.274925255775452,5.759306286062513,354456.8761904762,9,5,6,0,9,9,8,1.0,0,2,0,0,0,1,0
697,6.115530016716947,5.318821564819036,5.555291558919328,4.639654437477669,5.70831246925204,6.184533176797159,5.752199895596236,294281.34831460676,9,E01000712,5,4,0,9,8,8,5.9506016521919065,5.284369646049127,5.673548805422899,4.734868754410162,5.613994742602837,6.139743847963286,5.727774553764157,379177.68292682926,9,6,6,0,9,8,7,1.0,0,1,2,0,0,0,-1
698,6.148573851717111,5.356906685381304,5.472179325904635,4.680512789863249,5.743765121006834,6.080836984992686,5.575456656803742,303053.7569060773,9,E01000713,6,2,1,9,6,5,5.975467689023047,5.256379606481084,5.549793546071309,4.778728867005445,5.628338993666414,6.104798012864804,5.649056329698619,389551.2994011976,9,5,4,1,9,7,6,1.0,0,-1,2,0,0,1,1
699,5.59346798096063,5.074258015290746,5.754516197600455,4.874174230953432,5.539660100666982,6.063270800968386,5.560920217352093,306496.4981132075,4,E01000714,2,7,4,6,6,5,5.523061638748324,5.024717400605614,5.731684343234913,4.894960414316203,5.399953588037877,6.036618888378143,5.635467903034107,393386.3378378378,4,2,7,3,5,6,6,1.0,0,0,0,-1,-1,0,1
700,5.983823689344887,5.327020164962127,5.598318242024038,4.770170662447671,5.664799254631328,6.123871928063508,5.655037384723949,313357.42523364484,8,E01000715,6,4,2,8,7,7,5.859661009058606,5.290681896262995,5.596767800480293,4.796594144911739,5.530220206889361,6.094830125403804,5.662055764118386,402371.88268156425,8,6,4,1,8,7,6,1.0,0,0,0,-1,0,0,-1
701,6.017528726991299,5.299923472699866,5.584270191403617,4.7205827573759365,5.709066992312406,6.126153965966892,5.71618966876933,318794.78761061945,8,E01000716,5,4,1,9,7,7,5.907370541654705,5.331826738763654,5.548105397863251,4.857678020399724,5.519899492628837,6.118678577779012,5.796110271837152,409071.04784688994,8,7,3,2,8,7,8,1.0,0,2,-1,1,-1,0,1
702,6.1116586670731055,5.275010294384426,5.649857332008054,4.635806397356168,5.705056515606967,6.1566213965415955,5.72993485795127,322241.404040404,9,E01000717,5,5,0,9,7,8,5.932219005873983,5.317042303876289,5.6099544876559655,4.778828500006436,5.485868553414729,6.057150826069981,5.715292035685897,413614.2701421801,9,6,5,1,7,6,7,1.0,0,1,0,1,-2,-1,-1
703,5.776429868622475,5.458041890822456,5.422094578108099,4.913184532025043,5.5793934449258,5.9862701764525506,5.469053752023843,261789.8045325779,6,E01000718,8,2,5,7,4,4,5.742851161720729,5.396552354392439,5.3879344504658535,4.937409943873339,5.417965022054049,5.971381850761943,5.531099454011067,335982.2079207921,7,8,1,4,6,5,4,1.0,1,0,-1,-1,-1,1,0
704,5.38573629617691,5.517877348661423,5.252133784294128,5.083276671767234,5.311843755841255,5.791991547942161,5.278113597035408,312226.205,2,E01000719,8,0,8,1,1,1,5.391036402286412,5.45592710835293,5.400875637709832,5.101444971193827,5.31084481997637,5.863661094909197,5.298554519724741,400813.0925110132,3,8,1,7,3,2,0,1.0,1,0,1,-1,2,1,-1
705,5.799561594234834,5.7116173552994685,4.697012306882604,5.021033362291827,5.249419681654118,5.526883315626938,4.952178458471109,320200.0693069307,7,E01000720,9,0,7,0,0,0,5.94747013820009,5.592975061658417,4.907101759324266,4.954260285842405,5.206384354499011,5.598764237823112,5.042506039596616,410146.4722524483,9,9,0,4,1,0,0,1.0,2,0,0,-3,1,0,0
706,5.289090962191812,5.6244883062013615,5.097510772592881,5.274657672526789,5.220438813851549,5.692638235154495,5.293429160429762,312949.1699346405,1,E01000721,9,0,9,0,0,1,5.587643905265911,5.341392664490519,5.378180434574952,5.072834580331235,5.476752635594961,5.910358772084519,5.351177697246139,401827.3918918919,5,7,1,7,7,3,1,1.0,4,-2,1,-2,7,3,0
707,5.360183420310538,5.630787612443947,5.285533551710198,5.086112539811307,5.348347979855824,5.793678969503885,5.259704299719937,313972.313253012,2,E01000722,9,0,8,2,1,1,5.359432667993301,5.487257179934219,5.294752535540298,5.149539395417581,5.258747089175539,5.804190128209204,5.396275653519444,403047.0251396648,2,9,0,8,2,1,2,1.0,0,0,0,0,0,0,1
708,5.404701626896858,5.738527448773384,5.122378873229027,5.091807754039764,5.326141778230667,5.6826536655426025,5.099238255620003,317984.085,2,E01000723,9,0,8,1,0,0,5.3655553712180595,5.600503132711003,5.16897350045579,5.113238580191314,5.163449999704883,5.66336971728956,5.211927518322693,410103.4527363184,2,9,0,7,0,0,0,1.0,0,0,0,-1,-1,0,0
709,5.588668120027792,5.6936649583806895,5.2078827980792886,5.006242102444774,5.406684033798449,5.843353060760883,5.2773920688966305,313328.06565656565,4,E01000724,9,0,7,3,2,1,5.7299756337614625,5.441127568483353,5.380041714392457,4.923758272446838,5.453595531921761,5.947182090843425,5.406089229326622,402307.60784313723,7,8,1,4,6,4,2,1.0,3,-1,1,-3,3,2,1
710,5.541063321465477,5.560507665980946,5.341489196461152,5.0019350453494065,5.417933562222649,5.849282649749103,5.21135297051088,315326.1604278075,4,E01000725,9,1,7,3,2,0,5.454633504479796,5.40447210086571,5.384732372158176,5.0119968095978535,5.314875987204877,5.942906902386592,5.42846189553921,404768.31868131866,3,8,1,6,3,4,2,1.0,-1,-1,0,-1,0,2,2
711,5.39366179785213,5.598041231567795,5.287895536100542,5.053586582074294,5.346158414273648,5.861680114591444,5.303295257929209,314504.9256756757,2,E01000726,9,0,7,2,2,1,5.446222213250172,5.490267958067641,5.361251118062418,5.045947616613364,5.280526772330079,5.867039318326153,5.39268347205995,403802.40506329114,3,9,1,6,2,3,2,1.0,1,0,1,-1,0,1,1
712,5.520588031107065,5.520133085153541,5.4293376640397675,4.9324762135135884,5.429990722695176,5.935885515991522,5.4901182578534495,316001.44897959183,3,E01000727,8,2,5,3,3,4,5.450018732423285,5.361073155000986,5.462767793471555,4.991060368507263,5.324761590325688,5.956052720786099,5.496167242766385,405589.1767068273,3,7,2,5,3,4,3,1.0,0,-1,0,0,0,1,-1
713,5.479635070253919,5.746112054878181,4.880947512346548,5.150980512301127,5.186467165713544,5.59616319783084,5.038166795577203,312517.8041958042,3,E01000728,9,0,9,0,0,0,5.686289284046639,5.5578730674017045,5.097548099038024,5.024920891037145,5.2575749662351905,5.754159189405895,5.241324617502358,401420.32505175984,6,9,0,6,2,1,0,1.0,3,0,0,-3,2,1,0
714,5.387780101210983,5.610444630369728,5.236432600168534,4.990033154134397,5.401489641931322,5.884195261531406,5.228637659991229,309632.537037037,2,E01000729,9,0,6,3,3,0,5.5700637870524305,5.439950742635382,5.377244495483766,5.032367090862918,5.380903728036995,5.890562074012067,5.395490671496794,397552.5722891566,5,8,1,6,5,3,2,1.0,3,-1,1,0,2,0,2
715,5.284374234249007,5.682632806166163,5.228644451442754,5.073868786388973,5.255813909026812,5.805922962584585,5.229219758847974,310577.8490566038,1,E01000730,9,0,8,0,2,1,5.350339125010593,5.506395320261806,5.38717683977332,5.080947772530485,5.284665236295748,5.842595595958804,5.31927900274923,398787.326446281,2,9,1,7,2,2,1,1.0,1,0,1,-1,2,0,0
716,5.573254040045332,5.577653760133788,5.380110221315724,4.896545037742733,5.416663683662119,5.975301156672397,5.434939761494482,311172.1395348837,4,E01000731,9,1,5,3,4,3,5.6199465418249615,5.4597971284292575,5.454507752162654,4.9408500882668225,5.412460862136468,6.02313119221509,5.540404254828042,399576.4552845528,6,8,2,4,5,6,4,1.0,2,-1,1,-1,2,2,1
717,5.810366973071031,5.4974664270598,5.54186509584597,4.820354100124377,5.565997332474436,6.137951136754712,5.626515047650941,314603.74178403756,7,E01000732,8,3,3,7,7,6,5.790622211419619,5.348432336289149,5.53963026862878,4.874070082146388,5.528294543807323,6.16003522506127,5.875665822854409,403916.17307692306,7,7,3,3,8,8,9,1.0,0,-1,0,0,1,1,3
718,5.724062476216293,5.592086917985745,5.350024095880307,4.818183375567925,5.494801182572434,5.985501183726924,5.4357578289218065,313798.674796748,6,E01000733,9,1,3,5,4,3,5.695369433062945,5.464246767435887,5.37001267329667,4.898057783758918,5.418480893900228,6.011572053266126,5.640476576579633,402952.82945736434,6,9,1,3,6,5,6,1.0,0,0,0,0,1,1,3
719,5.696970266355595,5.600425151871963,5.49366635839704,4.920283678551795,5.53957207857723,6.099583805446893,5.686417449528063,315145.74647887325,5,E01000734,9,3,5,6,6,7,5.5942662494523185,5.396217896257128,5.546169129439763,4.864940236295973,5.453633683068412,6.175027419839586,5.882640088456018,404481.60714285716,5,8,3,3,6,8,9,1.0,0,-1,0,-2,0,2,2
720,5.486074932263448,5.720300961457766,5.111857306957245,5.166178877995565,5.322009261296346,5.755300171558673,5.156393079574292,308947.6384615385,3,E01000735,9,0,9,1,1,0,5.525894255711766,5.5922275546895035,5.230928876685359,5.1156922615633045,5.270293019453071,5.868737240555664,5.3858175397379515,396708.2471042471,4,9,0,7,2,3,1,1.0,1,0,0,-2,1,2,1
721,5.734162753176801,5.484879633630386,5.463056584479103,4.837460615825205,5.5558806484294045,6.034196677901935,5.526466174864433,309488.7840375587,6,E01000736,8,2,4,6,5,5,5.9063363815370895,5.350635143817883,5.529005385123158,4.805495667796564,5.646176095257438,6.167646334634573,5.595695621594434,397384.6255924171,8,7,3,1,9,8,5,1.0,2,-1,1,-3,3,3,0
722,5.7738945911945905,5.570465927489066,5.355089801920658,4.877384287318544,5.480291294138968,6.059338518306969,5.369013517096852,309869.9090909091,6,E01000737,9,1,4,5,6,2,5.853092133998871,5.42451217855726,5.438096991039457,4.813332459472474,5.573123188245864,6.106302190962292,5.531056926931654,397888.7571428571,8,8,2,2,9,7,4,1.0,2,-1,1,-2,4,1,2
723,5.615102338029983,5.5216063117304595,5.365397459226297,5.005610719640204,5.444896651497969,5.896381451728496,5.208798108794165,309807.109929078,4,E01000738,8,1,7,4,3,0,5.635663242766651,5.412251073712358,5.4536289106161835,5.008608778825583,5.442459146435649,5.976206707878235,5.354876597468465,397813.3642172524,6,8,2,5,6,5,1,1.0,2,0,1,-2,2,2,1
724,5.467854555863053,5.533848901293171,5.30248602468576,5.079085140975554,5.369317750432598,5.877437394056747,5.26041590633677,310087.3805970149,3,E01000739,9,0,8,2,2,1,5.597767539760646,5.4601320396451385,5.514231350492029,4.987355643335511,5.451099141555674,5.983170539140701,5.447827146333807,398168.9338235294,5,8,3,5,6,5,2,1.0,2,-1,3,-3,4,3,1
725,5.657002773441252,5.362557574048068,5.450376274155789,4.921088380891769,5.446989408607691,5.845047853032097,5.440359370304587,275399.0928961749,5,E01000740,6,2,5,4,2,3,5.821803410541137,5.3372122827183786,5.434123462691731,4.869223875428719,5.4748349258798426,5.931288112544645,5.505173200345868,348610.12355212355,8,7,2,3,7,4,3,1.0,3,1,0,-2,3,2,0
726,5.913487511589413,5.166805210567656,5.732209584826514,4.819704576901027,5.553970468611944,6.041475182487851,5.592428836368379,273478.17142857146,8,E01000741,3,6,3,6,5,6,5.909423377202905,5.065263810365097,5.797259475873864,4.719789796290191,5.530439657750337,6.175224260661913,5.739517298988674,352520.51304347825,8,2,8,0,8,8,7,1.0,0,-1,2,-3,2,3,1
727,6.046361639219172,5.119828579180381,5.730739751282861,4.729042373159352,5.699771464747541,6.0795283072135025,5.701124573455138,260848.72794117648,9,E01000742,2,6,2,9,6,7,5.860305995880803,5.148709219467791,5.774392668204971,4.767106966881812,5.5408600810207895,6.021478319469886,5.661759872225266,335685.39873417723,8,4,7,1,8,6,6,1.0,-1,2,1,-1,-1,0,-1
728,5.506711797636063,5.212911507145304,5.5379170921982315,5.012818214346151,5.418377281212416,5.899629844993841,5.466240000529368,305502.11475409835,3,E01000743,4,3,7,3,3,4,5.424470969859292,5.209617889979306,5.561707854270935,5.055876250652706,5.3287557188202355,5.859815618571113,5.463873091865988,392307.69852941175,3,5,4,6,3,2,3,1.0,0,1,1,-1,0,-1,-1
729,5.651144785827466,5.322756183281373,5.594018245011233,4.821863556176089,5.610929589593009,6.017374378911565,5.462925414021096,308070.3595505618,5,E01000744,6,4,3,8,5,3,5.611189978278202,5.271844171959421,5.63641851881276,4.9398384975350424,5.443568414967993,6.050392503323763,5.573276460170746,395702.5869565217,5,6,5,4,6,6,5,1.0,0,0,1,1,-2,1,2
730,6.053734936737662,5.179099356012391,5.650263738162412,4.654334193380008,5.669717230820304,6.059886338088313,5.687390067307232,264465.4482758621,9,E01000745,3,5,1,8,6,7,5.98159927960886,5.19917545375596,5.671606475138569,4.757881105658543,5.526771219128157,6.123632340792166,5.7729858611209455,339121.2111553785,9,4,6,1,8,7,8,1.0,0,1,1,0,0,1,1
731,5.930787156811721,5.087937256415113,5.810555241948409,4.645139134187493,5.62912373062518,6.16335701084823,5.692469385030458,298987.4964028777,8,E01000746,2,7,0,8,7,7,5.906928792493097,4.9702647546242025,5.889793642636003,4.71023450144406,5.574324897239948,6.159195837481269,5.7564283946464805,382790.88275862066,8,1,8,0,9,8,8,1.0,0,-1,1,0,1,1,1
732,6.033680117925008,5.600246556335025,4.848243427144157,4.833447228272756,5.373047268920475,5.594571725924809,5.088919410440657,437460.83777777775,8,E01000747,9,0,4,2,0,0,6.071891530209388,5.5942788927367735,4.895282259541769,4.846418848463742,5.256693841181735,5.644321511071516,5.1773492412238635,555518.5597416577,9,9,0,2,2,0,0,1.0,1,0,0,-2,0,0,0
733,6.138508958884055,5.584418529259094,4.885421282974983,4.784637647256872,5.404598386329243,5.6213213498815735,5.163460649955766,733095.5424836602,9,E01000748,9,0,3,3,0,0,6.078395029504178,5.501573752697712,4.98645797261994,4.795008224963043,5.286281280253889,5.624354202214474,5.208407053337669,931049.3076036866,9,9,0,1,2,0,0,1.0,0,0,0,-2,-1,0,0
734,6.078222425112467,5.663791630939095,4.827121553164043,4.845620574351556,5.280665519565879,5.605178920094838,5.039117234053012,380284.0383233533,9,E01000749,9,0,4,1,0,0,6.0632499652269605,5.584867672576408,4.928807364287952,4.879269998969761,5.198826236645944,5.643934213946052,5.161992819878508,468113.75413711584,9,9,0,3,1,0,0,1.0,0,0,0,-1,0,0,0
735,5.471316331624985,5.569887000322342,5.2266396775841715,5.066669883579015,5.348973046988249,5.860166788101196,5.2046750947833065,340274.28125,3,E01000750,9,0,8,2,2,0,5.770855089573011,5.419775033650333,5.390980455973377,4.769597382578131,5.46848202976462,6.0119776284857975,5.555408117705828,436560.11643835617,7,8,1,1,7,5,4,1.0,4,-1,1,-7,5,3,4
736,5.784047346383753,5.564385517214386,5.23709682242971,4.9257845798008875,5.3959776764184655,5.877857954401366,5.256095179033951,344743.4253521127,6,E01000751,9,0,5,3,2,1,5.833888057239202,5.436584170679657,5.362946773366052,4.856279074841616,5.387538660545738,5.933129832452657,5.441214331254667,442682.63265306124,8,8,1,2,5,4,2,1.0,2,-1,1,-3,2,2,1
737,5.844978592383168,5.5280038367503535,5.168527141134575,4.872849874080173,5.493101582009956,5.872726389339992,5.340937089037012,347955.05555555556,7,E01000752,8,0,4,5,2,2,5.979281616152358,5.390624335122635,5.319446675900452,4.738763338517791,5.522389264013023,6.004228770000636,5.592205865377291,445969.82063882065,9,8,0,0,8,5,5,1.0,2,0,0,-4,3,3,3
738,5.8077188599400404,5.5716569358255805,5.373031233142062,4.849018827080727,5.5805930687886915,6.083888511832168,5.470848043153926,334176.1981707317,7,E01000753,9,1,4,7,6,4,5.850578513714152,5.399751037268099,5.518363097392091,4.774817099629557,5.601508549594004,6.169725718483647,5.620963405031676,428811.1100917431,8,8,3,1,9,8,5,1.0,1,-1,2,-3,2,2,1
739,5.603021075851039,5.596273870321742,5.417432897969296,4.9891298193680615,5.501462279181731,5.992337944214804,5.414470248577888,324763.2850877193,4,E01000754,9,2,6,5,4,3,5.578162807867346,5.474802820806009,5.458246255300909,5.050305241607575,5.430165918699774,6.002454542068846,5.412266376483963,417276.07569721114,5,9,2,6,6,5,2,1.0,1,0,0,0,1,1,-1
740,5.664052285141682,5.595613032729182,5.407271522972452,4.897882036228276,5.508225916618079,6.018112095157106,5.372002931695488,325484.17587939696,5,E01000755,9,1,5,5,5,2,5.681365005671978,5.3601137803246575,5.566308981428544,4.922772952045004,5.53752407990396,6.065012683471044,5.574318197866281,418447.2864583333,6,7,4,4,8,6,5,1.0,1,-2,3,-1,3,1,3
741,5.7384485155989085,5.552749554316203,5.450307654095934,4.905571711011779,5.565141870345904,5.961777131794851,5.404995252559711,336927.34632034635,6,E01000756,9,2,5,7,4,2,5.735653102397919,5.388146274891056,5.618447551961805,4.854513572864845,5.50333826903437,6.05294007062912,5.594581959677524,432733.54098360654,7,8,5,2,8,6,5,1.0,1,-1,3,-3,1,2,3
742,5.723754063036769,5.591522695893925,5.461040100215171,4.899018743591851,5.539269009472634,6.06292836587011,5.587759641674458,336650.09952606633,6,E01000757,9,2,5,6,6,6,5.78369871737822,5.329826641757533,5.624977335614978,4.756132630244741,5.560731818653503,6.222972404282048,5.8659589076941865,432178.8962264151,7,7,5,1,8,9,9,1.0,1,-2,3,-4,2,3,3
743,5.769498489937693,5.460887867887065,5.420991424682005,4.818288609104337,5.53895355114397,6.018350946453382,5.567832890546547,336671.6037735849,6,E01000758,8,2,3,6,5,5,6.0562736251137474,5.220449085127224,5.66615055474368,4.643233734369278,5.6909590916200115,6.251836744221774,5.858561722798781,432275.11818181816,9,5,6,0,9,9,9,1.0,3,-3,4,-3,3,4,4
744,6.107093148854933,5.618640770971143,4.924438416326004,4.824824627001799,5.428535122332219,5.722216713554867,5.134917284911597,342045.1731448763,9,E01000759,9,0,3,3,1,0,6.128510248071794,5.594116047761286,5.01695560683769,4.869210832925804,5.314728103663079,5.808718461500828,5.255477963744914,438907.14448669204,9,9,0,3,3,2,0,1.0,0,0,0,0,0,1,0
745,5.8051012726456905,5.342548301522161,5.495601540999793,4.832544097318336,5.530930431236124,6.089429854227344,5.6554867723178415,341081.2910798122,7,E01000760,6,3,4,6,6,7,5.73189005754652,5.409385774470023,5.390363282207989,4.962302505700297,5.4003868313396675,6.006525248963369,5.568932616872486,437682.6153846154,7,8,1,4,5,5,4,1.0,0,2,-2,0,-1,-1,-3
746,6.048542708158493,5.371345762908459,5.389746415615082,4.740741197764874,5.606505085031191,6.077060900131861,5.638649966319402,341320.9666666667,9,E01000761,6,1,2,7,6,6,5.991624511681594,5.313678424079697,5.445276950860952,4.7867585487696,5.505731547033632,6.127395226325824,5.724696744055975,437953.91774891777,9,6,2,1,8,7,7,1.0,0,0,1,-1,1,1,1
747,5.709325135281656,5.53536096821844,5.467222565043289,4.839352638320586,5.561925478741131,6.059935105585419,5.486948618846657,333148.592920354,6,E01000762,9,2,4,7,6,4,5.605163685346054,5.501405727055113,5.481315439030276,4.942630835003772,5.402020383184239,6.0282667501498075,5.448538305395741,427877.6991525424,5,9,2,4,5,6,2,1.0,-1,0,0,0,-2,0,-2
748,5.888448607074759,5.204115423999849,5.653283915233091,4.681034375409611,5.6434568472898725,6.237427694549978,5.792012763805077,333601.737704918,7,E01000763,4,5,1,8,8,8,5.619408423301733,5.377200288230209,5.403467424672927,4.991704578648246,5.336246244715288,6.064590587435175,5.663836455458148,428399.91469194315,6,7,1,5,3,6,6,1.0,-1,3,-4,4,-5,-2,-2
749,5.901243460178375,5.366032516956329,5.598988314185823,4.73849778005055,5.633873876503536,6.180562398263386,5.732746660283634,333208.16071428574,8,E01000764,6,4,2,8,7,8,5.625313810240675,5.429112123095105,5.490383547523417,4.929106638625317,5.369833724658818,6.075136767680569,5.683478754316539,427706.8339222615,6,8,2,4,4,7,7,1.0,-2,2,-2,2,-4,0,-1
750,6.029599597977429,5.337366523975279,5.334705756641016,4.704008005595789,5.560399852438671,5.897853840269693,5.520605136708515,336453.96585365856,8,E01000765,6,1,1,6,3,4,5.959734751180161,5.373283791264822,5.350604397474333,4.823380010349806,5.444461129709731,5.890451893695565,5.491417915599291,431705.83953488374,9,7,1,2,6,3,3,1.0,1,1,0,1,0,0,-1
751,5.99854739432065,5.24625830043037,5.67901215013468,4.760396584587277,5.685491440431127,6.292875956814244,5.806380855024986,328015.391509434,8,E01000766,4,6,2,9,9,8,5.763906991546922,5.252815363185653,5.591380370770647,4.946606899871201,5.4284911494437464,6.168681265877896,5.7763998716906775,421429.2131147541,7,5,4,4,6,8,8,1.0,-1,1,-2,2,-3,-1,0
752,5.960183306627496,5.169190456146418,5.686811117793239,4.691327090596044,5.658119224393091,6.299756936139839,5.857348549643228,334065.91162790696,8,E01000767,3,6,1,8,9,9,5.651623936457055,5.309518611319711,5.464602110541869,4.93742265712435,5.3896570450791685,6.146735645900263,5.879446898665384,428982.7757009346,6,6,2,4,5,8,9,1.0,-2,3,-4,3,-3,-1,0
753,5.963043369319104,5.3635935001243835,5.49183087543125,4.801435889701498,5.56838726457967,6.124263290905844,5.7395297542416674,334521.2262443439,8,E01000768,6,3,3,7,7,8,5.919262848203144,5.27489650911755,5.538274941936372,4.798136192654806,5.524799391390785,6.062863822967287,5.670612320067391,430010.0634920635,8,6,3,1,8,6,6,1.0,0,0,0,-2,1,-1,-2
754,6.052231397858278,5.055661241638469,5.730478743818354,4.5490352629340265,5.797366328417936,6.305811925367876,5.80568321758413,325489.2299465241,9,E01000769,2,6,0,9,9,8,5.8763641925419074,5.128432829239789,5.693058763532077,4.773652628590079,5.499600680435405,6.168073042701272,5.756336306123172,418026.6,8,3,6,1,7,8,8,1.0,-1,1,0,1,-2,-1,0
755,6.128796420599285,5.220303629051175,5.598017498066551,4.659604818151708,5.6873502490813275,6.1765078442138535,5.714571401215436,320901.149122807,9,E01000770,4,4,1,9,7,7,6.058712080365321,5.208183838695776,5.599712092856892,4.697650821971112,5.543625917591032,6.141306250798897,5.80462060111468,411933.4016393443,9,5,4,0,8,8,8,1.0,0,1,0,-1,-1,1,1
756,5.908164532475881,5.109570932604069,5.761389769040621,4.685688038217536,5.641385237555698,6.356759295744054,5.918954368090738,324848.17194570135,8,E01000771,2,7,1,8,9,9,5.908204002113178,5.008737681754704,5.730147994797806,4.719826604271757,5.501031611500116,6.203376273656714,5.900814346198378,417503.4094827586,8,2,7,0,7,8,9,1.0,0,0,0,-1,-1,-1,0
757,6.074354090423228,5.340742053829621,5.593002889757958,4.700247601370945,5.681708539757773,6.163630169128703,5.757076841648494,323182.82710280374,9,E01000772,6,4,1,9,7,8,5.904306509183801,5.335853910446167,5.5611233913380165,4.819441835258318,5.4922318608864495,6.082286471905916,5.753788138990817,414377.41739130433,8,7,4,2,7,7,8,1.0,-1,1,0,1,-2,0,0
758,6.0304075620942195,5.023144169379089,5.835409260402291,4.630697932788881,5.730397871995376,6.443006665019666,6.028459661592872,325075.26271186443,8,E01000773,1,8,0,9,9,9,6.036669258445386,5.070311301923627,5.847892223637997,4.656718512299438,5.621703481121873,6.36482108145607,6.033206585751537,417362.9768339768,9,2,8,0,9,9,9,1.0,1,1,0,0,0,0,0
759,5.80245607350705,5.124631280024376,5.701438329628939,4.810038896707388,5.593388092588391,6.190490319178655,5.749720557906924,326145.3846153846,7,E01000774,2,6,3,7,8,8,5.671441069380804,5.09814737398516,5.696805749427188,4.9031233062798325,5.468796455047348,6.141297463666309,5.812676011161371,418854.8806818182,6,3,6,3,7,8,8,1.0,-1,1,0,0,0,0,0
760,5.828086354658993,5.392446617197885,5.376191063074288,4.833839898592575,5.510991016148471,5.957113981246948,5.511668591247256,324822.91189427313,7,E01000775,7,1,4,5,4,4,5.797678854002621,5.3204216590294475,5.445748728273553,4.842040192513239,5.4328550812088965,5.970350036254296,5.500926689350561,416870.304029304,8,7,2,2,6,5,3,1.0,1,0,1,-2,1,1,-1
761,5.724173656872341,5.016036520004272,5.7460945647103445,4.825764816147941,5.581183812277658,6.1963226631709505,5.850072986739022,325318.52571428573,6,E01000777,1,7,3,7,8,9,5.682502547063326,4.9744802368314645,5.8279806187278345,4.874049494141026,5.491695322488484,6.227630928943031,5.881166097364928,417687.9684210526,6,1,8,3,7,9,9,1.0,0,0,1,0,0,1,0
762,5.647589426536064,5.151497921386323,5.591077549116952,4.833194961795559,5.446041766699258,6.099969732296931,5.692032129733594,326489.83116883115,5,E01000778,3,4,4,4,6,7,5.428574985632017,5.138924228412479,5.614037481100199,4.9049653287706425,5.329104945646318,6.112071443536428,5.754888942787767,419294.48044692737,3,3,5,3,3,7,8,1.0,-2,0,1,-1,-1,1,1
763,5.876503570047439,5.305689356445726,5.4829764252874105,4.7407637440780706,5.540299919935373,5.969641756687769,5.55279748580035,306558.407239819,7,E01000779,5,3,2,6,4,5,5.82197881430045,5.317126105114875,5.460049063766596,4.917129858243511,5.445887581598713,5.9877849077356275,5.6296563363166605,389396.7816091954,8,6,2,4,6,5,6,1.0,1,1,-1,2,0,1,1
764,5.606085291990997,5.292991100473607,5.454891368852439,4.927424070682932,5.533413408495855,6.081232710087553,5.634855060712666,356217.6737588653,4,E01000780,5,2,5,6,6,6,5.624831189582874,5.2406604468048394,5.541548815640536,4.913571007065959,5.473889950033906,6.086180730299517,5.684485140558961,456201.6103896104,6,5,3,3,7,7,7,1.0,2,0,1,-2,1,1,1
765,5.59203152371268,5.375313210691142,5.53329684999254,4.907137264553298,5.47037632852538,6.086556622105786,5.5637322256707735,356641.19658119656,4,E01000781,6,3,5,4,6,5,5.6422935098898215,5.337615493868218,5.610625538669649,4.917846130543068,5.469642418329833,6.021795237650637,5.62826415945272,456695.4918032787,6,7,5,4,7,6,6,1.0,2,1,2,-1,3,0,1
766,5.5682507480605175,5.377242327746698,5.462128873598778,4.948817144005986,5.471046944796028,5.98227273407629,5.443582943940567,317824.8220338983,4,E01000782,6,2,6,4,4,3,5.687667408927542,5.296610526374129,5.541757866984508,4.9232879945489225,5.56011535105158,5.953313333089234,5.406563111016007,407459.9016393443,6,6,3,4,8,4,2,1.0,2,0,1,-2,4,0,-1
767,5.716486185789108,5.407205042166588,5.494704429919903,4.789599119088589,5.544305594303669,6.0684095193178225,5.500710021990996,357181.03846153844,6,E01000783,7,3,3,6,6,4,5.804821690608716,5.330557444314847,5.5678833901197065,4.855614126413718,5.586326286710542,6.083574279971506,5.565742211095218,457315.3103448276,8,7,4,2,9,7,4,1.0,2,0,1,-1,3,1,0
768,5.789827941120535,5.313249251980713,5.585806749869084,4.774131962354632,5.644691244415615,6.233174897622371,5.730147905971693,356474.9130434783,6,E01000784,5,4,2,8,8,8,5.7490231796547215,5.242662684122721,5.700600362707068,4.80882877862012,5.62691267684654,6.174106661478678,5.642066228831256,456690.55555555556,7,5,6,2,9,8,6,1.0,1,0,2,0,1,0,-2
769,5.588787277539571,5.357771029548039,5.477045573885479,4.955001372193533,5.482505576951163,6.031620583836994,5.467500926010192,357515.94444444444,4,E01000785,6,2,6,5,5,4,5.607413508238331,5.3240368923833294,5.566060933374589,4.988684659042666,5.514771291325169,6.039815083626778,5.58812330807409,457701.3306451613,5,7,4,5,8,6,5,1.0,1,1,2,-1,3,1,1
770,5.768594890150405,5.597211522910431,5.302539955568678,4.854363080199438,5.528742867571707,5.945303815011759,5.4063328358963245,346503.1603053435,6,E01000786,9,0,4,6,4,3,5.73780647662648,5.52023988606637,5.32150567832746,4.923483350402431,5.465117331136737,5.947510741886339,5.51585674202233,444459.249122807,7,9,0,4,7,4,4,1.0,1,0,0,0,1,0,1
771,5.622830113197895,5.599876658713564,5.397030928033463,4.9385973982354425,5.58373653127792,6.0104482858739,5.364349034872461,316341.0478723404,5,E01000787,9,1,6,7,5,2,5.6846762731592495,5.414540309123892,5.4442192284518445,4.932100728706077,5.449563505788329,6.051834954155816,5.669529258258759,406402.0317460318,6,8,2,4,6,6,6,1.0,1,-1,1,-2,-1,1,4
772,5.7462128268347845,5.447288714809182,5.496017359902338,4.8356812863683505,5.531707604235582,6.029412673824608,5.577398976180779,321502.9670781893,6,E01000788,8,3,4,6,5,5,5.68043404729278,5.293985674557862,5.540331630353575,4.939289065202077,5.420192286703322,6.047989834679497,5.726684552210348,412818.337037037,6,6,3,4,6,6,7,1.0,0,-2,0,0,0,1,2
773,5.205821601171342,5.637969941373855,5.212529566552904,5.272336063876985,5.277355417372688,5.6034830297742575,5.046633183956146,348138.1349206349,0,E01000789,9,0,9,1,0,0,5.166313894793519,5.471948270104889,5.3510410520765515,5.1529726472675295,5.2722212677327995,5.70759261571444,5.24547976306361,446541.52991452994,0,9,1,8,2,0,0,1.0,0,0,1,-1,1,0,0
774,5.642509437707754,5.3297012919646045,5.527706774931688,4.896936774253845,5.569104416186993,5.9302228590158315,5.491347531538743,330547.0123076923,5,E01000790,6,3,5,7,3,4,5.57427655907696,5.257482901525073,5.566242437334372,4.933874445074744,5.412685377661481,5.974287330219937,5.583085035004319,424328.590504451,5,5,4,4,5,5,5,1.0,0,-1,1,-1,-2,2,1
775,5.650642691514431,5.517615915567447,5.467146120315943,4.819980953901242,5.53513053380526,6.072402218060616,5.494150492472526,321643.4,5,E01000791,8,2,3,6,6,4,5.62709195505489,5.468391212550077,5.421265280607975,4.948317565701225,5.397019698162271,6.023634899746288,5.593463631591412,412244.2272727273,6,9,1,4,5,6,5,1.0,1,1,-1,1,-1,0,1
776,5.412984249698129,5.7047515393822055,5.2976333920363405,5.0467642689966095,5.461173860890091,5.917789135768914,5.320355878514089,343844.4458598726,2,E01000792,9,0,7,4,3,1,5.444420250753562,5.579690976275338,5.416289582848549,5.035761829051706,5.343368098139763,5.940285038616922,5.361833185785347,439686.86805555556,3,9,1,6,4,4,1,1.0,1,0,1,-1,0,1,0
777,5.929862525841709,5.466455361362179,5.575919558561923,4.798104138333398,5.647861898201218,6.184234145373234,5.610332796502011,337009.42060085834,8,E01000793,8,4,3,8,8,6,5.951652763351317,5.350601192443602,5.61115363047969,4.757707870294971,5.572688547834273,6.205293505422531,5.808538466691971,432671.93548387097,9,7,5,1,9,8,8,1.0,1,-1,1,-2,1,0,2
778,5.991450184671749,5.330932000000488,5.608644544784658,4.702655198538832,5.680285909492981,6.289011189503036,5.665537937521347,338437.9162561576,8,E01000794,6,5,1,9,9,7,5.863222351141065,5.345763425960719,5.611592585795393,4.775645854874192,5.615534336210411,6.201746981834697,5.813951542444318,434307.0654205608,8,7,5,1,9,8,8,1.0,0,1,0,0,0,-1,1
779,5.749874815606234,5.472978536148517,5.517683628009774,4.827039024983233,5.50878527847647,6.194376820012143,5.685540123989708,339422.9941520468,6,E01000795,8,3,3,5,8,7,5.6370021391913525,5.38331005772995,5.545246966846326,4.878341684166673,5.469715950376701,6.127781303765262,5.816617737889914,435519.3717277487,6,8,3,3,7,7,8,1.0,0,0,0,0,2,-1,1
780,5.282464511770951,5.48821338854338,5.389551870446456,5.128375062189604,5.28366843775699,5.8265072797474105,5.380542806575173,298604.3052631579,1,E01000796,8,1,8,1,2,2,5.232648243186294,5.440547313741458,5.4813144155727915,5.223066408147094,5.35175883769989,5.845534938637928,5.436691366216188,382607.59139784944,1,8,2,9,4,2,2,1.0,0,0,1,1,3,0,0
781,5.989019044178469,5.220073647536193,5.587769411881146,4.7096046046988045,5.666365618835627,6.123465832105406,5.6585670389553915,292426.9338521401,8,E01000797,4,4,1,8,7,7,5.846645859952243,5.207345992214275,5.546669918636106,4.865116237694362,5.5087773395034505,6.055353981144023,5.655828153862143,375575.1849056604,8,5,3,3,8,6,6,1.0,0,1,-1,2,0,-1,-1
782,5.326735301962438,5.363210277737312,5.598425516542399,5.01560998412798,5.32686536716965,5.853932088276125,5.40765739499398,300056.42452830187,1,E01000798,6,4,7,1,2,3,5.353485391095832,5.32179100535534,5.669554034868876,5.054362116036592,5.263135347101423,5.931351908931026,5.553812714638533,387088.5925925926,2,7,6,6,2,4,4,1.0,1,1,2,-1,1,2,1
783,5.41768411647028,5.065493242064519,5.7784615434817415,4.916359553586191,5.4030924217024845,6.054428762464381,5.384640914290698,286159.1417910448,2,E01000799,2,7,5,3,5,2,5.463615898019778,5.112447053749369,5.678668242804012,4.905464161256826,5.306704125789381,6.019580367929446,5.484377176124857,366476.24844720494,4,3,6,3,3,6,3,1.0,2,1,-1,-2,0,1,1
784,5.528828834615102,5.3722226932281405,5.475050936384899,4.954224656267864,5.419793357209461,5.88080567266883,5.3801062848509815,296218.7012195122,3,E01000800,6,2,6,3,3,2,5.429736335387175,5.254441864189061,5.488681238958205,5.086607765877384,5.388154830055675,5.859809578150168,5.3884168938658705,383585.0229885057,3,5,2,7,5,2,1,1.0,0,-1,0,1,2,-1,-1
785,5.596539516243146,5.289301821653791,5.543323353897754,4.888729878466764,5.4860427696927845,6.052141741882983,5.54028788230402,306161.56115107914,4,E01000801,5,3,5,5,5,5,5.355216925794428,5.3033809361757935,5.5035554145599574,5.034412348187053,5.304675904187289,5.95925656898872,5.666278145530007,393025.4125874126,2,6,3,6,3,4,6,1.0,-2,1,0,1,-2,-1,1
786,5.767744034023608,5.131640591863858,5.798934651633441,4.779786651417361,5.534387012659493,6.143750837293722,5.549258512965704,259370.49152542374,6,E01000802,2,7,2,6,7,5,5.651955646228015,5.091363691702122,5.769440342740315,4.833705341912867,5.436172487289925,6.073083014992195,5.5499399755059216,333949.3658536585,6,3,7,2,6,7,4,1.0,0,1,0,0,0,0,-1
787,6.161614146439925,5.069809682472893,5.944271257649297,4.60082762863325,5.677032392957936,6.317727136611938,5.724078445849211,259179.35652173913,9,E01000803,2,9,0,9,9,8,6.004057088784412,5.037449793478029,5.9072760122012244,4.708122976058353,5.5278096199035645,6.289812442475715,5.87165099329653,333737.18584070797,9,2,9,0,8,9,9,1.0,0,0,0,0,-1,0,1
788,5.756482653501557,5.328515000459625,5.599538312888727,4.844214479516192,5.569749417537596,6.023779785342333,5.547982849725863,261260.54146341464,6,E01000804,6,4,4,7,5,5,5.521393925503448,5.314598208776227,5.500142757539396,5.046026017930773,5.386773982533702,5.9430280338834836,5.5394055429432125,337056.2037037037,4,6,3,6,5,4,4,1.0,-2,0,-1,2,-2,-1,-1
789,5.602304423922923,5.207485001478622,5.620526251508228,4.779372755271285,5.403044328760745,6.001211442164521,5.415467686617553,259045.8208955224,4,E01000805,4,5,2,3,5,3,5.447784813550802,5.231687255089099,5.618674672566927,4.980947299187,5.328723613115457,5.950985063039339,5.475969854684976,333574.44615384616,3,5,5,5,3,4,3,1.0,-1,1,0,3,0,-1,0
790,5.689719618513034,5.109883427619934,5.725981668784068,4.796511120521105,5.490010144618841,5.974639615187278,5.59428648192149,259880.75,5,E01000806,2,6,3,5,4,6,5.51371628504533,5.127602360569513,5.716216616905653,5.005960787718113,5.352735697076871,5.936801011745747,5.517080477797068,335189.6538461539,4,3,7,5,4,4,4,1.0,-1,1,1,2,-1,0,-2
791,5.831240117835086,5.2887807177584705,5.688116242440693,4.741864825549879,5.570350027540654,6.199804331126966,5.678101735822322,312846.23923444975,7,E01000807,5,6,2,7,8,7,5.955117870434164,5.176795482635498,5.816551577281482,4.825058166616656,5.605827939921412,6.219084528279422,5.845654563950788,401844.3645320197,9,4,8,2,9,9,9,1.0,2,-1,2,0,2,1,2
792,6.015870276487099,5.49271059542332,5.484323861464015,4.796573324023552,5.634255296779129,6.147969195302927,5.716224672659388,316199.0188679245,8,E01000808,8,3,3,8,7,7,5.86509309796726,5.340020989670473,5.584987709335253,4.865415583054225,5.614675677290149,6.222223582221012,5.852086087652281,405922.3725490196,8,7,4,3,9,9,9,1.0,0,-1,1,0,1,2,2
793,5.548898418744405,5.550311736141642,5.425790699819724,4.965664601574342,5.477429900318384,5.999314020077388,5.40343374448518,315101.5416666667,4,E01000809,9,2,6,4,5,2,5.6597054518186125,5.376797160124167,5.55012339200729,4.939809362093608,5.500522719896757,6.050988509716132,5.568492257289398,404440.58974358975,6,7,4,4,7,6,4,1.0,2,-2,2,-2,3,1,2
794,5.9746768824183025,5.393497981704199,5.561537677278886,4.838236498144957,5.612923366519121,6.220740462724979,5.797563925385475,314659.4903846154,8,E01000810,7,4,4,8,8,8,6.006744979643354,5.3040133142003825,5.755502419728859,4.731726412679635,5.681855554674186,6.335716277945275,5.976176724714391,403921.76470588235,9,6,7,0,9,9,9,1.0,1,-1,3,-4,1,1,1
795,5.729366820671655,5.403763004121064,5.6107844631106865,4.786561912194842,5.603077967042868,6.213754022741593,5.716202406524923,315166.65895953757,6,E01000811,7,5,3,7,8,7,5.847270944730831,5.285834490927191,5.79453118902738,4.788769269901547,5.659774093028626,6.305458221279207,5.81236618529252,404550.0218579235,8,6,8,1,9,9,8,1.0,2,-1,3,-2,2,1,1
796,5.935107609028873,5.434454666296013,5.500971007724053,4.757718700194076,5.64426147843538,6.002063247997299,5.541940661758302,316779.30830039526,8,E01000812,7,3,2,8,5,5,5.8114655220283655,5.314958724885616,5.583595743719137,4.845994550327085,5.51948308719779,6.073491232350188,5.687056213954709,406514.94716981135,8,6,4,2,8,7,7,1.0,0,-1,1,0,0,2,2
797,5.580723505978491,5.609136271710489,5.499147072726605,4.986313203386232,5.477983247415692,6.011794384788065,5.480299076028898,316183.26960784313,4,E01000813,9,3,6,4,5,4,5.660870947188615,5.389270948692107,5.5313625240549795,4.920888797777919,5.55518776038443,6.089972750121999,5.590000776058072,405784.47417840373,6,8,3,4,8,7,5,1.0,2,-1,0,-2,4,2,1
798,6.0678807099660235,5.421646436571558,5.597660663324001,4.60799092699439,5.77695445993762,6.2697613972090025,5.798171857218722,319645.6883116883,9,E01000814,7,4,0,9,8,8,5.967378083981719,5.36126703432962,5.654497762521108,4.707514336296156,5.60193241110035,6.295261937029221,5.948087466698067,409408.92647058825,9,7,5,0,9,9,9,1.0,0,0,1,0,0,1,1
799,6.17747682929039,5.387260522246361,5.715545971393585,4.63955853998661,5.678734172582626,6.351097121238708,5.938833627104759,313186.065,9,E01000815,7,6,0,9,9,9,6.208331857326526,5.121851358436732,5.875744861105214,4.706007060797318,5.7378757460681715,6.443824397193061,6.0966866603796035,402054.3623188406,9,3,8,0,9,9,9,1.0,0,-4,2,0,0,0,0
800,5.608957524679921,5.391862284917773,5.56478472136281,4.919274819409189,5.489973833224525,6.156087269812274,5.653469315335794,264803.49693251535,4,E01000816,7,4,5,5,7,7,5.472447409843787,5.356424573140266,5.570132254025875,5.07081445134603,5.40846417653255,6.070392020237752,5.613584925731023,341101.42307692306,4,7,4,7,5,7,5,1.0,0,0,0,2,0,0,-2
801,5.878038446316545,5.236769075168989,5.579383934355531,4.813125986703404,5.5538712278086475,6.1785656981443235,5.761075101597771,261629.9267015707,7,E01000818,4,4,3,6,7,8,5.854336893435606,5.1642525515605495,5.715992643661106,4.860002064827791,5.5450434955125,6.1590250017716714,5.748653043791191,337465.55154639174,8,4,7,2,8,8,8,1.0,1,0,3,-1,2,1,0
802,5.4880766132801915,5.376213043500361,5.401947936943273,4.972400254039673,5.385608334290354,5.938490912104338,5.4953971741872545,258604.27751196173,3,E01000819,6,1,6,2,4,4,5.438606805092579,5.3167596894341544,5.413641497895524,5.032489937704963,5.3572695437852325,5.923788474486755,5.518469320224212,332946.2252252252,3,6,1,6,4,4,4,1.0,0,0,0,0,2,0,0
803,5.751744551584125,5.352242827415466,5.593425365785758,4.8341270095358295,5.560563003644347,6.103686599681775,5.664698806280891,264581.40625,6,E01000820,6,4,4,6,6,7,5.8574665258912475,5.254176409805522,5.585013888630212,4.793101832562802,5.5287888231230715,6.110196089043336,5.713983336500093,339978.112745098,8,5,4,1,8,7,7,1.0,2,-1,0,-3,2,1,0
804,5.823998728767037,5.161765302531421,5.663296286016703,4.801845551468432,5.515304797329009,6.250462541356683,5.597312838770449,266920.4921875,7,E01000822,3,5,3,5,8,6,5.681929650130095,5.146913315631725,5.690713338498716,4.792188332698963,5.444507294230991,6.1407297929128015,5.640642538777104,344516.63703703706,6,4,6,1,6,8,6,1.0,-1,1,1,-2,1,0,0
805,5.846980554527707,5.1821893354256945,5.702867991394466,4.735294596354167,5.52559131052759,6.152017041047414,5.654538688394759,280983.39444444445,7,E01000823,3,6,2,6,7,7,5.716117882600394,5.148361491900618,5.657329671485449,4.887658464652236,5.440433994416268,6.082212817284368,5.65889282700836,362436.70967741933,7,4,6,3,6,7,6,1.0,0,1,0,1,0,0,-1
806,5.655900136868756,5.245291755611735,5.717032151114672,4.783615686839685,5.5288093143836,6.166054526666053,5.494179771358805,297762.962406015,5,E01000824,4,6,3,6,7,4,5.596803010834588,5.148786374374672,5.64677867712798,4.931589727048521,5.407051388422648,6.119590776937979,5.658359828701726,380352.6962962963,5,4,5,4,5,7,6,1.0,0,0,-1,1,-1,0,2
807,5.729312004361834,5.2675736120768955,5.630542475836617,4.842361015081406,5.485644764559609,6.094670753819602,5.562378251552582,306320.92142857146,6,E01000825,5,5,4,5,6,5,5.701885656593672,5.194276459076825,5.699856871872946,4.83378600295073,5.4507812464159295,6.1026664746353045,5.728635969504811,393999.29411764705,7,4,6,2,6,7,7,1.0,1,-1,1,-2,1,1,2
808,6.02151250078323,5.3973607636512595,5.608700776607432,4.826862477241678,5.678125533144525,6.138056151410367,5.731193005785029,322943.21276595746,8,E01000826,7,5,3,9,7,8,5.840886024718589,5.308213165465822,5.566893542066533,4.893300998464544,5.464279136251896,6.177022488573765,5.894867318741818,414504.6127659574,8,6,4,3,7,8,9,1.0,0,-1,-1,0,-2,1,1
809,6.040781825658225,5.315635632585596,5.585588580786936,4.642570924366453,5.7101459110715265,6.138333663037775,5.697151135515283,327149.83950617287,9,E01000827,5,4,0,9,7,7,5.9390701986156875,5.289923515018478,5.602440506995389,4.69864191264468,5.562338500661035,6.149279186716753,5.707384377164026,419909.73605947953,9,6,4,0,8,8,7,1.0,0,1,0,0,-1,1,0
810,6.117594736995119,5.270323579359537,5.71408617376077,4.603183871567851,5.7924446915135235,6.207504456693476,5.80525654975814,321891.0303030303,9,E01000828,5,6,0,9,8,8,6.047910709887887,5.26213618753037,5.634759770499335,4.7484057179971595,5.5671191843235555,6.152747424904275,5.8204669221011915,413193.4541062802,9,6,5,1,9,8,8,1.0,0,1,-1,1,0,0,0
811,6.015698316693306,5.2464452788233755,5.776233050227165,4.679650025814771,5.655708993971348,6.360936667025089,5.788441154360771,331574.6,8,E01000829,4,7,1,8,9,8,5.781340843540127,5.157020481292811,5.699647512813073,4.872678846962708,5.451236543682335,6.124772624107404,5.638327887502768,425743.0508474576,7,4,6,3,6,7,6,1.0,-1,0,-1,2,-2,-2,-2
812,6.218039745754666,5.307809666224888,5.641806735311236,4.691544385940309,5.7799099748096765,6.2468779397389245,5.846535473778134,323227.9142857143,9,E01000830,5,5,1,9,8,9,6.067035074051196,5.289985954571075,5.5110047891878855,4.806169226908455,5.514093750201094,6.202599091270861,5.915773683081801,414879.60383386584,9,6,3,1,8,8,9,1.0,0,1,-2,0,-1,0,0
813,6.128533133515367,5.252161234348744,5.637707882099323,4.669488758654208,5.717928854194847,6.202502581450316,5.785530929629867,324030.8918918919,9,E01000831,4,5,1,9,8,8,5.940781911564294,5.327894299040807,5.594280942421127,4.763079042476704,5.577279625485122,6.128142986003523,5.8121650339748365,416590.5242290749,9,7,4,1,9,7,8,1.0,0,3,-1,0,0,-1,0
814,6.003884684814597,5.326458318728321,5.510705122857724,4.689411557845349,5.661360725366844,6.079102230971714,5.664593943559899,323115.92075471696,8,E01000832,6,3,1,8,6,7,5.964799282015586,5.219698928326976,5.568024933094881,4.775649611317381,5.523827806784182,6.10374520068266,5.673490500936703,414737.89795918367,9,5,4,1,8,7,6,1.0,1,-1,1,0,0,1,-1
815,6.002632029354572,5.328594166785479,5.707956767082214,4.679308318346739,5.691690637171268,6.23724556863308,5.743249706923962,323206.5125,8,E01000833,6,6,1,9,8,8,5.973403101725294,5.233597832010282,5.746780316561263,4.7418622970581055,5.605166370505529,6.274733852866469,5.946507286551772,414608.3509933775,9,5,7,1,9,9,9,1.0,1,-1,1,0,0,1,1
816,5.959249174183813,5.156185641782037,5.7967405269885885,4.649434685707092,5.668184898639548,6.280931522106302,5.853465279217424,325776.2068965517,8,E01000834,3,7,0,8,9,9,5.815648773900506,5.042659467580367,5.83083143201815,4.789510813700098,5.532330877926885,6.264537194959161,5.912408912262949,418964.8163265306,8,2,8,1,8,9,9,1.0,0,-1,1,1,0,0,0
817,5.560461882518546,5.233089455040046,5.626661379241088,4.862747155497427,5.450756155321951,6.026167525304272,5.572440593231954,324962.264573991,4,E01000835,4,5,4,4,5,5,5.4681702163712735,5.140685889227637,5.6196151021225695,4.977710721307788,5.375159174203873,5.981766723353287,5.576715034143678,416706.6422413793,4,3,5,5,4,5,5,1.0,0,-1,0,1,0,0,0
818,5.954179186751877,5.206512386384218,5.7997511918993965,4.63212110598882,5.635870907617652,6.336103912712871,5.789458714533543,322234.3985507246,8,E01000836,4,7,0,8,9,8,5.7314542876076455,5.052421609150994,5.821319142567742,4.850379154854214,5.478869470124392,6.182168872086043,5.844240505670764,413644.75257731957,7,2,8,2,7,8,9,1.0,-1,-2,1,2,-1,-1,1
819,5.790744144648792,5.288789336056633,5.555956584247038,4.85510330212945,5.53244770784429,6.120202985039369,5.710144804123251,325705.66310160427,7,E01000837,5,4,4,6,7,7,5.604744256509317,5.3638176054567905,5.500481733115944,4.981061150576617,5.339917512842127,6.031808627618326,5.7509385753322295,417919.32972972974,5,7,3,5,3,6,8,1.0,-2,2,-1,1,-3,-1,1
820,5.891600495576858,5.370633307912133,5.458201853795485,4.846150953661311,5.570843467387286,6.0549379858103665,5.800259682265195,331746.3181818182,7,E01000838,6,2,4,7,6,8,5.650064187091694,5.205473243144521,5.506103106758051,4.951650738193278,5.408320178065384,5.999407665771351,5.611631667927692,426322.4561403509,6,4,3,4,5,5,5,1.0,-1,-2,1,0,-2,-1,-3
821,5.996922402600058,5.224521863694284,5.656412197873483,4.585982717719733,5.6629267829695555,6.252272836523118,5.971006899098166,337719.4183006536,8,E01000839,4,5,0,8,8,9,5.65934770528962,5.016556900374743,5.626440114715472,4.949227292521471,5.447478494676603,6.062036799735764,5.912391579881007,433542.387755102,6,2,5,4,6,6,9,1.0,-2,-2,0,4,-2,-2,0
822,6.0148946909470995,5.438787668835033,5.342999068606984,4.816481208801269,5.538790437524969,6.034908735101873,5.661928798502141,340672.19636363635,8,E01000840,7,1,3,6,5,7,5.915333903591398,5.366375527331527,5.362114571349721,4.942352609315389,5.438388566316013,5.957638638959804,5.688465956231238,437086.95070422534,8,7,1,4,6,4,7,1.0,0,0,0,1,0,-1,0
823,5.766915182879918,5.326226077746096,5.685551149876357,4.760704483527804,5.540274538848077,6.162464587448986,5.75551618811345,335545.06113537116,6,E01000841,6,6,2,6,7,8,5.666177095788898,5.195214625044819,5.611649239734137,4.92904206581446,5.412593547399942,6.130206129767678,5.80913790892729,430629.06926406926,6,4,5,4,5,7,8,1.0,0,-2,-1,2,-1,0,0
824,6.023536366851706,4.896482403341093,6.110483448756368,4.628641553615269,5.676421425844493,6.35122077088607,5.873807155772259,583721.3157894737,8,E01000842,0,9,0,9,9,9,5.926748367456289,4.838047646559202,6.032812665670346,4.715650284901644,5.529899322069609,6.225743596370403,5.86806185123248,743283.8461538461,9,0,9,0,8,9,9,1.0,1,0,0,0,-1,0,0
825,6.099686079337949,4.8310555669127915,6.137746760102569,4.670325988628825,5.640874952566429,6.22327468043468,5.85249216439294,583855.7213114754,9,E01000843,0,9,1,8,8,9,5.997040564673288,4.714920607634953,6.017473534175328,4.610746157169342,5.675264358520508,6.248653905732291,5.746386447974614,743366.9428571429,9,0,9,0,9,9,8,1.0,0,0,0,-1,1,1,-1
826,6.178007675806682,4.874664340019226,6.140663563410441,4.575325619379679,5.6305502478281655,6.253116842905681,5.953012239138285,584037.9733333334,9,E01000844,0,9,0,8,8,9,6.192523985295682,4.815844497165164,6.17947751122552,4.684704875623858,5.557251740146327,6.3346504359631925,5.943210402050534,743670.6486486486,9,0,9,0,8,9,9,1.0,0,0,0,0,0,1,0
827,5.864652465848089,4.95431598529075,5.947521371748841,4.675105387724719,5.619014552496012,6.095013295562522,5.765130426119832,584180.5242718447,7,E01000845,1,9,1,8,6,8,5.823449968134315,4.915247565334283,5.931292633408481,4.795824400429587,5.528683676303012,6.105897803908413,5.7575810082907815,743860.0679611651,8,1,9,1,8,7,8,1.0,1,0,0,0,0,1,0
828,5.800358109176159,5.274168074131012,5.641769148409367,4.798247288912535,5.474480152130127,5.875118885189295,5.508580090478063,584434.109375,7,E01000846,5,5,3,4,2,4,5.715430561985288,5.326574219124658,5.709403361592974,4.940904251166752,5.32321452668735,5.938501477241516,5.640078659568514,744086.2321428572,7,7,6,4,3,4,6,1.0,0,2,1,1,-1,2,2
829,5.878745302077262,5.086846823333412,5.873226304208079,4.730285089503052,5.596910148538569,6.10979204280402,5.650967126251549,584569.0,7,E01000847,2,8,2,7,7,7,5.827573561668396,4.930060595936245,6.05929577615526,4.764869615766737,5.463743829727173,6.177902269363403,5.83317625787523,743953.7333333333,8,1,9,1,7,8,8,1.0,1,-1,1,-1,0,1,1
830,6.085662923139684,4.869952614167158,6.041088325837079,4.51282713693731,5.663348419526044,6.261398890439202,5.844208261545966,583437.7647058824,9,E01000848,0,9,0,8,8,9,6.02513868085454,4.771659474694327,6.055216679412328,4.657805833923683,5.573829808931672,6.233324243781272,5.822231476226549,742945.4382022471,9,0,9,0,9,9,8,1.0,0,0,0,0,1,1,-1
831,6.207682192325592,4.782766914367675,6.27946658929189,4.520456043879191,5.765363705158234,6.49122238556544,6.131167618433635,583260.3833333333,9,E01000849,0,9,0,9,9,9,5.921760779438597,4.8604557261322485,6.093305688915831,4.67798919208122,5.534214167883902,6.25181647864255,5.890967773668693,742714.4242424242,8,0,9,0,8,9,9,1.0,-1,0,0,0,-1,0,0
832,5.559299314441393,4.693887770475454,5.984904669038015,4.771856505068103,5.605439025553028,5.900169069443516,5.610880850547522,196649.37688442212,4,E01000850,0,9,2,7,3,6,5.616151147970447,4.729353350069788,5.9352080711612,4.791857710591069,5.626302243382843,5.803518030930449,5.696261584206864,266186.9212962963,5,0,9,1,9,1,7,1.0,1,0,0,-1,2,-2,1
833,5.250059800586481,4.83593292482968,5.80803613621613,4.913848807756928,5.555258080877107,5.728270178553702,5.453634678632364,124344.41379310345,1,E01000851,0,7,5,6,1,3,5.231715819518555,4.796740180753135,5.77013421822064,4.988754850303011,5.46114798132422,5.642896327479132,5.507269651431756,157108.66009852217,1,0,7,5,7,0,3,1.0,0,0,0,0,1,-1,0
834,5.644950407166635,4.908293675991796,5.802652385927016,4.818208715608043,5.555460845270464,5.847547061981693,5.697155316991191,123617.00806451614,5,E01000852,0,7,3,6,2,7,5.627758532544992,4.906597813550573,5.907473390119789,4.884138351809369,5.435440993657077,5.889671055939946,5.869101064048544,156135.38686131386,6,1,9,3,6,3,9,1.0,1,1,2,0,0,1,2
835,5.2874336535813375,4.862637990810832,5.778523562384433,4.863746246353525,5.546148417425937,5.794170500802212,5.444847540777237,118991.29508196721,1,E01000853,0,7,4,6,1,3,5.475873598976741,4.7525282379180664,6.0121644716414195,4.762432544950455,5.60768004826137,5.845280234775846,5.678300649400741,150899.68253968254,4,0,9,1,9,2,6,1.0,3,0,2,-3,3,1,3
836,5.212758801837656,4.859621796378478,5.7862782720576,5.078543270335478,5.482879078324466,5.71747104624376,5.512719114196492,124107.44385026737,0,E01000854,0,7,8,5,1,4,5.242447877568858,4.914461830364806,5.732782672558512,5.097092451261623,5.356808179723365,5.672955331525633,5.490788039884397,156821.41964285713,1,1,7,7,4,0,3,1.0,1,1,0,-1,-1,-1,-1
837,5.57255572860251,4.79426746730563,5.902865979238904,4.855095958910914,5.586625138415566,5.844237151528209,5.669633352303807,254339.01687763713,4,E01000855,0,8,4,7,2,7,5.584086607675999,4.777316657360643,5.893923842348158,4.848104975186288,5.508205252699554,5.79218093957752,5.706885516177863,319129.84765625,5,0,8,2,8,1,7,1.0,1,0,0,-2,1,-1,0
838,5.272940293947856,5.103682143347604,5.678201180412656,5.003272763888041,5.373229765892029,5.687125398999169,5.322033157802763,156819.80952380953,1,E01000856,2,6,7,2,0,1,5.188897618302354,5.155823752686784,5.593215702890276,5.040052846745327,5.299733950211121,5.680199404020567,5.392887146623285,201480.45045045044,0,4,4,6,3,0,2,1.0,-1,2,-2,-1,1,0,1
839,5.899955113728841,5.029264717771296,5.938907510355899,4.757090474429884,5.588264235279016,6.058382544601173,5.690649208269622,584648.4561403509,8,E01000857,1,9,2,7,6,7,5.7158891043420565,5.035369602300353,5.885036407890967,4.775039329367169,5.426330570447242,5.996747388678082,5.678131845037816,744405.4915254237,7,2,8,1,6,5,6,1.0,-1,1,-1,-1,-1,-1,-1
840,5.1663561850994615,5.223007809865725,5.512983938197156,5.171551965333365,5.28837330524738,5.620431339824116,5.241694591262124,569371.5944055944,0,E01000858,4,3,9,1,0,1,5.163017593957241,5.138998423526489,5.514865415548187,5.2020953441757,5.2014340653139,5.6711181752821975,5.3061817346834665,722635.4444444445,0,3,3,9,1,0,1,1.0,0,-1,0,0,0,0,0
841,5.5445920751335915,4.830344301930974,6.043225274996811,4.7248420487628895,5.493820913722006,6.006617872902517,5.651671416304085,582691.9662921348,4,E01000859,0,9,1,5,5,7,5.535604583054054,4.943853170406528,5.920006132707363,4.791923839871476,5.4166610270011715,5.917765124541957,5.70166024347631,744267.012195122,4,1,9,1,5,3,7,1.0,0,1,0,0,0,-2,0
842,5.906036165853341,5.1886536578337354,5.70791848252217,4.780402620633443,5.528443850576878,6.030990103880565,5.699121868858735,541907.5625,8,E01000860,3,6,2,6,5,7,5.779454910591857,5.116030467699652,5.668916708802524,4.963842063733976,5.443148157367967,6.019548024216744,5.627066747782981,677369.0,7,3,6,5,6,6,6,1.0,-1,0,0,3,0,1,-1
843,5.388883507770041,5.099705298309741,5.815379267153532,4.886298798996469,5.491477626821269,5.795515389546104,5.3687702106392905,122115.15217391304,2,E01000861,2,7,5,5,1,2,5.387974029299857,4.943602230357028,5.72950365762601,4.905379396745528,5.340161822308069,5.721848594731298,5.558149614553342,154327.36781609195,3,1,7,3,3,1,4,1.0,1,-1,0,-2,-2,0,2
844,5.817065002488309,5.0116823511045485,5.81487750811655,4.777717083203988,5.563882591294461,5.995772789736263,5.74350665729554,537879.4508196721,7,E01000862,1,7,2,7,4,8,5.707624703896146,5.104741353948577,5.787119546858203,4.927202871867588,5.4107275790527085,5.9008625715720555,5.664753171576171,681114.1764705882,7,3,8,4,5,3,6,1.0,0,2,1,2,-2,-1,-2
845,5.212104729376733,4.832517231814563,5.901159722357988,5.0116528905928135,5.391229256987572,5.639854034408927,5.3628557892516255,266891.4609375,0,E01000863,0,8,7,3,0,2,5.295476174354553,4.6912650241851805,5.893518045425415,4.993014313697815,5.368065051078796,5.71242778968811,5.449527305603027,314450.112,1,0,8,5,4,0,2,1.0,1,0,0,-2,1,0,0
846,5.723329044523693,5.037555028521825,5.964244834960453,4.855954611112201,5.539137809995621,6.019993963695708,5.622740526047964,121118.95238095238,6,E01000864,1,9,4,6,5,6,5.513310806075139,4.982190441729418,5.870100508874922,4.8343543881800635,5.359238133501651,5.967423645418082,5.676277596559098,152688.85074626867,4,1,8,2,4,4,6,1.0,-2,0,-1,-2,-2,-1,0
847,5.807776744876589,5.125495382717678,5.686594098806381,4.817636131175926,5.535721410598073,5.884083496672766,5.42259345310075,121427.91071428571,7,E01000865,2,6,3,6,3,3,5.62615330939023,5.0707638443640946,5.552194379410654,5.005095849621971,5.44231125656164,5.804743239339793,5.487868157197845,153499.14150943398,6,2,4,5,6,1,3,1.0,-1,0,-2,2,0,-2,0
848,5.7507884171273975,4.939508847774021,5.908467107348972,4.762981390196179,5.628654031526475,6.012611290765187,5.598009491723682,121629.03968253969,6,E01000866,0,8,2,8,5,6,5.691073275566101,4.93147283744812,5.837683763504028,4.82266326713562,5.558523469924927,6.006198989868164,5.691949502944946,153716.704,6,1,8,2,8,5,7,1.0,0,1,0,0,0,0,1
849,5.409689926332043,5.0565150219907045,5.709515481866816,5.065527686508753,5.493825720202539,5.791074809207712,5.335104723130503,121776.72043010753,2,E01000867,2,6,8,5,1,2,5.3594071959504985,4.971431883254854,5.716710959330643,5.0125043545619095,5.442245606148597,5.704135021360794,5.431614496920369,153904.86138613863,2,1,7,6,6,0,2,1.0,0,-1,1,-2,1,-1,0
850,5.665908847536359,5.37295397122701,5.6674328190939764,5.100762094770159,5.466076714651925,5.892334075201125,5.274258693059285,121696.0,5,E01000868,6,5,8,4,3,1,5.317591018676758,5.020724849700928,5.656297206878662,4.998979268074035,5.2990269947052,5.740331583023071,5.358836226463318,153821.68,2,2,5,5,3,1,1,1.0,-3,-4,0,-3,-1,-2,0
851,5.8035578284381835,5.07803965698589,5.955898637613974,4.8382933632401395,5.508846166705297,6.081002370385099,5.662848370134338,122277.09917355372,7,E01000869,2,9,4,5,6,7,5.8076203021136195,4.890066999738867,6.000599124214866,4.7998233383352105,5.456137017770247,6.130179292505438,5.766876557740298,154444.5909090909,8,0,9,1,6,7,8,1.0,1,-2,0,-3,1,1,1
852,5.836387609442075,5.078846680621306,5.988976649940014,4.737402273962895,5.669269502162933,6.105216341714065,5.597033421198527,123668.72916666667,7,E01000870,2,9,2,8,6,6,5.7228678540066555,5.018165236120826,5.968962935714035,4.841292199787793,5.511827857644708,6.050842482764442,5.6344582733807265,156444.42342342343,7,2,9,2,8,6,6,1.0,0,0,0,0,0,0,0
853,6.078318532199075,5.058084062517506,5.889985399703457,4.661949401848937,5.665006784543599,6.280383348464966,5.770583641039182,479717.3630136986,9,E01000871,2,8,1,8,9,8,6.017640873497608,5.100657465411167,5.752990091548247,4.783120481406941,5.559018581521277,6.225694532487907,5.720782462872711,611384.2009803922,9,3,7,1,8,9,7,1.0,0,1,-1,0,0,0,-1
854,6.089885239462251,4.845182658399193,6.0715138310367625,4.6222444286624205,5.773158163700289,6.304470900193001,5.754581107676608,483674.71844660194,9,E01000872,0,9,0,9,9,8,6.013073762257894,4.844999468687809,5.965774593931256,4.712944628012301,5.628189477053556,6.1727826691637135,5.841278314590454,618461.4343434343,9,0,9,0,9,8,9,1.0,0,0,0,0,0,-1,1
855,6.131608856534495,4.983517313466488,6.024986653652006,4.689726358478509,5.674115646232679,6.34341624871041,5.743531206279125,485225.6116504854,9,E01000873,1,9,1,9,9,8,5.915828429162502,4.9489153164128465,5.942507557570934,4.678968696544568,5.548651513954003,6.2475737283627195,5.813498927901189,621392.9895833334,8,1,9,0,8,9,8,1.0,-1,0,0,-1,-1,0,0
856,6.130150152790931,4.765435353402169,6.179538203823951,4.5715465910973085,5.717553542506311,6.385832117449853,5.974045488142198,497066.46774193546,9,E01000874,0,9,0,9,9,9,6.0585759860366135,4.79376509118436,6.151891338291453,4.598773616463391,5.67871877684522,6.271865778894567,5.967728867459653,621849.6417910447,9,0,9,0,9,9,9,1.0,0,0,0,0,0,0,0
857,5.9567373852980765,5.021368881275779,5.904259656604967,4.678099141622845,5.662519246653507,6.187831047961587,5.863241407745763,486870.5894736842,8,E01000875,1,8,1,8,8,9,5.769452349639233,5.10627642089938,5.81269954899211,4.869624995890959,5.466344594955444,6.126492620986185,5.785845924306799,622784.4197530864,7,3,8,3,7,7,8,1.0,-1,2,0,2,-1,-1,-1
858,5.822320654517726,5.124828620960838,5.823802330619411,4.741499430254886,5.561313157332571,6.073141110570807,5.590561665986714,486963.65263157897,7,E01000876,2,8,2,6,6,6,5.5094639802280865,5.1323905941806265,5.601208864888059,4.952625475352323,5.2876507919045945,5.863004713118831,5.486914527567127,622836.0632911392,4,3,4,4,2,2,3,1.0,-3,1,-4,2,-4,-4,-3
859,5.914656452558659,4.890585622301808,6.073327607578701,4.6424224487057435,5.634425754900332,6.332467759097064,5.8198555343680916,479327.44444444444,8,E01000877,0,9,0,8,9,9,5.921622555906122,4.819371862844988,6.071925963055004,4.727887513420798,5.504344927180897,6.247357199408791,5.8918583544817835,614056.6545454545,8,0,9,0,8,9,9,1.0,0,0,0,0,0,0,0
860,6.365294973958623,4.854855590245941,6.093900639902461,4.4805460423231125,5.828960632736033,6.421797015450218,6.084236678752032,488332.9090909091,9,E01000878,0,9,0,9,9,9,6.162616442989659,4.96517171408679,6.0054012247034025,4.586337313458726,5.554469873776307,6.342680512247859,5.9888171859689665,606437.8513513514,9,1,9,0,8,9,9,1.0,0,1,0,0,-1,0,0
861,6.260196017403888,4.786527911822001,6.076319509082371,4.491200020170619,5.8107494615082045,6.233387590473534,5.935583772822323,538048.5384615385,9,E01000879,0,9,0,9,8,9,6.065706042960139,4.809179376847673,6.012177467346191,4.593566658473251,5.656783172399691,6.134213405080361,5.845332646133876,665908.0198019802,9,0,9,0,9,8,9,1.0,0,0,0,0,0,0,0
862,6.381164164482793,4.915545729142201,6.064578026155882,4.419956706747224,5.817745290225065,6.389749593372587,6.110320278360874,550004.4810126582,9,E01000880,0,9,0,9,9,9,6.204976728984287,4.994491515840803,5.86379736491612,4.684017743383135,5.598215505055019,6.315068129130772,5.855513545445033,606721.5714285715,9,1,8,0,9,9,9,1.0,0,1,-1,0,0,0,0
863,6.164057588002768,4.899587763361184,5.97024073370968,4.552565089191299,5.754031422626541,6.126017059188292,5.8969490154679995,584227.8674698796,9,E01000881,0,9,0,9,7,9,6.270436220169067,4.863980131149292,5.928354177474976,4.5914792585372926,5.675202717781067,6.29541316986084,5.778971326351166,743231.56,9,0,9,0,9,9,8,1.0,0,0,0,0,0,2,-1
864,5.861707272110404,5.094446947286417,5.873486065602565,4.731723921639579,5.553454912625826,6.088822545586051,5.635638788506225,583732.956043956,7,E01000882,2,8,2,6,6,6,5.663289947565212,5.024842421675837,5.8238192353137705,4.81876369409783,5.398376945839372,6.0051311919855515,5.536033070364664,743297.1860465116,6,2,8,2,5,5,4,1.0,-1,0,0,0,-1,-1,-2
865,5.841150311231613,4.821470049619674,5.921228597164154,4.707272975444794,5.626098647117614,6.045429594516754,5.790800371170044,584239.28,7,E01000883,0,8,1,8,5,8,5.856023129549894,4.919311347152248,5.940527606732918,4.792569187915686,5.513801765441895,6.049755986531576,5.728219051072092,743664.5696969697,8,1,9,1,8,6,7,1.0,1,1,1,0,0,1,-1
866,6.3971532755677805,4.954633360388894,5.995187066635996,4.427221124277175,5.866710054049702,6.424932572826649,6.106019230008875,473711.8113207547,9,E01000884,1,9,0,9,9,9,6.13482366332525,4.932625078702275,5.9058950611307655,4.640434146681918,5.628781893585302,6.312129118774511,5.997473534903949,606081.6708860759,9,1,9,0,9,9,9,1.0,0,0,0,0,0,0,0
867,6.358136260793323,5.086543317352023,5.731690564325878,4.453507433334987,5.777280322143009,6.094258915810358,5.81213706164133,473004.9285714286,9,E01000885,2,6,0,9,6,8,6.111310143587066,5.173681703427943,5.596383214578396,4.667122311708404,5.57497163167814,6.054506058809234,5.694686144735755,605140.5219512195,9,4,4,0,9,6,7,1.0,0,2,-2,0,0,0,-1
868,6.007367033707468,4.9809992903157285,6.002510331806383,4.652955770492554,5.584824175583689,6.205221477307771,5.725189357054861,467873.7157894737,8,E01000886,1,9,1,7,8,8,5.8213738310203125,4.961189484328367,5.871899468175481,4.757645033718495,5.4101877587564875,6.045289848627669,5.632389055209213,592007.3483146067,8,1,8,1,5,6,6,1.0,0,0,-1,0,-2,-2,-2
869,5.949605857884443,4.783766521347894,6.151099181469576,4.587263219150496,5.636026539920289,6.272405939337648,5.6924721002578735,470344.8024691358,8,E01000887,0,9,0,8,8,7,5.781146081188057,4.7274577346029165,6.089505693580531,4.762185876882529,5.455150945277154,6.168555142004279,5.75096449972708,601744.5316455696,7,0,9,1,6,8,8,1.0,-1,0,0,1,-2,0,1
870,6.131102277386573,4.828754367366914,6.163649187293104,4.491951987307559,5.748470483287688,6.355328398366129,5.901733790674517,516062.7849462366,9,E01000888,0,9,0,9,9,9,5.897292105356852,4.882983206378089,6.119223358896043,4.724620644251505,5.552226199044122,6.205277469423082,5.779105710983276,659387.3444444444,8,0,9,0,8,8,8,1.0,-1,0,0,0,-1,-1,-1
871,5.558727394651483,5.25918530314057,5.521402765203406,4.9860622066038625,5.496073347550851,5.833226239239728,5.356803788079156,546876.5555555555,4,E01000889,4,3,6,5,2,2,5.356879502046303,5.315304795249563,5.490168102452012,5.2082292349612125,5.231664528612231,5.809066827179955,5.266120132852773,713634.344262295,2,6,2,9,1,2,0,1.0,-2,2,-1,3,-4,0,-2
872,5.314406282192952,5.2233645110516935,5.384363767263052,5.126169971517615,5.396010257102348,5.627496236079448,5.0796735093400285,582976.9189189189,1,E01000890,4,1,8,3,0,0,5.06240349787253,5.3203357899630515,5.241149319542779,5.274013581099333,4.943183470655371,5.339142706659105,4.973421979833533,742393.1851851852,0,7,0,9,0,0,0,1.0,-1,3,-1,1,-3,0,0
873,5.581163777245416,5.15035713215669,5.690907263093525,4.90397212240431,5.510459721088409,5.944928606351216,5.526790724860297,582822.0694444445,4,E01000891,3,6,5,5,4,5,5.5231760010790465,5.0154317510661794,5.62693087022696,5.045738163279064,5.234822607752102,5.844559651702197,5.425612403385675,742184.5970149253,4,2,5,6,1,2,2,1.0,0,-1,-1,1,-4,-2,-3
874,5.928696756179516,4.922155412343832,6.022049594383973,4.722882270812988,5.576478983347233,6.182732834265782,5.679017272133094,583121.6826923077,8,E01000892,0,9,1,7,8,7,5.750899172274866,5.053654296375881,5.963022394715068,4.8174406022669,5.426345118852419,6.096646836984937,5.650515736820542,742547.6542056075,7,2,9,2,6,7,6,1.0,-1,2,0,1,-1,-1,-1
875,6.480625956146805,4.917532045532156,6.140288865124738,4.414446262297807,5.859720903414267,6.381175886701654,6.032537301381429,445288.25,9,E01000893,0,9,0,9,9,9,6.187568144263508,5.003818993256471,5.993455783229008,4.522179642570353,5.615238945060801,6.210509725820239,5.769796809303426,569481.1869158879,9,1,9,0,9,8,8,1.0,0,1,0,0,0,-1,-1
876,6.195733014684524,5.029433664614267,5.896302447701893,4.495559849878298,5.814213154089712,6.093663722059152,5.739194185194308,445056.21167883213,9,E01000894,1,8,0,9,6,8,6.0118114277168555,5.04592439421901,5.679164761084097,4.642110219708195,5.529267097402502,5.991677095271923,5.714450195983604,569183.9629629629,9,2,6,0,8,5,7,1.0,0,1,-2,0,-1,-1,-1
877,5.568615429180184,4.847111077652764,5.93547167237272,4.771236240249319,5.533370497300453,5.902178702895174,5.501504164381125,446526.21649484534,4,E01000895,0,9,2,6,3,4,5.671829015305899,4.899131368664862,5.884454359128637,4.798491637683609,5.507960566039224,5.909252791728788,5.549264660159361,569876.0873786408,6,0,8,1,8,3,4,1.0,2,0,-1,-1,2,0,0
878,6.1297297576039105,4.8695193553708265,6.007172842615659,4.606553297681907,5.745469004837508,6.218483870791406,5.838524098248826,451945.43298969074,9,E01000896,0,9,0,9,8,9,5.9932760567341035,4.856116963821707,5.995820742208981,4.6629899474023615,5.5866384436783285,6.164452448631954,5.856659701726969,582372.1650485437,9,0,9,0,9,8,9,1.0,0,0,0,0,0,0,0
879,6.227798274455179,4.992639861944068,6.0044291383437525,4.55067214347024,5.769710682730638,6.249132150912103,5.9431803626868565,571914.4198473282,9,E01000897,1,9,0,9,8,9,5.966197886328766,4.896040518214737,5.941654993140179,4.688478699628858,5.580468370430712,6.135392449904179,5.882283054400181,727966.6521739131,9,0,9,0,9,8,9,1.0,0,-1,0,0,0,0,0
880,5.854251993152331,4.9809761193563356,5.8348559208636015,4.701268094890523,5.5822661597773715,5.976915876820402,5.6678607036482616,582024.0660377359,7,E01000898,1,8,1,7,4,7,5.588893182923861,5.033199530895625,5.704195321163285,4.873307411915788,5.415567129571861,5.871024376878115,5.484938570272143,742817.4485981308,5,2,6,3,5,3,3,1.0,-2,1,-2,2,-2,-1,-4
881,6.160200899839401,5.2865514937374325,5.45434985558192,4.620543644163344,5.68242097000281,5.85672262708346,5.562020576662487,453345.3694444444,9,E01000899,5,2,0,9,2,5,6.050972603601853,5.215772505036465,5.483454460722541,4.745434572854018,5.497427230256463,5.867900197276004,5.471691864093549,580497.5050761421,9,5,2,1,7,3,3,1.0,0,0,0,1,-2,1,-2
882,5.5560520119137236,5.084126048617893,5.81449167198605,4.826281797885895,5.439305061764188,5.942347841792636,5.453103711869981,582893.0444444445,4,E01000900,2,7,3,4,4,3,5.546758600152456,4.995224613409776,5.862290934874461,4.919192699285654,5.338209555699275,5.9259085196715136,5.557239116384433,742263.4134615385,5,1,8,4,3,4,4,1.0,1,-1,1,1,-1,0,1
883,5.3875240160494435,5.183755304132189,5.702241308835088,4.835599636544987,5.411752433192973,5.8211504585888925,5.441959739947806,582662.612244898,2,E01000901,3,6,4,3,2,3,5.352564753205688,5.02859612305959,5.700749072763655,4.980250053935581,5.273550494953438,5.772717637044412,5.403557293944889,741969.7777777778,2,2,6,5,2,1,2,1.0,0,-1,0,1,-1,-1,-1
884,5.967691236353935,5.253590979474656,5.802666653978064,4.763454772056417,5.680641250407442,6.1257443935313125,5.724783308962558,583450.9787234042,8,E01000902,4,7,2,9,7,8,5.82902051832365,5.0415972393491995,5.757831894833108,4.828042665253514,5.476642473884251,6.05247658231984,5.621287042679994,742918.0434782609,8,2,7,2,7,6,5,1.0,0,-2,0,0,-2,-1,-3
885,5.767120509907819,5.143173920935479,5.846764471219934,4.72170490976693,5.527208169301351,5.97850361423216,5.6939963344214615,583004.9565217391,6,E01000903,3,8,1,6,4,7,5.718885460320641,4.960070716984132,5.872439507175894,4.818812056499369,5.417351042523103,5.958652503350201,5.666781883029377,742408.9117647059,7,1,8,2,5,4,6,1.0,1,-2,0,1,-1,0,-1
886,5.516239045541497,5.061505341831642,5.703526270540455,4.926747051975395,5.405409192737145,5.77606430536584,5.357260275490677,582579.8607594937,3,E01000904,2,6,5,3,1,2,5.332171949602309,5.064933135395958,5.662975305602664,5.064495230004901,5.302944766623633,5.757638545263381,5.4271382462410696,741806.869047619,2,2,6,7,3,1,2,1.0,-1,0,0,2,0,0,0
887,5.431416218931025,5.051509924368425,5.881311646374789,4.8502251321619205,5.480063104629517,5.978590336712924,5.581202123381875,583289.1272727273,2,E01000905,1,8,4,5,4,5,5.398214701450232,5.014893398140416,5.7815662766947895,4.954159162261269,5.344806132894574,5.94139268542781,5.702840996511055,742832.6818181818,3,2,7,4,4,4,7,1.0,1,1,-1,0,-1,0,2
888,5.9111011038933485,5.066100279135363,5.757991079773221,4.717287635164602,5.611172320587294,6.065492410744939,5.644123410539968,584155.1517857143,8,E01000906,2,7,1,8,6,6,5.580273998986691,5.037103881529712,5.706134295244829,4.963014140041596,5.455619435791576,5.978637817802779,5.595297228305712,743833.6697247706,5,2,6,5,6,5,5,1.0,-3,0,-1,4,-2,-1,-1
889,5.757219629628318,5.094800792421613,5.648643752506801,4.7594728197370255,5.585424089431763,5.990471952302116,5.359117671421596,170281.05714285714,6,E01000907,2,5,2,7,4,2,5.569628361109141,4.962629820849444,5.692180917069718,4.903668141042864,5.354412713566342,5.837346808330433,5.450742819824734,228918.5810810811,5,1,6,3,4,2,2,1.0,-1,-1,1,1,-3,-2,0
890,6.263936724773673,5.039687164994174,5.7587748211483625,4.543926897437074,5.757067538971125,6.107806724171306,5.842619561871817,385153.81395348837,9,E01000908,1,7,0,9,6,9,6.171119199480329,5.0139880293891546,5.830872928528558,4.7054060935974125,5.604023322604951,6.186981555393764,5.838401535579137,493621.5333333333,9,2,8,0,9,8,9,1.0,0,1,1,0,0,2,0
891,6.224968435490026,5.0288319714301455,5.92823358130666,4.477621501525946,5.745853812293669,6.273063136413034,5.828126526511876,445323.0707964602,9,E01000909,1,9,0,9,8,9,5.985409330513518,4.980991307961738,5.856124611224159,4.648959051754515,5.586157184536174,6.245227890499567,5.792362639459513,569535.9237288135,9,1,8,0,9,9,8,1.0,0,0,-1,0,0,1,-1
892,6.18777558917091,4.923187983603705,6.1188105265299475,4.557528906776792,5.7415070147741405,6.3630747227441695,5.913456724938892,377268.2571428571,9,E01000910,0,9,0,9,9,9,5.97546558840233,4.883130993759423,6.005712837503667,4.72576130586758,5.53993959385052,6.2261223458407216,5.797115883283448,489014.5263157895,9,0,9,0,8,9,8,1.0,0,0,0,0,-1,0,-1
893,6.082914204132266,5.04265903845066,5.962319333378861,4.59197440089249,5.657214600865434,6.224733343938502,5.676878475561375,167132.82926829267,9,E01000911,1,9,0,8,8,7,5.909315272819164,4.8363031162772065,5.958879764689955,4.725324267564818,5.493015666340673,6.188289689463239,5.764854752740194,219080.93023255814,8,0,9,0,7,8,8,1.0,-1,-1,0,0,-1,0,1
894,5.971359992849416,5.0426018494984195,5.783561299587118,4.659195435458217,5.62040304932101,6.028101183217148,5.67459187733716,438566.5689655172,8,E01000912,1,7,1,8,5,7,5.862796364380763,4.935110769822047,5.769922935045683,4.801353319791647,5.484573083657485,5.966385901891268,5.6422621314342205,562721.9076923077,8,1,7,1,7,4,6,1.0,0,0,0,0,-1,-1,-1
895,6.0057459237246675,5.1074862141033694,5.602493678701335,4.6358999712713835,5.6440542689685165,5.933725636580895,5.65565210940509,393172.2068965517,8,E01000913,2,4,0,8,3,7,5.8100716491915145,5.112521294377885,5.593917145819034,4.802801839810497,5.507134421366565,5.832813189164647,5.530623547086176,506210.75849056605,8,3,4,1,8,2,4,1.0,0,1,0,1,0,-1,-3
896,5.575650965928348,4.764624873341667,5.902679955037071,4.766392162331196,5.587881213956029,5.915333919333865,5.699212690479093,211321.23209169053,4,E01000914,0,8,2,7,3,7,5.5519656234599175,4.74828930928352,5.89088245338582,4.852318208902441,5.496507838368416,5.846030102131214,5.761081083340848,253384.59574468085,5,0,8,2,7,2,8,1.0,1,0,0,0,0,-1,1
897,5.345408633603888,4.771185406183792,5.864885479716931,4.824627290337773,5.621380308927116,5.942746518021923,5.6712645352896995,118926.69491525424,1,E01000915,0,8,3,8,4,7,5.437020075875659,4.791452937347945,6.034514536691266,4.738411678824314,5.587246966916461,5.859495054843814,5.728109295978102,150530.3488372093,3,0,9,0,9,2,7,1.0,2,0,1,-3,1,-2,0
898,5.18842564552061,4.7958785072449714,5.832204680288991,4.951600365484914,5.5243380446587835,5.716078370617282,5.41057305489817,2988.025806451613,0,E01000916,0,8,6,6,1,3,5.131440188995628,4.8574632302273155,5.756540701832882,5.016068037859229,5.390212490808132,5.613153576850891,5.472102943547936,4063.8313953488373,0,0,7,6,5,0,3,1.0,0,0,-1,0,-1,-1,0
899,5.587700262069702,4.825129418373108,5.9474889087677,4.805756285190582,5.643982648849487,5.896590094566346,5.712410261631012,2960.16,4,E01000917,0,9,3,8,3,7,5.281329421997071,4.860728452205658,5.74234626531601,5.0475129127502445,5.50366869688034,5.571120057106018,5.458213484287262,3975.72,1,0,7,6,8,0,3,1.0,-3,0,-2,3,0,-3,-4
900,5.429933723211288,4.7303425514698025,5.912330440282822,4.8520353180170055,5.647928541898727,5.855112185478211,5.7668195772171025,506518.645,2,E01000918,0,8,4,8,2,8,5.503197984261946,4.638843348351392,5.952438434687528,4.808860598369078,5.599155247211456,5.79407632946968,5.7111256669868125,650995.3,4,0,9,2,9,1,7,1.0,2,0,1,-2,1,-1,-1
901,5.488084314310032,4.656323671340942,6.017256104427835,4.776892184563305,5.659061049637587,5.864202759836031,5.544433305444925,525096.8858695652,3,E01000919,0,9,2,8,2,5,5.40730378157656,4.681681877570533,5.949212162707333,4.8662416587972865,5.580136347264751,5.737729026678022,5.595709396080232,670294.7089201878,3,0,9,3,9,1,5,1.0,0,0,0,1,1,-1,0
902,5.334068518954438,4.902750695680643,5.757600411192163,4.9597768233968065,5.524881938835243,5.6924898802460016,5.418558986156018,102147.62987012987,1,E01000920,0,7,6,6,0,3,5.3804250941800245,4.892164636898592,5.751026117732759,4.915120441100501,5.427945335476385,5.712485262424271,5.547490113732443,131645.8612716763,2,0,7,4,6,0,4,1.0,1,0,0,-2,0,0,1
903,5.626590802290729,4.88148558139801,5.978698883101205,4.894028859717824,5.544828439427313,5.904928033597002,5.590397293322554,125621.3644859813,5,E01000921,0,9,5,6,3,6,5.583503093038287,4.835240329013152,5.920654076488078,4.896950364112854,5.436655098650636,5.9023629797606905,5.5633037450934655,158686.57142857142,5,0,9,3,6,3,4,1.0,0,0,0,-2,0,0,-2
904,5.3115770688159865,5.218850647802833,5.5369170792668845,5.025672699907701,5.362234324002437,5.708990938371891,5.292669753376528,349245.4892086331,1,E01000922,4,3,7,2,0,1,5.2492466518121175,5.111392159794653,5.515438309011533,5.082806905110677,5.2852934645127885,5.628617364306782,5.256221068921939,470750.503875969,1,3,3,7,2,0,0,1.0,0,-1,0,0,0,0,-1
905,5.681715234925475,5.036399818673918,5.873358964920044,4.849424704720702,5.5774771488165555,6.004020929336548,5.5249258672134784,125622.89873417722,5,E01000923,1,8,4,7,5,4,5.648781398247028,4.93934808106258,5.8464242726906965,4.790114924825471,5.543385472790948,5.9422146369671,5.538996837605005,158692.2988505747,6,1,8,1,8,4,4,1.0,1,0,0,-3,1,-1,0
906,5.967694079592114,4.966615052450271,6.0131834035828,4.5819046923092435,5.6435645918051405,6.153647752035232,5.732303136870975,125229.58333333333,8,E01000924,1,9,0,8,7,8,5.8909146057932,4.821788865641544,6.013341903686523,4.698395962464182,5.59382710958782,6.18089065049824,5.7981876272904245,158258.63157894736,8,0,9,0,9,8,8,1.0,0,-1,0,0,1,1,0
907,5.6361073467829454,5.128916936377957,5.715907815384538,4.935933957361195,5.58268986989374,5.897710578082359,5.541570926365787,125475.64383561644,5,E01000925,2,6,6,7,3,5,5.5945861843270315,5.081122959163827,5.813666948130433,4.852150522487264,5.5016771941117835,5.9712906387490285,5.620466579853649,158503.0,5,2,8,2,7,5,5,1.0,0,0,2,-4,0,2,0
908,5.675800665122707,4.997461454170506,5.8036644197091825,4.826501631155247,5.5534369625696325,6.011918480803327,5.684589019635829,125091.01219512195,5,E01000926,1,7,3,6,5,7,5.549541944265366,4.919530234336853,5.774756264686585,4.82662760257721,5.424111444950103,5.993915143013001,5.72526826262474,158071.99,5,1,7,2,6,5,7,1.0,0,0,0,-1,0,0,0
909,5.612824171513051,4.8824891689661385,5.872127139890516,4.757766366004944,5.517681194855286,5.968508286519094,5.632941759384431,383551.2162162162,4,E01000927,0,8,2,5,4,6,5.450355904024155,4.790226960768465,5.849142434167081,4.851125515875269,5.420952863380557,5.911065768023006,5.633116753374944,472218.39344262297,3,0,8,2,6,3,6,1.0,-1,0,0,0,1,-1,0
910,5.488812164403498,5.0783600229769945,5.717965244315565,4.899386253207922,5.455896085128188,5.803534273058176,5.420836622826755,199092.2578125,3,E01000928,2,6,5,4,1,3,5.4400954432521305,4.974562182494089,5.7491403970312565,4.987618598532169,5.360834981532807,5.781426461875862,5.46827203162173,258464.14184397162,3,1,7,5,4,1,3,1.0,0,-1,1,0,0,0,0
911,5.661100971164988,5.157951899428866,5.7356045744312345,4.874868668727021,5.479462123628872,5.9387461071583765,5.537332490308961,527669.9253731343,5,E01000929,3,6,4,5,4,5,5.63854305779756,5.078965233333075,5.71827256145762,4.818299117372997,5.446928095461717,5.949435878155836,5.552320706310557,673564.5074626865,6,2,7,2,6,4,4,1.0,1,-1,1,-2,1,0,-1
912,5.499056137270397,5.113190287793124,5.723813343931128,4.883145868778229,5.467289365000195,5.887771690333331,5.505441586176555,515168.64814814815,3,E01000930,2,6,5,4,3,4,5.351063563803996,5.03834320395446,5.6278087383459425,5.0522524561763795,5.339596211417647,5.773687612911886,5.484300416363173,657656.4958677687,2,2,5,6,3,1,3,1.0,-1,0,-1,1,-1,-2,-1
913,5.515313151840852,4.879464991738863,5.837959414330598,4.839320765477475,5.551941363610954,5.832803235989865,5.49635727383266,488609.07476635516,3,E01000931,0,8,4,6,2,4,5.511645513422349,4.969919619840734,5.705686616897583,4.957937171879936,5.346035048540901,5.808058306750129,5.298960242551916,624833.305882353,4,1,6,4,4,2,0,1.0,1,1,-2,0,-2,0,-4
914,5.878672491420399,4.78625056960366,5.990389628843828,4.649152466745088,5.665929324699171,6.069532217401447,5.808109512834838,488544.1515151515,7,E01000932,0,9,0,8,6,8,5.8167048499390885,4.758950399385916,6.089003595145973,4.673497364327714,5.5042807137643965,6.0619216931832804,5.777144792917612,624730.2297297297,8,0,9,0,8,6,8,1.0,1,0,0,0,0,0,0
915,5.789513376951217,5.0696037018299105,5.988479323387146,4.7702660918235775,5.555614850521088,6.042922828197479,5.625956342220307,502147.12,6,E01000933,2,9,2,6,5,6,5.655654201140771,4.9519007088063836,5.965739491221669,4.818673570077498,5.4382864616729405,5.997611100857075,5.611223207725273,639847.1813186813,6,1,9,2,6,5,5,1.0,0,-1,0,0,0,0,-1
916,5.404242551326751,5.266875460743904,5.618189099431038,4.971113130450249,5.386707073450088,5.757086326181889,5.294487129151821,544044.675,2,E01000934,5,5,6,2,1,1,5.333141333057035,5.254286822965068,5.6051961037420455,5.140280185207244,5.247850538069202,5.641902858980241,5.330375960565383,692286.5032258064,2,5,5,8,2,0,1,1.0,0,0,0,2,0,-1,0
917,5.828962601148165,5.122437669680669,5.901548761587876,4.747755816349616,5.437432105724628,6.221251625281114,5.550222956217253,527444.9615384615,7,E01000935,2,8,2,4,8,5,5.678690433502197,5.054234533309937,5.812953443527221,5.052970113754273,5.386539297103882,6.0077442455291745,5.884034414291381,673305.08,6,2,8,6,5,5,9,1.0,-1,0,0,4,1,-3,4
918,5.362700986862182,4.9213277562459306,5.713751850128173,4.961331157684326,5.5509183343251545,5.7948580137888595,5.5659612925847375,118310.48,2,E01000936,0,6,6,6,1,5,5.509987030943779,4.9634126196168875,5.707577520853852,4.88635532660027,5.3593269064001845,5.811247407573543,5.675735685923328,149810.2876712329,4,1,6,3,4,2,6,1.0,2,1,0,-3,-2,1,1
919,5.556258125885113,4.909013211727142,5.810647233112438,4.8647749311215165,5.608618832923271,5.892043957839141,5.647609752577704,118460.71621621621,4,E01000937,0,7,4,7,3,7,5.74663579600981,4.931571934415006,5.758923179801854,4.812794522307385,5.495820133165381,5.903920655963065,5.699068313357474,149991.3563218391,7,1,7,2,7,3,7,1.0,3,1,0,-2,0,0,0
920,5.104489354200141,5.073318748973136,5.6885334447372795,5.032752531905507,5.409667468348215,5.559062350627988,5.347712444704633,117713.48837209302,0,E01000938,2,6,7,3,0,2,5.295850396156311,4.915053146641429,5.7215451132960435,4.979283828560899,5.408056391448509,5.68145355800303,5.363933938305553,149088.8536585366,1,1,7,5,5,0,1,1.0,1,-1,1,-2,2,0,-1
921,5.446981957554817,4.803482124209404,5.836479020118714,4.7371148526668545,5.508715298771858,5.801006588339805,5.536118134856224,118061.8625,3,E01000939,0,8,2,5,1,5,5.506360435998568,4.842199248652304,5.7793258390119,4.84821242414495,5.490378934849975,5.811538911634876,5.586563802534534,149383.01075268816,4,0,7,2,7,2,5,1.0,1,0,-1,0,2,1,0
922,5.410225371096996,4.99187863380351,5.7267940957495505,4.901092544515082,5.4855794196433205,5.72943979121269,5.364147952262392,118084.51063829787,2,E01000940,1,6,5,5,1,2,5.5146942010947635,4.790371356265886,5.819765248468944,4.785533890128136,5.52230675305639,5.742254891565868,5.754387842757361,149515.98214285713,4,0,8,1,8,1,8,1.0,2,-1,2,-4,3,0,6
923,5.5282091479147635,4.912891872467533,5.835485581428774,4.740390691065019,5.631501566979193,5.84959993439336,5.613983210056059,119633.01612903226,3,E01000941,0,8,2,8,2,6,5.652609613633925,4.765204939150041,5.802188354153787,4.794933346010024,5.497892068278405,5.774208826403464,5.628792555101456,151738.3064516129,6,0,8,1,7,1,6,1.0,3,0,0,-1,-1,-1,0
924,5.346089522043864,4.864608524423657,5.870825319579153,4.893366584272096,5.582935322414745,5.695646788134719,5.588519764669014,123330.84848484848,1,E01000942,0,8,5,7,0,6,5.634465934549059,4.885262516566685,5.92028466973986,4.787071531159537,5.649973239217486,5.764628349031721,5.7570784330368046,155869.67142857143,6,0,9,1,9,1,8,1.0,5,0,1,-4,2,1,2
925,5.594851524222131,4.800262301575904,5.844153787575516,4.769707569888994,5.624217082472408,5.762968750560985,5.57237741058948,123031.1568627451,4,E01000943,0,8,2,8,1,5,5.732870517893041,4.720622430456445,5.853883296885389,4.582640911670441,5.66190095657998,5.9223670858017945,5.8108340730058385,155444.02127659574,7,0,8,0,9,4,8,1.0,3,0,0,-2,1,3,3
926,5.507321189089519,5.212586996031971,5.847765986512347,5.0763319003872756,5.503050379636811,5.915666690686854,5.53247662579141,153119.46341463414,3,E01000944,4,8,8,5,3,5,5.494415513804702,5.040091493090645,5.696892398302673,5.010130583262835,5.404184933568611,5.872513450560023,5.454267669896611,190143.29508196723,4,2,6,6,5,3,2,1.0,1,-2,-2,-2,0,0,-3
927,5.158837150959742,5.1780818399928865,5.623156778585344,5.054768399397532,5.345199505488078,5.556157727468581,5.343103853861491,123511.16666666667,0,E01000945,3,5,7,2,0,2,5.059934997819161,5.191106384569179,5.618117851637751,5.109371137749302,5.212445197209634,5.596319986822826,5.350456116629428,156098.00546448087,0,4,5,7,1,0,1,1.0,0,1,0,0,-1,0,-1
928,5.690515166895401,5.186070268856731,5.625567828975438,4.868189894634744,5.522311956986137,5.897904339619881,5.637396045353102,335761.4492753623,5,E01000946,3,5,4,6,3,6,5.6669448212025655,5.138664953765415,5.585069216906079,4.947837898182491,5.402825856492633,5.896204287097568,5.661431568955618,438461.34523809527,6,3,4,4,5,3,6,1.0,1,0,-1,0,-1,0,0
929,5.359184865410446,4.954287070754572,5.779084094027255,4.913875723561497,5.469373878012312,5.745575945428077,5.4258954710994205,122529.98581560283,2,E01000947,1,7,5,4,1,3,5.344439913244808,4.933676578016842,5.737432589250452,4.983105266094208,5.400499341768377,5.730934911615709,5.47751624584198,154846.7294117647,2,1,7,5,5,1,3,1.0,0,0,0,0,1,0,0
930,5.774284773562328,5.197500696383327,5.639014414994113,4.819589667291527,5.499278317014855,5.976162064506347,5.64978156247771,309541.7530120482,6,E01000948,3,5,3,5,4,7,5.785773307255337,5.233937610217503,5.579154729161944,4.826972209385463,5.378021138054984,5.911257990428379,5.730245528902326,429178.02857142856,7,5,4,2,4,3,7,1.0,1,2,-1,-1,-1,-1,0
931,5.512152644720945,5.219445060599934,5.695796901529485,4.925758291374553,5.360179738564924,5.8593420007012105,5.346540665084666,150426.97727272726,3,E01000949,4,6,5,2,2,2,5.197975556055705,5.141301062371996,5.537510432137383,5.174438280529446,5.317138645384047,5.652262041303847,5.3976142194536,178326.06666666668,1,3,3,8,3,0,2,1.0,-2,-1,-3,3,1,-2,0
932,5.485314658347597,5.288125185256309,5.682608467467288,4.939488317104096,5.384994679308952,5.879371435084241,5.420238071299614,123037.74468085106,3,E01000950,5,6,6,2,2,3,5.200081247394368,5.099114052319931,5.529970831790213,5.186001660460133,5.289403507264994,5.748847751294152,5.343294854891503,155571.01694915254,1,3,3,8,2,1,1,1.0,-2,-2,-3,2,0,-1,-2
933,5.468649478519664,5.1969202523138005,5.7687653233023255,4.841102207408232,5.460480409509995,5.921749044867123,5.490281927819345,123192.88235294117,3,E01000951,3,7,4,4,3,4,5.328253360021682,5.088401569260491,5.761022764538962,4.939898916653225,5.358365221629067,5.802130831612481,5.456275430936662,155716.12698412698,2,3,7,4,4,1,2,1.0,-1,0,0,0,0,-2,-2
934,5.4705407321453094,5.064073148895712,5.734574363512151,4.875622558243134,5.585560346350951,5.779188787235933,5.581209656070261,122682.5,3,E01000952,2,6,4,7,1,5,5.526407726823467,4.855461772174051,5.700192719289701,4.833206825060387,5.404314612689084,5.72371464722777,5.623268793707025,155049.56164383562,4,0,6,2,5,1,6,1.0,1,-2,0,-2,-2,0,1
935,5.104927083128664,5.4940889834268996,5.238439371052398,5.278316342667358,5.134859987045532,5.467474761618871,5.11085608669612,122600.06849315068,0,E01000953,8,0,9,0,0,0,5.165793619355205,5.229628637289311,5.475267878682667,5.217441427362694,5.203149905542086,5.679826244280653,5.422960285588476,154810.3762057878,0,5,2,9,1,0,2,1.0,0,-3,2,0,1,0,2
936,5.512073497514467,4.954044918756227,5.70319238224545,4.927586626362157,5.5890275465475545,6.011137459729169,5.616142237508619,122943.75675675676,3,E01000954,1,6,5,7,5,6,5.632287634046454,4.790515905932376,5.72880670898839,4.9392595949925875,5.5940695279522945,5.926097706744545,5.891879840901024,155358.2105263158,6,0,7,4,9,4,9,1.0,3,-1,1,-1,2,-1,3
937,5.266655212846295,5.142629798116355,5.6138422283633,5.1352270224998735,5.478408669603282,5.646626513579796,5.220845775357608,123230.62068965517,1,E01000955,3,5,8,4,0,0,5.269277390205499,5.008805020288988,5.587800737583276,5.001483129732536,5.370177231051705,5.690753084240538,5.317605611049768,155741.5303030303,1,2,4,5,4,0,1,1.0,0,-1,-1,-3,0,0,1
938,5.240994989871979,4.993886489989394,5.670478206569865,5.032561898231506,5.381703551542961,5.75524888200275,5.51749470981501,123097.33898305085,1,E01000956,1,6,7,2,1,4,5.446713469484273,4.787192032617681,5.812183013733695,4.94048037511461,5.364718155825839,5.856217138907489,5.652825621997609,155585.6911764706,3,0,8,4,4,2,6,1.0,2,-1,2,-3,2,1,2
939,5.415988206863403,5.2798870947302845,5.433288649814885,4.939972514059486,5.5018291269860615,5.647913905178628,5.196669401192084,121908.14634146342,2,E01000957,5,2,6,5,0,0,5.463726645591212,5.197163207858217,5.51323523124059,4.981298186031043,5.329771432222104,5.731535820400014,5.292710151158127,154067.66666666666,4,4,3,5,3,1,0,1.0,2,-1,1,-1,-2,1,0
940,5.38000888631523,5.282928163605618,5.54396262747704,5.030094192207204,5.479547182948603,5.700770276130279,5.315864680130358,122404.27167630057,2,E01000958,5,3,7,5,0,1,5.358883233070373,5.086615822655814,5.592558922086443,5.053332674843924,5.405415806770325,5.756612033843994,5.417770876203265,154705.61142857143,2,3,4,6,5,1,2,1.0,0,-2,1,-1,0,1,1
941,5.474371807915824,5.155013069814565,5.78827748979841,4.976699989669177,5.557161676640413,5.865387819251236,5.571735433169773,122457.63265306123,3,E01000959,3,7,6,6,2,5,5.4421926681812,5.0683952331542965,5.746703089200533,4.977734259458688,5.443650436401367,5.8652098875779375,5.445148623906649,154790.9846153846,3,2,7,5,6,2,2,1.0,0,-1,0,-1,0,0,-3
942,6.000094284371632,4.828359845207959,6.118187700829854,4.765776344915715,5.593425510860071,6.123045889342704,5.896794287169852,584992.3658536585,8,E01000960,0,9,2,7,7,9,5.356174275875092,4.908605995178223,5.826404881477356,4.950518355369568,5.282753896713257,5.808343415260315,5.576119270324707,744206.01,2,1,8,4,2,2,5,1.0,-6,1,-1,2,-5,-5,-4
943,5.817780310032415,5.129604215715446,5.778539477610121,4.85984912923738,5.43585658307169,5.980250459091336,5.5967118447902156,575730.2549019608,7,E01000961,2,7,4,3,4,6,5.555645697825664,5.0787686296411465,5.745909737251901,5.0448477332656445,5.287830177513329,5.871346576793774,5.6046313569352435,735958.6594594595,5,2,7,6,2,3,5,1.0,-2,0,0,2,-1,-1,-1
944,6.283724134618586,4.83077515038577,6.153110118345781,4.4822460044514045,5.840865390950984,6.296019952947443,5.8873039245605465,585541.0545454546,9,E01000962,0,9,0,9,9,9,5.855895459651947,4.882915899157524,6.095093354582787,4.580924406647682,5.450599849224091,6.135866686701775,5.875810518860817,745492.71875,8,0,9,0,6,8,9,1.0,-1,0,0,0,-3,-1,0
945,5.706041559276965,5.114724333654314,5.810306710684859,4.867567560016709,5.4734808230560095,5.961257912168567,5.638576445163497,563137.4093959732,5,E01000963,2,7,4,4,4,6,5.4974988624453545,5.041646231379774,5.6874206430382195,5.01068049006992,5.288976435032156,5.920945593880282,5.719046380784777,718719.8125,4,2,6,6,2,4,7,1.0,-1,0,-1,2,-2,0,1
946,6.520090073805589,4.74811591551854,6.280123376846314,4.374877339143019,5.934299395634578,6.504373975900504,6.135863538888785,585422.3384615384,9,E01000964,0,9,0,9,9,9,5.967453928554759,4.875422505771413,6.1047349817612595,4.788621664047241,5.643208728117101,6.345094288096709,6.034507947809556,745295.0588235294,9,0,9,1,9,9,9,1.0,0,0,0,1,0,0,0
947,6.283897513567015,4.9337820272113,6.002993672393089,4.561519047548605,5.7770186080489045,6.211484972820726,5.854795572369597,525387.9186046511,9,E01000965,0,9,0,9,8,9,6.019729414796518,4.795362985212039,6.034800700892031,4.726476775275336,5.564712203406041,6.166081684087616,5.79673213273092,653481.1176470588,9,0,9,0,9,8,8,1.0,0,0,0,0,0,0,-1
948,6.451134045918782,4.79689583862037,6.349157074041534,4.314670255309657,5.8643236662212175,6.55299072516592,6.215869723704824,585513.2807017544,9,E01000966,0,9,0,9,9,9,6.115372591548496,4.921754247612423,6.147520528899299,4.432141853703393,5.646480692757501,6.407421827316284,5.99381156762441,745475.9166666666,9,1,9,0,9,9,9,1.0,0,1,0,0,0,0,0
949,6.217329828325146,5.106494941397341,5.959509208530723,4.561183366233004,5.749545370033402,6.192750765178018,5.76245692318785,555178.5389221557,9,E01000967,2,9,0,9,8,8,5.95807515435359,5.100357188021436,5.721877306699753,4.76797444592504,5.5039953738451,6.068886674502316,5.700910193078658,697751.1654411765,9,3,7,1,8,7,7,1.0,0,1,-2,1,-1,-1,-1
950,6.218590978781382,4.827350544929504,6.202352674802144,4.51444753408432,5.791864172617594,6.3384143829345705,5.920739527543386,497234.6666666667,9,E01000968,0,9,0,9,9,9,6.129702402540475,4.67709685357149,6.172301871717469,4.670484083743135,5.583395624948928,6.307544345698081,5.949640853345887,626456.6198347107,9,0,9,0,9,9,9,1.0,0,0,0,0,0,0,0
951,5.999189885835799,4.830546907962314,6.071346055893671,4.629496995418791,5.672464858917963,6.242900452916584,5.9481185267842,558486.0317460317,8,E01000969,0,9,0,8,8,9,5.746508573874449,4.5591010344334135,6.178882476611015,4.57851331661909,5.580331013752864,6.132209325448061,5.840306489895552,622297.5641025641,7,0,9,0,9,8,9,1.0,-1,0,0,0,1,0,0
952,5.965435472585387,4.7934973987482365,6.094029616501372,4.597640187053357,5.699739023790521,6.343039173190877,5.8607960636332885,486538.25423728814,8,E01000970,0,9,0,9,9,9,5.766082961769665,4.752966321566525,6.094748532070833,4.646502917303758,5.583536649451537,6.142574103439555,5.684079485781052,622380.7647058824,7,0,9,0,9,8,7,1.0,-1,0,0,0,0,-1,-2
953,6.211032754666096,4.835477087948774,6.158339207236831,4.537226908915752,5.630872165834582,6.5218872830674455,5.9995212393838,486532.41891891893,9,E01000971,0,9,0,8,9,9,6.039729771018028,4.8294876083731655,6.14853583574295,4.56877262443304,5.545189595222473,6.4349663853645325,5.953115522861481,622361.9125,9,0,9,0,8,9,9,1.0,0,0,0,0,0,0,0
954,5.317863458319556,5.179700287082527,5.591938260235364,5.059368575675578,5.31105361558214,5.665349254125281,5.363775226134289,574016.4810126582,1,E01000972,3,4,8,1,0,2,4.887181243896484,5.023943719863891,5.563254375457763,5.100836658477784,5.343959712982178,5.503881111145019,5.476761798858643,676385.36,0,2,4,7,4,0,3,1.0,-1,-1,0,-1,3,0,1
955,5.5703854008632545,5.141780494767077,5.647741010083871,4.921111188390675,5.406186474596753,5.852194128667607,5.4727162683711335,512572.64705882355,4,E01000973,3,5,5,3,2,4,5.552310507838466,4.904043620374022,5.8843307655398585,4.882710558025777,5.4149582115541985,5.949670278725504,5.558701805707787,628503.7941176471,5,1,8,3,5,4,4,1.0,1,-2,3,-2,2,2,0
956,5.631706322709175,4.989266429861931,5.89840158697677,4.759095825561105,5.509923291532961,5.958972387117882,5.605781119163722,487486.20547945204,5,E01000974,1,8,2,5,4,6,5.510467143619762,4.799743215827381,5.982253733803244,4.89956465012887,5.408485268845277,5.869078285553876,5.525315219865126,623471.0,4,0,9,3,5,3,4,1.0,-1,-1,1,1,0,-1,-2
957,5.4614336190523805,5.209258249589613,5.544197784437166,5.006294762337958,5.373065119856721,5.903771755578634,5.4985474006279365,710415.2937062937,3,E01000975,4,3,7,2,3,4,5.337498848011951,5.162362841580877,5.60667916402122,5.055158172222162,5.357802998940676,5.850767085094326,5.494277913838823,902523.1059602649,2,4,5,6,4,2,3,1.0,-1,0,2,-1,2,-1,-1
958,5.380466455763036,5.18246318174131,5.660900940497716,4.996435828281172,5.324024531877402,5.9180734717484675,5.343690558816448,710562.0984848485,2,E01000976,3,5,6,1,3,2,5.209126003299441,5.095036161797387,5.653762677737645,5.072490873507091,5.3053603827953335,5.867758921214512,5.3335415984903065,902668.0071428572,1,3,5,7,3,3,1,1.0,-1,0,0,1,2,0,-1
959,5.785480415996383,5.222245486343608,5.666688761290382,4.836328908801079,5.6313888500718505,6.109643147272222,5.604162074187222,331020.8382352941,6,E01000977,4,5,4,8,7,6,5.716034392957334,5.150798530048794,5.693085876217594,4.963203273879158,5.521513938020777,6.153985657515349,5.68401720435531,425187.4962962963,7,4,6,5,8,8,7,1.0,1,0,1,1,0,1,1
960,5.819047186964301,5.199006334427865,5.842531442642212,4.829277193674478,5.712895231862222,6.177069412764682,5.719712184321496,331236.22580645164,7,E01000978,3,8,3,9,7,7,5.785516632413401,5.0787711861064135,5.8832078003188935,4.94428197272773,5.619073802985034,6.120679728035788,5.680432424961942,425300.786407767,7,2,8,4,9,7,7,1.0,0,-1,0,1,0,0,0
961,5.650998512282968,5.157485496252775,5.683759119361639,4.791350826621056,5.464071232825518,6.206214690580964,5.437377353198826,575373.0625,5,E01000979,3,6,3,4,8,3,5.584556759280317,5.0490707658669525,5.714406122179592,4.917747175868819,5.3075821180554,6.056749733055339,5.498910602401285,725336.7573529412,5,2,7,4,3,6,3,1.0,0,-1,1,1,-1,-2,0
962,5.565147367495935,5.16963441973751,5.668770813247533,4.832458108374216,5.468322078001152,6.111393872973989,5.497133256162255,397914.76699029125,4,E01000980,3,5,4,4,7,4,5.567818292474325,5.068660773007216,5.716407809637289,4.865155677879806,5.325789311290842,6.057679488595608,5.467503252282607,506064.1592920354,5,2,7,3,3,6,3,1.0,1,-1,2,-1,-1,-1,-1
963,5.566271245084851,5.11211452184134,5.625374468746564,4.801702673861523,5.475015707363356,6.096221656988788,5.513483319061481,330911.0,4,E01000981,2,5,3,4,6,4,5.4104588799828655,5.0539976958460455,5.701934046393273,4.943441867028307,5.240857885987967,5.983834476278933,5.4935490605015085,424910.6979865772,3,2,6,4,1,5,3,1.0,-1,0,1,1,-3,-1,-1
964,5.472475705608245,5.1908506026832,5.72049613665509,4.809356075461193,5.476636991705946,6.180758060947541,5.571446662308068,372406.39784946234,3,E01000982,3,6,3,4,7,5,5.58168793519338,5.049668284257253,5.734725568029615,4.779000062412686,5.312695129712423,6.060365711318122,5.60991440349155,478838.7888888889,5,2,7,1,3,6,5,1.0,2,-1,1,-2,-1,-1,0
965,5.568008454222428,5.21741693539727,5.653801659892376,4.710687982408624,5.467457660158774,6.18626946793463,5.520082680802596,330799.53383458644,4,E01000983,4,5,1,4,8,4,5.529709486694602,5.073570584083771,5.706529170483142,4.9134484921301995,5.412045342105252,6.076075975711529,5.5112657947140145,424727.1888111888,4,2,6,3,5,7,3,1.0,0,-2,1,2,1,-1,-1
966,5.715592514660399,5.235206383769795,5.6692564103562955,4.775881763231957,5.503045097246009,6.173808633270911,5.70261370933662,498709.9322033898,6,E01000984,4,5,2,5,7,7,5.562617058829059,5.144479513168335,5.656385924872451,4.919802127860662,5.3933482770844705,6.0908092401159095,5.674957676196661,647429.2598425196,5,3,5,4,5,7,6,1.0,-1,-1,0,2,0,0,-1
967,5.682474575356809,5.344138266083723,5.541354524161288,4.946225873010601,5.5386885875713325,6.033114369044047,5.652234055324943,328612.75449101796,5,E01000985,6,3,6,6,5,7,5.541187348889141,5.288459292272242,5.486235985668694,5.137478685960537,5.359144336566692,6.0131830544006535,5.70239286451805,422127.5548780488,5,6,2,8,4,5,7,1.0,0,0,-1,2,-2,0,0
968,6.00693530552458,5.175955027636915,5.752261128756079,4.7820790923467955,5.6705331035179665,6.272337081408737,5.807319017920164,334111.900990099,8,E01000986,3,7,2,8,8,8,5.803252314295724,5.061947332921429,5.788080155292404,4.83321159131059,5.512648115648288,6.240108267169132,5.872157322469159,429071.96261682245,8,2,8,2,8,9,9,1.0,0,-1,1,0,0,1,1
969,5.764511892572045,5.117100209929049,5.721582571044564,4.816851771436632,5.564817716367543,6.309065587818623,5.688536196947098,329288.8359375,6,E01000987,2,6,3,7,9,7,5.4296581726807815,5.122059438778804,5.694197386961717,4.980483142229227,5.389961153727311,6.239133136089031,5.715932344473325,422915.42307692306,3,3,6,5,5,9,7,1.0,-3,1,0,2,-2,0,0
970,5.657205600834372,5.368953613180611,5.501133078905805,4.846720970455726,5.534652675216521,6.14656118891347,5.6104900579356665,327400.5326633166,5,E01000989,6,3,4,6,7,6,5.401959710723752,5.388026594460666,5.472650424464718,5.0600510933897,5.347272963314266,5.978713993187789,5.62006756565073,420510.478021978,3,8,2,6,4,5,5,1.0,-2,2,-1,2,-2,-2,-1
971,5.39733855371122,5.538631418016222,5.47407909322668,5.0372079195799655,5.421725318166945,5.900163034156517,5.360578715359723,328446.5407407407,2,E01000990,9,2,7,3,3,2,5.202505019493401,5.434906612150371,5.389496024698019,5.173634605482221,5.217851425521076,5.879931215196848,5.412418620660901,421850.0703125,1,8,1,8,1,3,2,1.0,-1,-1,-1,1,-2,0,0
972,5.67323376862508,5.429580046545785,5.437689007903045,4.864648639481023,5.52875528245602,6.028218141591774,5.586391323017624,327343.89056603773,5,E01000991,7,2,4,6,5,6,5.530200121118061,5.443867525058006,5.293301273637743,5.067127325641575,5.3300333886004205,5.927532831234719,5.547055589618967,420445.9328358209,4,8,0,7,3,4,4,1.0,-1,1,-2,3,-3,-1,-2
973,5.816385967557023,5.433458482346883,5.546114798289974,4.7913131202139505,5.5833851058308674,6.125289640194032,5.655063643688109,328674.6195121951,7,E01000992,7,4,3,7,7,7,5.601371868626102,5.359696278205285,5.528966474009084,4.928704261779785,5.373354755915129,5.985651466872666,5.731220346230727,422152.3241758242,5,7,3,4,4,5,7,1.0,-2,0,-1,1,-3,-2,0
974,5.695305406001577,5.111762825857129,5.703908754022498,4.750078749238399,5.531821900292447,6.147610348567628,5.735952267521306,330152.4736842105,5,E01000993,2,6,2,6,7,8,5.504364939059242,4.937238421480535,5.73931373276953,4.9593845444210505,5.380591390496593,6.091492652893066,5.578863569235398,423889.16101694916,4,1,7,4,5,7,5,1.0,-1,-1,1,2,-1,0,-3
975,5.711778565075086,5.061705788322117,5.741580069583395,4.857292559872503,5.513399831108425,6.227865639976833,5.741803877250008,717170.4608695653,6,E01000994,2,7,4,5,8,8,5.469531305003584,5.0423519527703,5.689418983041194,5.030615462545763,5.428505104884767,6.0585230609826874,5.588021703979425,910733.2894736842,4,2,6,6,6,6,5,1.0,-2,0,-1,2,1,-2,-3
976,5.7294127402098285,5.0087489594583925,5.773354258744613,4.7994771356168,5.572320836523305,6.1949689326079,5.760014484239661,718123.6,6,E01000995,1,7,3,7,8,8,5.432511061713809,5.230449086143857,5.609435022444952,5.052380817277091,5.308033428873334,6.017792470114571,5.64008698122842,911655.0190476191,3,5,5,6,3,5,6,1.0,-3,4,-2,3,-4,-3,-2
977,5.657822752282733,5.128042818534942,5.738672509079888,4.7521225696518306,5.434669720275061,6.236305963425409,5.542661737828028,717210.5714285715,5,E01000996,2,7,2,3,8,5,5.368217329869325,5.13793958877695,5.687689542770386,5.119724125697695,5.307587385177612,6.064211132882655,5.518974738559503,910764.2988505748,2,3,6,7,3,6,4,1.0,-3,1,-1,5,0,-2,-1
978,5.578682067467994,5.045837850914788,5.708054627339864,4.830848792164596,5.443617697843571,6.204604330751085,5.5545385031356025,716697.8144329897,4,E01000997,1,6,4,4,8,5,5.326261259541653,4.969599668342288,5.682471933931407,5.101221418616795,5.199535641339746,6.005476347290643,5.502165945449678,910153.5742574257,2,1,6,7,1,5,3,1.0,-2,0,0,3,-3,-3,-2
979,5.818122526611945,5.042106471880518,5.873959986850469,4.850774401366109,5.510907281528819,6.279356477236507,5.812669521630412,715898.5252525252,7,E01000998,1,8,4,5,9,9,5.8255845252073035,5.029834223243426,5.8212409817947535,4.888484000035052,5.469010071934394,6.265739438668737,5.781301519780789,909200.2641509434,8,2,8,3,7,9,8,1.0,1,1,0,-1,2,0,-1
980,5.707014845684171,4.981548184528947,5.775651749223471,4.682412393391132,5.431057468056679,6.435182347893715,5.593394488096237,717487.65625,6,E01000999,1,7,1,3,9,6,5.5143644051118335,5.017727962045958,5.688444484363902,4.860366716529384,5.230050361517704,6.233523480819933,5.58367414004875,911086.3484848485,4,2,6,2,1,9,5,1.0,-2,1,-1,1,-2,0,-1
981,5.498520519143792,5.164989667554056,5.6602502202474945,4.894780685824733,5.4034404241910545,6.022144056135608,5.525118036936688,716038.8064516129,3,E01001000,3,5,5,3,5,4,5.28450168395529,5.18504521433188,5.572036701805738,5.085675021823572,5.264573144669435,5.917373696152045,5.433306477507767,909385.3163265307,1,4,4,7,2,3,2,1.0,-2,1,-1,2,-1,-2,-2
982,5.694720133792522,5.201146936693857,5.6659081453500795,4.8978706321050955,5.537665044152459,6.16963423684586,5.622975002887637,715111.6046511628,5,E01001001,3,5,5,6,7,6,5.455010360982045,5.182902831629098,5.60364117967077,5.036543110767043,5.357019784938858,6.111527506127415,5.588864629527173,908218.265060241,3,4,5,6,4,7,5,1.0,-2,1,0,1,-2,0,-1
983,5.729808401493799,5.054228047529857,5.737624310311817,4.767941023622241,5.4952779185204275,6.181206280276889,5.476608934856596,716946.0952380953,6,E01001002,2,7,2,5,7,4,5.5277807360345665,5.084021665833213,5.718093408779665,4.924202119762247,5.229348005218939,6.036408223889091,5.508259196173061,910468.3522727273,4,3,7,4,1,6,3,1.0,-2,1,0,2,-4,-1,-1
984,5.437229126955556,5.306525553222251,5.547142832680086,5.03471811788272,5.369170307058148,6.0176613584028935,5.36863120256272,715996.6548672566,2,E01001003,5,4,7,2,5,2,5.173318679235419,5.208296133547413,5.483261777430164,5.105702828387825,5.106103352137974,5.948440323070604,5.45924916437694,909358.3571428572,0,5,2,7,0,4,3,1.0,-2,0,-2,0,-2,-1,1
985,5.418059680610895,5.319184944033623,5.520460043102503,5.014078083448112,5.411348657682538,6.02821477688849,5.393546826206148,716007.234375,2,E01001004,5,3,7,3,5,2,5.278343669746233,5.341267093368199,5.452121060827504,5.186510835004889,5.18103897139646,5.849823775498764,5.357178260450778,909392.1376811594,1,7,2,8,1,2,1,1.0,-1,2,-1,1,-2,-3,-1
986,5.560417910984584,5.119556925977979,5.764906399590629,4.826276019641331,5.405258667469025,6.09084245136806,5.444939340863909,717349.3142857143,4,E01001005,2,7,3,3,6,3,5.553632361548288,5.040194925240108,5.900249171257019,4.780642812592642,5.338891141755241,6.070498623166766,5.435371492590223,910727.3857142857,5,2,9,1,3,7,2,1.0,1,0,2,-2,0,1,-1
987,5.477416298875761,5.476348888814746,5.3263357765045924,4.997369288805112,5.350919990397212,5.86681515067371,5.28063589364142,282134.2288557214,3,E01001006,8,1,7,2,2,1,5.381550587140596,5.490430291421813,5.178394428745114,5.139631960726431,5.191770510436183,5.762931099844194,5.220898803003234,398362.963800905,3,9,0,8,1,1,0,1.0,0,1,-1,1,-1,-1,-1
988,5.346151046360595,5.319192979154708,5.619777003421059,5.098552850982811,5.341247618952884,5.960337415526185,5.393139146551301,272713.36075949366,1,E01001007,5,5,8,2,4,2,5.083375619064947,5.282485312556628,5.5405560102522005,5.320242207983266,5.185675682488435,5.844128934492976,5.310032051542531,346243.1863354037,0,6,3,9,1,2,1,1.0,-1,1,-2,1,-1,-2,-1
989,5.31556110543416,5.44307978260786,5.555890800361347,5.084492681618023,5.303189300952997,5.919162563811567,5.467645675616157,557982.8045112782,1,E01001008,7,4,8,1,3,4,5.1816237893285635,5.34387080956109,5.442289690428142,5.137972581990158,5.139819364758987,5.808876076831093,5.4314336022244225,713374.9240506329,0,7,2,8,0,2,2,1.0,-1,0,-2,0,-1,-1,-2
990,5.471516949349437,5.212241831524619,5.645451609430642,4.880082475728002,5.442238859061537,6.102739514975712,5.4568600377132155,655458.5775862068,3,E01001009,4,5,4,4,6,3,5.430194688045372,5.154235506461839,5.728148312891944,5.023268888562413,5.2872538768638995,5.986042331841032,5.426321483264535,832607.593220339,3,4,7,6,2,5,2,1.0,0,0,2,2,-2,-1,-1
991,5.090249450269498,5.619220942886252,5.123030130800448,5.290326028748562,5.139986992196033,5.587159299850464,5.077433731681422,560265.0,0,E01001010,9,0,9,0,0,0,5.123332755347884,5.505995268006514,5.2327264259794,5.2377389217148895,5.082314372900219,5.639963959363361,5.1430665874369526,716651.0866510539,0,9,0,9,0,0,0,1.0,0,0,0,0,0,0,0
992,5.198202738538384,5.345381393097341,5.521471559070051,5.186115343123674,5.257489923387766,5.722790256142616,5.203883402980864,717215.203125,0,E01001011,6,3,9,0,1,0,5.174504405302967,5.187386257185353,5.444851298984006,5.140677575584796,5.300884775978198,5.67655251952384,5.276199873402822,910857.8992805756,0,4,2,8,3,0,0,1.0,0,-2,-1,-1,3,-1,0
993,5.88572612663974,5.010277498027553,5.711567811343981,4.79316631866538,5.509985281073528,6.180971632833066,5.760030679080797,716296.7391304348,7,E01001012,1,6,3,5,7,8,5.789859294891357,4.9146381181829115,5.8845548657809985,4.819346862680772,5.518232290885027,6.218440389633178,5.767773772688473,909503.8352941177,7,1,8,2,8,9,8,1.0,0,0,2,-1,3,2,0
994,5.1527987338126975,5.335443489940454,5.471153196713603,5.062710908287806,5.244253289615009,5.744178703490724,5.218471259935527,719198.8297872341,0,E01001013,6,2,8,0,1,0,5.128307140848172,5.285209846196684,5.3806388168215005,5.2574488389417064,5.174421024772356,5.634015156787896,5.19575443807638,913244.0691823899,0,6,1,9,0,0,0,1.0,0,0,-1,1,0,-1,0
995,5.0378181508316615,5.502654445540045,5.2230623309145265,5.286906040001571,5.116253021246789,5.578577877319965,5.105090539479993,681387.8762886598,0,E01001014,8,0,9,0,0,0,5.068050816472994,5.395487390112469,5.271444487105372,5.280437356976833,5.048046941570664,5.57214536148062,5.109378294140319,836276.6919315404,0,8,0,9,0,0,0,1.0,0,0,0,0,0,0,0
996,5.945854744960353,5.361526878838687,5.469925001724479,4.709061073273728,5.616436286685393,5.976270514665191,5.573449512117917,726199.6649484537,8,E01001015,6,2,1,8,4,5,5.915457654643703,5.1996395613696125,5.5116216376021105,4.73572080070908,5.642296590031804,6.037891949834051,5.692486340290792,921677.1081081082,8,4,3,0,9,6,7,1.0,0,-2,1,-1,1,2,2
997,5.981783129341171,5.407887917244116,5.385393226889545,4.733338808801125,5.586058584801875,5.956129208162913,5.544944647157935,675515.8902077151,8,E01001016,7,1,2,7,4,5,5.823930714140294,5.408318835670028,5.301385023781868,4.855314436789865,5.4753241385661715,5.823889196166359,5.562590886943073,857290.8630705394,8,8,0,2,7,2,4,1.0,0,1,-1,0,0,-2,-1
998,6.240287579291048,5.435566868698388,5.3613695139773405,4.693525902360504,5.592879058324803,6.0513815817080046,5.57621918679678,726740.5350877193,9,E01001017,7,1,1,7,5,5,6.024651215527509,5.32600675144711,5.334392060460271,4.783035497407655,5.532406327531144,5.957949223389496,5.712383111747536,923148.7675675675,9,7,1,1,8,4,7,1.0,0,0,0,0,1,-1,2
999,5.972594668106599,5.353880670395765,5.584598911350423,4.637054737589576,5.626191587881609,6.187741373885761,5.608129758184607,725236.3,8,E01001018,6,4,0,8,8,6,5.85862077008123,5.422595705675042,5.351422139354374,4.955320148882659,5.447133744281271,5.961891035411669,5.634088680018549,920750.2217391304,8,8,1,4,6,4,6,1.0,0,2,-3,4,-2,-4,0
1000,5.986542778923398,5.3827951669692995,5.543079447746277,4.773274598235176,5.6609909693400065,6.149247739428565,5.698476183414459,726159.6523809524,8,E01001019,7,3,2,8,7,7,5.701651221055251,5.455736866975442,5.394748357626108,5.040223830785507,5.505054358946971,5.856309770926451,5.612046253986848,921580.5846153846,7,8,1,6,8,2,5,1.0,-1,1,-2,4,0,-5,-2
1001,5.947164989653087,5.270170571122851,5.613424865404765,4.7934394416354955,5.584492759477524,6.231437951042539,5.743447051161811,725588.4238095238,8,E01001020,5,5,3,7,8,8,5.753071697338207,5.354040107211551,5.4117014098811795,4.955272664250554,5.503336398021595,6.069774858371631,5.748490595173191,921115.2351351351,7,7,1,4,7,7,8,1.0,-1,2,-4,1,0,-1,0
1002,6.042655362324282,5.4311547916043885,5.470534740523859,4.670751164582643,5.7232425077395,6.132647030732849,5.578227742829106,725580.2613636364,9,E01001021,7,2,1,9,7,5,5.90397137373232,5.526758512264581,5.229475298508775,4.911747199629769,5.524364990026212,5.981340865798408,5.517485444920922,921175.695431472,8,9,0,3,8,5,4,1.0,-1,2,-2,2,-1,-2,-1
1003,6.151580844491215,5.379860340942771,5.3316886526043135,4.6188271878129346,5.638686726052883,6.011034797813933,5.50550054534007,724543.8881355933,9,E01001022,7,1,0,8,5,4,6.028600690801159,5.548473301276662,5.192977741652844,4.8624313247749225,5.489854602252736,5.918777573731989,5.494762380917867,919845.522875817,9,9,0,2,7,4,3,1.0,0,2,-1,2,-1,-1,-1
1004,5.430471279917384,5.438378806650286,5.281936990086144,5.058830548320296,5.265634949743395,5.692526455461627,5.217316114690882,651016.5266272189,2,E01001023,7,0,8,1,0,0,5.379185192069115,5.263086581787868,5.520188952050014,5.023569982651382,5.287549557044492,5.819946599285505,5.408003056258486,723076.8947368421,2,6,3,6,2,2,2,1.0,0,-1,3,-2,1,2,2
1005,5.885344794044247,5.201842922668953,5.662840790562815,4.905915300567429,5.579787419987963,6.13395857191705,5.630517706468508,654924.2662337662,7,E01001024,3,5,5,7,7,6,5.589440099309,5.188471973612067,5.584694565012214,4.941629735271582,5.428991270868965,6.142863353986419,5.6554211177183005,762255.7415730337,5,4,4,4,6,8,6,1.0,-2,1,-1,-1,-1,1,0
1006,5.964375970498571,5.121863527867779,5.704434505798532,4.863704394994292,5.639256511844179,6.29153725935978,5.667964344504495,700372.358490566,8,E01001025,2,6,4,8,9,7,5.719120417611074,5.144082573510833,5.576701437012624,4.9723566821066,5.61317244020559,6.096029366477061,5.772829666986304,879503.9406779661,7,3,4,5,9,7,8,1.0,-1,1,-2,1,1,-2,1
1007,5.710644803176055,5.414312007620528,5.517837462554107,4.99083975263544,5.48949663832381,6.073687592068234,5.587340403891899,727534.1891891892,6,E01001026,7,3,6,5,6,6,5.394117858336896,5.324965266548857,5.394795022448715,5.107016638833649,5.2827508595525,5.805136605184906,5.405317772407921,923691.6836734693,3,7,1,7,2,1,2,1.0,-3,0,-2,1,-3,-5,-4
1008,6.159775196519585,5.39964416630161,5.353518455868354,4.658400651974599,5.5994513268730035,5.915229668853976,5.516667378427853,727240.0425531915,9,E01001027,7,1,1,7,3,4,5.975357423790476,5.371270593255758,5.32188633558425,4.717386071316221,5.470100332728841,5.873261659660122,5.469943861392411,923402.1860795454,9,7,0,0,7,3,3,1.0,0,0,-1,-1,0,0,-1
1009,6.352548918542983,5.302610559403142,5.542317904098124,4.536589420898051,5.830133870281751,6.152046194559412,5.808485832395433,568240.2253164557,9,E01001028,5,3,0,9,7,8,6.132967564357719,5.370283594591363,5.34570367747757,4.738946621188052,5.632593003323841,6.017901279599533,5.6607330096554636,723797.885786802,9,7,1,1,9,5,6,1.0,0,2,-2,1,0,-2,-2
1010,6.278566803250994,5.181569640889709,5.7036857797112654,4.526276069246369,5.7988793186215695,6.144900402306637,5.771806123055818,566170.4578754578,9,E01001029,3,6,0,9,7,8,6.00209808308073,5.193163799076546,5.587677261139873,4.69685984779318,5.581333728617492,6.0029585967911245,5.651920182364328,721212.0662020906,9,4,4,0,9,5,6,1.0,0,1,-2,0,0,-2,-2
1011,6.209224465367892,5.297699261626465,5.639722694310067,4.681005551088914,5.749202350918337,6.160352087135223,5.696313812292451,566704.7122302158,9,E01001030,5,5,1,9,7,7,5.916049120426178,5.277496303915978,5.472184196710587,4.86001645565033,5.539191174507141,6.085403350591659,5.644011923670769,721859.74,8,6,2,2,8,7,6,1.0,-1,1,-3,1,-1,0,-1
1012,6.184805023335965,5.200843717450294,5.69379333023713,4.573237861985358,5.734522982178447,6.2820246854675155,5.773754719818864,569147.1728971963,9,E01001031,3,6,0,9,9,8,5.9753826601536515,5.239096984072023,5.586508457837667,4.72306962669156,5.541885289042277,6.073858273601949,5.704278108855002,725035.8209606986,9,5,4,0,8,7,7,1.0,0,2,-2,0,-1,-2,-1
1013,6.116508344685809,5.327167720528123,5.5073176696433785,4.643059423991612,5.757738834582501,6.217014690363629,5.764728443592972,492092.07763975154,9,E01001032,6,3,0,9,8,8,5.877910439118382,5.359203590241271,5.493456133509177,4.8557188725389,5.523655931842368,6.1502551883974705,5.827917470239026,627669.9619377162,8,7,3,2,8,8,8,1.0,-1,1,0,2,-1,0,0
1014,5.783224336940087,5.211595442397463,5.669431114489315,4.783179094454994,5.5053043745778085,6.11942235238713,5.685021147406174,722115.2024539877,6,E01001033,4,6,2,5,7,7,5.620939220581855,5.13697237735028,5.659985449764278,4.894503672639806,5.3630836318422865,6.0097813989732645,5.592786491334022,916906.4545454546,6,3,6,3,4,5,5,1.0,0,-1,0,1,-1,-2,-2
1015,6.0346065468675505,5.194616843396284,5.780123810129841,4.696071734578591,5.555910746882281,6.235809682861087,5.686754448207345,716590.4566929134,8,E01001034,3,7,1,6,8,7,5.666580167392756,5.230590023450404,5.611576846781993,4.908660736660029,5.383314449515119,6.02352681736018,5.601855162806159,910825.3288590604,6,5,5,3,5,6,5,1.0,-2,2,-2,2,-1,-2,-2
1016,6.0798881919295695,5.115663843684726,5.8144393461721915,4.6577443820458875,5.73397307395935,6.203848674562242,5.889581148712724,713015.6,9,E01001035,2,7,1,9,8,9,5.8738836591893975,5.101354473468029,5.665798644224803,4.811122092333707,5.571535547574361,6.137080943945683,5.7510764508536365,905471.4242424242,8,3,6,2,9,8,8,1.0,-1,1,-1,1,0,0,-1
1017,6.2292276446812735,5.329548589125809,5.642767319337724,4.584643746867324,5.823090153948991,6.21114411432881,5.822887336583833,442497.6914600551,9,E01001036,6,5,0,9,8,9,6.021237935965865,5.182240537138228,5.668610759227201,4.750360036031383,5.546892408946419,6.224013522393981,5.850728582052604,579064.8526912181,9,4,6,1,8,9,9,1.0,0,-2,1,1,-1,1,0
1018,5.355002997590484,5.221978022040223,5.562512449223361,5.034416859956097,5.425965352024106,5.857755842826349,5.343460634457979,718779.345323741,2,E01001037,4,4,7,3,2,2,5.287095606327057,5.187544399583843,5.544779280541649,5.062237536403495,5.347061754952015,5.834078159130795,5.318272433650326,912883.5563380282,1,4,3,7,4,2,1,1.0,-1,0,-1,0,1,0,-1
1019,5.949956485629082,5.143146838744482,5.639080717166265,4.657059693336487,5.666877824068069,6.123585430781047,5.732612068454425,713192.2333333333,8,E01001038,3,5,1,8,7,8,5.907416621531088,5.098324032280389,5.68589447802446,4.783967096035875,5.500198929328618,6.118298694843382,5.7273683848343495,906008.1653543307,8,3,6,1,7,7,7,1.0,0,0,1,0,-1,0,-1
1020,6.154137187101403,5.238364258104441,5.571623877116612,4.658294215007704,5.744185727469775,6.178114185527879,5.7741730081791784,705189.3551020408,9,E01001039,4,4,1,9,7,8,5.9130431288673035,5.220962812823634,5.534312518373612,4.817858641186068,5.499752162444976,6.127169344694384,5.754413992166519,895896.1209677419,8,5,3,2,7,7,8,1.0,-1,1,-1,1,-2,0,0
1021,5.564292854116869,5.186766481214716,5.69805599737537,4.8308241034663,5.434123787769051,6.036362396654233,5.564818816591603,721068.1472868217,4,E01001040,3,6,4,3,5,5,5.414780539954268,5.215687746969645,5.544699827296622,5.093194963147976,5.303083781427985,5.887038268498927,5.351020380954615,915445.6912751677,3,5,3,7,3,3,1,1.0,-1,2,-3,3,0,-2,-4
1022,5.831646680831909,5.099333202838897,5.863712771733602,4.779568392038345,5.517503317197164,6.231775583823522,5.7440859566132225,721815.175,7,E01001041,2,8,2,5,8,8,5.634260529058951,5.104453175156205,5.651638575836464,5.021662371246903,5.213591183556451,5.963712154494392,5.562525310339751,916519.0296296297,6,3,5,6,1,4,4,1.0,-1,1,-3,4,-4,-4,-4
1023,5.250000772243593,5.37899709096769,5.351926126131198,5.143903625302198,5.234422746518763,5.655015463363833,5.2496028539611075,719021.9512195121,1,E01001042,7,1,9,0,0,1,5.2203672554640645,5.243677454184642,5.422129904274392,5.143801062507967,5.2406769363226084,5.728035244266544,5.328263139830226,913039.2345132744,1,5,1,8,1,1,1,1.0,0,-2,0,-1,1,1,0
1024,5.263001223276188,5.039017351416798,5.672137275918738,5.019567852670496,5.345771071972785,5.77865812375948,5.457995009112667,718393.0032467532,1,E01001043,1,6,7,2,1,3,5.260703475607766,5.034905937645171,5.6423042804002765,5.129933401942253,5.3032655086782245,5.671492986215485,5.3908690399593775,912255.4222222222,1,2,5,8,3,0,2,1.0,0,1,-1,1,1,-1,-1
1025,6.095284227075612,5.418341329176927,5.383685901156211,4.708598324733467,5.733983667134359,5.922104869821415,5.547321071044106,661815.7306273063,9,E01001044,7,1,1,9,3,5,5.983794095506706,5.296995716740885,5.463422967143268,4.751143057507822,5.532557516933912,5.990434336947255,5.631265069384024,836194.6653386455,9,6,2,1,8,5,6,1.0,0,-1,1,0,-1,2,1
1026,5.505424552493626,5.211533369192111,5.594144404713624,4.951647878861895,5.388213868624245,5.906396761049632,5.599706991435656,714068.8790849673,3,E01001045,4,4,6,3,3,6,5.4567358516604525,5.119970672768973,5.658823133817787,5.080613950562608,5.374498821347138,5.907569742919318,5.632298586147079,906802.7868852459,3,3,6,7,4,3,6,1.0,0,-1,2,1,1,0,0
1027,6.089238992104163,5.45221342740359,5.549369475224635,4.6721538071865805,5.778912472558188,6.106019346864073,5.610376227152098,534579.020979021,9,E01001046,8,4,1,9,6,6,6.114410341560067,5.370268251214709,5.567433606494557,4.750627451128774,5.64961420560812,6.233253867595227,5.723168147848798,687945.2727272727,9,7,4,1,9,9,7,1.0,0,-1,0,0,0,3,1
1028,5.8363027278806126,5.187408599215494,5.670548989739217,4.876572905291973,5.56095873973739,6.086062899777587,5.740677874692729,717287.5070422535,7,E01001047,3,6,4,6,6,8,5.701743509671459,5.239251888778112,5.633390265784851,4.907634889426297,5.4484648116647385,6.062187536122048,5.739735239989137,910780.9589041095,7,5,5,3,6,6,7,1.0,0,2,-1,-1,0,0,-1
1029,5.323393175999324,5.179217133257124,5.5863983935779995,5.073159959581163,5.384901481866836,5.7932548443476355,5.510736629035738,715684.5666666667,1,E01001048,3,4,8,2,1,4,5.316808502209137,5.141294477886184,5.589217787461656,5.133095771445278,5.29515678259347,5.789643300519445,5.561210864312422,909122.5020746888,2,3,4,8,2,1,4,1.0,1,0,0,0,0,0,0
1030,6.186494407524545,5.3897249727364045,5.532316201063524,4.67446362756821,5.791158980633839,6.145239090344992,5.630069602325738,345047.1204819277,9,E01001049,7,3,1,9,7,6,6.156611647232469,5.309708481093487,5.555291788764746,4.694935400442905,5.643915475132954,6.266506069395915,5.831333178712661,442358.063253012,9,6,4,0,9,9,8,1.0,0,-1,1,-1,0,2,2
1031,5.95277049995604,5.257663665782838,5.551324881258465,4.772982419956298,5.65465046394439,5.9935556792077564,5.572685211896896,576087.2857142857,8,E01001050,4,4,2,8,4,5,5.849303549649764,5.262064480051702,5.534204429509688,4.82701668690662,5.492998778820038,6.004479172278423,5.60377625543244,715215.581632653,8,6,3,2,7,5,5,1.0,0,2,-1,0,-1,1,0
1032,4.96548612707669,5.873007177077618,4.983188812265691,5.3148912375735256,5.227671125500472,5.556162395428136,4.971721614758993,342707.91752577317,0,E01001051,9,0,9,0,0,0,5.008550695578257,5.713875412940979,5.031477275159624,5.368474054336548,5.1643519083658855,5.5458795388539635,5.181050772137112,439550.3,0,9,0,9,0,0,0,1.0,0,0,0,0,0,0,0
1033,5.033010244369507,5.759249452959027,4.900944918916936,5.524178822835286,5.263869480082863,5.471920320862218,4.8574780894998915,342153.43859649124,0,E01001052,9,0,9,1,0,0,4.905001803751914,5.771787920305806,5.008665144443512,5.570710851300147,5.1032069806129705,5.459912663505923,5.004176309031825,438902.1935483871,0,9,0,9,0,0,0,1.0,0,0,0,0,-1,0,0
1034,5.451461846101369,5.488509572144096,5.395278646590862,5.007760757250144,5.383854855036905,5.880045946608198,5.369529894903197,344857.07092198584,3,E01001053,8,1,7,2,3,2,5.277920240598009,5.570137191292466,5.238312993618036,5.174878913045719,5.192980742612422,5.785265870441664,5.379530140895717,442305.6490066225,1,9,0,8,1,1,1,1.0,-2,1,-1,1,-1,-2,-1
1035,5.101017527615846,5.710311169054971,5.080233608608816,5.217219936313914,5.175840440081127,5.64545789316519,5.174889624118805,343433.5671641791,0,E01001054,9,0,9,0,0,0,5.218885615223744,5.7050594081644155,5.097275436901655,5.327360391616821,5.157085378639033,5.686223571417762,5.383866101014809,440429.2295081967,1,9,0,9,0,0,1,1.0,1,0,0,0,0,0,1
1036,5.466325649794411,5.5962242413969605,5.336958942693823,4.97473569056567,5.3877290410154,5.958085527139551,5.433026024173288,343107.23529411765,3,E01001055,9,1,6,3,4,3,5.313893037523542,5.600740996769496,5.225569402149746,5.113655388014657,5.200857759884426,5.882092331477574,5.49781847681318,440017.6914285714,2,9,0,7,1,3,3,1.0,-1,0,-1,1,-2,-1,0
1037,5.3215593948364255,5.582630666732788,5.258261108398438,5.076967489242554,5.358779727935791,5.870903245925903,5.333096894264221,344083.496,1,E01001056,9,0,8,2,2,1,5.263166525628832,5.589239198190195,5.169019364427637,5.254116036273815,5.179149697445057,5.7078393229731805,5.356895363772357,441260.0,1,9,0,9,1,0,1,1.0,0,0,0,1,-1,-2,0
1038,5.614230924639209,5.593634120349226,5.308057880607144,5.034891771859136,5.484267573932121,5.962143038881236,5.296308378721106,346337.9051724138,4,E01001057,9,0,7,5,4,1,5.471106531443419,5.65669145849016,5.20882370184969,5.169657381596388,5.347189141644372,5.911097409548582,5.485485444466273,443921.52777777775,4,9,0,8,4,3,3,1.0,0,0,0,1,-1,-1,2
1039,6.06599699304654,5.467111122149688,5.383843460908303,4.656523834054287,5.637148265655224,6.047645075963094,5.546408551243635,346819.82692307694,9,E01001058,8,1,1,8,5,5,5.9859011219098015,5.48524597631051,5.396235291774456,4.831008986784862,5.449437241141613,5.998879964535053,5.510363077888122,444796.2211538461,9,9,1,2,6,5,3,1.0,0,1,0,1,-2,0,-2
1040,6.186845865249634,5.462315822839737,5.426628680229187,4.588334982395172,5.711878716945648,6.0968786811828615,5.652187911272049,347423.22,9,E01001059,8,2,0,9,6,7,6.124467176395458,5.505710117109529,5.382561371876643,4.676672683967339,5.646576022053813,6.077779405719632,5.629482397666345,445314.032967033,9,9,1,0,9,7,6,1.0,0,1,-1,0,0,1,-1
1041,5.9771944910872215,5.560878785451253,5.01835445469501,4.774091618668799,5.500114044021157,5.685703690846761,5.233511235199723,348140.45098039217,8,E01001060,9,0,2,5,0,1,6.010127661337379,5.485482074832189,5.142772357882434,4.9452217125710645,5.363340432862289,5.74565497154498,5.188693826435176,446214.8435114504,9,9,0,4,4,1,0,1.0,1,0,0,2,-1,1,-1
1042,5.7368948382359966,5.469756145168234,5.384658140164834,4.85049904551771,5.545594060862506,6.050124890274471,5.5175038741694555,345122.0925925926,6,E01001061,8,1,4,6,5,4,5.690598931730068,5.490620316997651,5.314543986100755,4.989874718376019,5.397430222155312,5.9838320505783855,5.574578931254726,442374.1198156682,6,9,0,5,5,5,5,1.0,0,1,-1,1,-1,0,1
1043,5.998289695667355,5.387301582314394,5.4357583884752225,4.725015632390189,5.681112276838951,6.07097868872161,5.672717560242505,337770.95049504953,8,E01001062,7,2,1,9,6,7,5.96841615382756,5.257601386290101,5.4744101435967325,4.857697987482184,5.495109233900766,6.088099467791501,5.738990686392858,433435.6137071651,9,5,2,2,7,7,7,1.0,1,-2,0,1,-2,1,0
1044,5.72903361544013,5.253510013222694,5.678592061003049,4.849026697998245,5.703804932534695,6.137578086306651,5.708722377816836,341493.5,6,E01001063,4,6,4,9,7,7,5.621917560480643,5.107058853342913,5.66235790045365,4.94404491537435,5.451115608215332,6.06532333208167,5.68366019103838,437210.9275362319,6,3,6,4,6,6,7,1.0,0,-1,0,0,-3,-1,0
1045,6.123488514715234,5.4389667793374,5.249962134656921,4.717044481980971,5.7046813585799905,5.897039777334241,5.4906003380428245,343597.5786963434,9,E01001064,7,0,1,9,3,4,6.076469248347291,5.472041223045249,5.248596909010939,4.836664274408312,5.416116726418043,5.8764940713622495,5.45478733987448,440640.5303776683,9,9,0,2,5,3,2,1.0,0,2,0,1,-4,0,-2
1046,5.889995512357504,5.550428104611624,5.240201983831625,4.8651628659538115,5.535959752260056,6.02373384022783,5.43652619900605,343325.00884955755,7,E01001065,9,0,4,6,5,3,5.9146139980358665,5.5303039162271865,5.3040772819253394,4.89913421852675,5.435756810196263,6.056135217459421,5.516066274271038,440367.63231197774,8,9,0,3,6,6,4,1.0,1,0,0,-1,0,1,1
1047,5.599490461349487,5.569882913430532,5.317428265412649,4.930467703342438,5.492754154205322,6.002154852549235,5.473658725420634,345661.86666666664,4,E01001066,9,1,5,5,5,4,5.4482465563593685,5.610130754677025,5.234120752360369,5.1220182832833885,5.275621183015205,5.954650216811412,5.482755669870892,443221.27702702704,3,9,0,8,2,4,3,1.0,-1,0,-1,3,-3,-1,-1
1048,6.261934746657649,5.2537007663519155,5.58438685968999,4.533349045342015,5.772961679004854,6.136745067373399,5.7266825850932825,601827.2419354839,9,E01001067,4,4,0,9,7,8,5.999247721055659,5.303207951832593,5.511737594759561,4.786672288809365,5.587717450246578,6.048258174725665,5.731442926860437,761531.5447154471,9,6,3,1,9,6,7,1.0,0,2,-1,1,0,-1,-1
1049,6.186310604766563,5.363469295663598,5.3415922345938505,4.5903574938391465,5.64439305000835,5.878510746323032,5.471370311063013,716191.438271605,9,E01001068,6,1,0,8,2,4,6.040743697364375,5.341848828657618,5.256231992649583,4.804696618386035,5.423316992903655,5.806729909608949,5.394111802443018,911037.996226415,9,7,0,1,6,2,2,1.0,0,1,-1,1,-2,0,-2
1050,6.238026930813045,5.274483174714358,5.470593642081893,4.5775724106197115,5.730314938830927,6.013702931283396,5.631735108572722,723542.6033755274,9,E01001069,5,2,0,9,5,6,5.9129714652382095,5.36963940643031,5.352153106496252,4.820509259043069,5.488307661537466,5.939119101598345,5.643286246677925,918675.4956896552,8,7,1,2,7,4,6,1.0,-1,2,-1,2,-2,-1,0
1051,6.0397375607662065,5.361949955816749,5.500565021158122,4.718065639193967,5.664794667161626,6.01282459711857,5.525803859714124,712188.5611510791,9,E01001070,6,3,1,8,5,5,5.743909626676325,5.383171268513328,5.341325384692142,4.926962621588456,5.449191379965398,5.940817741762128,5.529081851557682,900473.0070175439,7,8,1,4,6,4,4,1.0,-2,2,-2,3,-2,-1,-1
1052,5.766496165025802,5.28921050230662,5.457665319102151,4.7835670987764995,5.539015053567432,5.962689656303042,5.528581966104961,714382.0523809524,6,E01001071,5,2,3,6,4,5,5.800346006838123,5.281598214353068,5.482598783594839,4.793541917640172,5.451905380474048,6.008332386445463,5.622411131189111,907433.4269662921,8,6,2,1,6,5,5,1.0,2,1,0,-2,0,1,0
1053,6.213594271640274,5.420434236876076,5.214693784713745,4.5930952053965015,5.665792629865607,5.814148337959893,5.495679670414966,722890.4721407625,9,E01001072,7,0,0,8,2,4,6.089413747686634,5.477097873601308,5.14780535042466,4.807154642851331,5.476379598015384,5.8363129127421765,5.439626331415782,918811.7794561933,9,9,0,1,7,2,2,1.0,0,2,0,1,-1,0,-2
1054,6.13053431113561,5.259514787958728,5.632355299260881,4.6262325826618405,5.690300396747059,6.213030066755083,5.738723239964909,611479.9583333334,9,E01001073,4,5,0,9,8,8,5.8858238918329375,5.2809451421101885,5.542312871396931,4.756373401560815,5.493055525948019,6.070133830986771,5.6611590658138,772041.8104575163,8,6,3,1,7,7,6,1.0,-1,2,-2,1,-2,-1,-2
1055,6.026088289844179,5.2684847897696265,5.544718568764844,4.68910331980696,5.653826225151136,5.983774206013355,5.5370376237387795,565706.6699029126,8,E01001074,5,3,1,8,4,5,5.740528638228709,5.339976590949219,5.419030386132079,4.872103982673579,5.418154897627892,5.931688653958308,5.5300837982268565,720641.6536796537,7,7,1,3,6,4,4,1.0,-1,2,-2,2,-2,0,-1
1056,5.969386027745552,5.26722793741376,5.431664172891547,4.667661601960347,5.543161620644375,5.926451459605032,5.5070243343632885,722879.6020942408,8,E01001075,5,2,1,6,3,4,5.809178366380579,5.329694039043896,5.335176257526173,4.83204149944897,5.352703945522002,5.881337650319471,5.459722338513257,917719.7219251337,8,7,1,2,4,3,3,1.0,0,2,-1,1,-2,0,-1
1057,5.902655167537823,5.445370346830602,5.445922602164118,4.776443905474847,5.625120997951742,6.109957498416566,5.478680688561055,348444.9429824561,8,E01001076,7,2,2,8,7,4,5.893993672598963,5.405046719053518,5.425637980647709,4.751551368443862,5.569312697908153,6.088285094758739,5.574429219702016,446510.94782608695,8,8,2,1,9,7,5,1.0,0,1,0,-1,1,0,1
1058,5.738611200617419,5.411880910396576,5.642022704084714,4.878096823891004,5.602392024464077,6.136305487818188,5.818742654389805,347478.78472222225,6,E01001077,7,5,4,7,7,9,5.610945724107169,5.362332088963969,5.535700863057917,5.053737753754729,5.510217971735067,6.095346390784203,5.7807197470765015,445398.9160839161,5,7,3,6,8,7,8,1.0,-1,0,-2,2,1,0,-1
1059,5.569021966568259,5.491418448991554,5.352241806512655,4.9277595066747,5.421213155569032,6.025625000166339,5.407309634740963,347940.87790697673,4,E01001078,8,1,5,3,5,3,5.544660870371194,5.538616183160365,5.333760573946196,5.071691650083696,5.346083872619716,5.955905282634428,5.462482407860373,445937.9942528736,5,9,1,7,4,4,3,1.0,1,1,0,2,1,-1,0
1060,5.406394932208917,5.562090841317788,5.283476109382434,5.055610888432234,5.362437910300034,5.909899265338213,5.348051526607612,348593.9692307692,2,E01001079,9,0,7,2,3,2,5.324991216050818,5.517959753249554,5.247987900008547,5.10383922305513,5.211135118565661,5.878998209821417,5.4575824173206975,446729.8670212766,2,9,0,7,1,3,3,1.0,0,0,0,0,-1,0,1
1061,5.4764287423255835,5.499020620833996,5.314569421285807,4.972557589065197,5.432894118996554,5.908755531144696,5.29296257468157,348672.238372093,3,E01001080,8,1,6,3,3,1,5.447642640769482,5.4720048271119595,5.285251636058092,5.047117066383362,5.2875601567327974,5.8913562700152395,5.443567878752947,446802.425,3,9,0,6,2,3,2,1.0,0,1,-1,0,-1,0,1
1062,5.843377097249031,5.4635959631204605,5.331347147226333,4.7583610707521435,5.510102512836457,6.070979350209236,5.486144037842751,356365.31,7,E01001081,8,1,2,5,6,4,5.82439972099505,5.525381881939738,5.31050588457208,4.8654470757434245,5.476051998138428,6.099272551034626,5.603657521072187,449771.56315789477,8,9,0,3,7,7,5,1.0,1,1,-1,1,2,1,1
1063,5.711932827264834,5.571304535254454,5.379212060545245,4.868419528007507,5.562952652446225,5.991640993163117,5.528830438088148,346914.18803418806,6,E01001082,9,1,4,7,4,5,5.6039956456325095,5.541518186936613,5.255642316380485,4.970388876121552,5.391367933789238,5.929781656773364,5.478937193507054,444832.987704918,5,9,0,5,5,4,3,1.0,-1,0,-1,1,-2,0,-2
1064,6.012515895588454,5.234322953131771,5.636083089566046,4.709380609582561,5.758911397105964,6.1846861358760865,5.739307190096656,635408.019379845,8,E01001084,4,5,1,9,8,8,5.856835219397474,5.130120312989647,5.591211557388306,4.772897907157443,5.61898880218392,6.1037174854705585,5.694003617585595,801252.3582089553,8,3,4,1,9,7,7,1.0,0,-1,-1,0,0,-1,-1
1065,5.59102477287424,5.080977749824524,5.703903545182326,4.860714916525216,5.455816163687871,6.16709203226813,5.5417250838773,341916.7655172414,4,E01001085,2,6,4,4,7,5,5.464258887623781,5.054290317849025,5.650790328147427,4.933148036067117,5.401630942453474,6.036172337180016,5.550608753357958,429389.4630872483,4,2,5,4,5,6,4,1.0,0,0,-1,0,1,-1,-1
1066,5.857158337699042,4.984236739299916,5.840142167056048,4.75888157332385,5.727348693211874,6.347014904022217,5.827105659025687,717786.4592592593,7,E01001086,1,8,2,9,9,9,5.720403696993272,4.966262422019629,5.815354304347965,4.883962483714811,5.580203147243253,6.257853645214931,5.761226303285832,911444.4892086331,7,1,8,3,9,9,8,1.0,0,0,0,1,0,0,-1
1067,5.852025607536579,4.934955929887706,5.886203917963751,4.73175888979572,5.63120184821644,6.280247730770331,5.760705802632474,668309.9137931034,7,E01001087,0,8,2,8,9,8,5.663515437463796,4.9181970380107805,5.796209853628407,4.869987558874285,5.449011186635272,6.130811974128581,5.748096270590835,832225.7267080746,6,1,8,3,6,8,8,1.0,-1,1,0,1,-2,-1,0
1068,5.7512268651934235,5.106815665083773,5.7182131760260635,4.818005150731872,5.541378108894124,6.231515858103247,5.622037497513435,234360.75735294117,6,E01001088,2,6,3,6,8,6,5.615768091167722,5.036889581169401,5.7737351383481705,4.882930026735578,5.469819011858531,6.23782536813191,5.774051977906908,301178.6,5,2,7,3,7,9,8,1.0,-1,0,1,0,1,1,2
1069,5.754596058636496,5.047963660873779,5.833040639145733,4.752133169402815,5.562366087142736,6.2947799146991885,5.5470314744400655,256528.76712328766,6,E01001089,1,8,2,7,9,5,5.603302749868941,4.944713356560224,5.8006611556223,4.79684676944393,5.4763924748930215,6.249938471676552,5.696275800874789,322016.80821917806,5,1,8,1,7,9,7,1.0,-1,0,0,-1,0,0,2
1070,5.905104366671138,5.070123248741407,5.843477553680163,4.6624197499090885,5.6041418273909755,6.290147122214822,5.6890395148461606,397437.06722689077,8,E01001090,2,8,1,7,9,7,5.637338549149137,5.02500694238839,5.794710317579638,4.8251316407147575,5.387826856444864,6.192974282913849,5.6991978312740805,537997.8403361344,6,2,8,2,5,8,7,1.0,-2,0,0,1,-2,-1,0
1071,6.037172731932472,5.221974717869478,5.688342403664309,4.676805052336524,5.7761413097381595,6.242560625076294,5.702498513109544,437184.52352941176,8,E01001091,4,6,1,9,8,7,5.975115303095285,5.108549644420673,5.74493881324669,4.708294173339745,5.614604891120614,6.276498204701907,5.888938467223923,547898.1428571428,9,3,7,0,9,9,9,1.0,1,-1,1,-1,0,1,2
1072,6.204966304722492,5.265451903005408,5.580169391396411,4.558103932972991,5.757281680476332,6.063858056579037,5.747447346933984,609477.3179571663,9,E01001092,5,4,0,9,6,8,6.055007107295687,5.277744404474894,5.521545175900535,4.712915059119936,5.5973954715426,6.019475810489958,5.640554844765436,769812.0158730159,9,6,3,0,9,6,6,1.0,0,1,-1,0,0,0,-2
1073,5.890739370637865,5.359167327186954,5.481190345180568,4.810949083139647,5.541727501064984,6.016701743673923,5.610312602413234,717954.6977611941,7,E01001093,6,2,3,6,5,6,5.6625798935520235,5.286076631525467,5.456725242836722,4.947182870116727,5.355462419061825,6.010127987327246,5.609828978776932,910523.5086206896,6,6,2,4,4,5,5,1.0,-1,0,0,1,-2,0,-1
1074,6.403387757888527,5.26719200663171,5.569039403611396,4.510870046490665,5.947568693535818,6.154514286715911,5.865314490930483,567092.0393013101,9,E01001094,5,4,0,9,7,9,6.204108615875244,5.248367195129394,5.5729225468635555,4.668476447105408,5.690074130058289,6.170391008377075,5.791166766643524,722346.608,9,5,4,0,9,8,8,1.0,0,0,0,0,0,1,-1
1075,5.676835753227192,5.261574059887662,5.545183017605641,4.986861279753388,5.497763915140121,6.006134804480714,5.5935711626146665,722487.7322404372,5,E01001095,5,4,6,5,5,6,5.396768563985825,5.313962407112122,5.4872038507461545,5.08684328019619,5.230063608884811,5.8399773430824276,5.486127440333366,917465.5,3,6,2,7,1,2,3,1.0,-2,1,-2,1,-4,-3,-3
1076,6.19432536328193,5.246358961752145,5.6440472909719634,4.653313180597702,5.745947666687541,6.252476405389238,5.912790303183074,721828.9851485149,9,E01001096,4,5,1,9,8,9,5.857232070613552,5.280469028369801,5.55786822615443,4.8974085988225164,5.448342950924022,6.110505780658206,5.784967948294975,917519.3945945946,8,6,4,3,6,7,8,1.0,-1,2,-1,2,-3,-1,-1
1077,5.766900555452167,5.1942881933256,5.555421519416109,4.807345700127348,5.515811480218838,5.906656464054796,5.533102052259582,682021.0257879656,6,E01001097,3,4,3,5,3,5,5.610752458612912,5.232049196367561,5.471424469529063,4.956842247217303,5.361552168559758,5.856636128074387,5.453130783507912,873393.1926345609,5,5,2,4,4,2,2,1.0,-1,2,-2,1,-1,-1,-3
1078,6.259267190669445,5.302943212343446,5.530898815351175,4.565706442011163,5.827024011747212,6.073443017952831,5.717745642290048,723096.7304964539,9,E01001098,5,3,0,9,6,7,5.985726510902637,5.302098350576084,5.407428816947187,4.802908534014161,5.45131912640894,5.997305457195357,5.709507237606697,918263.549194991,9,6,1,1,6,5,7,1.0,0,1,-2,1,-3,-1,0
1079,5.9123937526862775,5.219211866041857,5.598677396774292,4.654593561223881,5.5767016139572965,6.068308100728932,5.642591020304286,723229.0179640718,8,E01001099,4,4,1,7,6,6,5.69704005052877,5.336673044881155,5.470944235491198,4.920976977708728,5.344208466452222,5.914719814477965,5.438757937314898,918268.6686046511,6,7,2,4,4,3,2,1.0,-2,3,-2,3,-3,-3,-4
1080,5.828166837933697,5.134685708752161,5.662872736967063,4.7917631049699425,5.588309368755244,6.220258990420571,5.778331207323678,721664.7468354431,7,E01001100,3,5,3,7,8,8,5.710322659287677,5.221002217107171,5.699368673683013,4.831550370126763,5.447713387092488,6.19570681232734,5.789916813773597,916337.8322147651,7,5,6,2,6,8,8,1.0,0,2,1,-1,-1,0,0
1081,6.081950851421261,5.316352661530576,5.5080273546765195,4.726790202921959,5.773688110274885,6.248591611133748,5.76086456512087,665915.0,9,E01001101,5,3,2,9,8,8,5.699393144360295,5.369176414277819,5.488869575806606,4.892266657617357,5.528958553149376,6.183714619389287,5.912373960754017,753494.7098765433,6,7,2,3,8,8,9,1.0,-3,2,-1,1,-1,0,1
1082,6.117705241420813,5.266353721785964,5.59841486780267,4.6818722637076124,5.729611988234939,6.182212948380855,5.760798532084415,385825.649122807,9,E01001102,5,4,1,9,7,8,5.908928270766277,5.278171034443457,5.512598221270454,4.8745825211733385,5.523439850238775,6.160034430737527,5.848844490698632,475882.62913907284,8,6,3,3,8,8,9,1.0,-1,1,-1,2,-1,1,1
1083,5.983775024851337,5.257402921347639,5.575706936907039,4.705858321689623,5.740560581590411,6.299411371805783,5.747972151598035,626238.7641921397,8,E01001103,4,4,1,9,9,8,5.628164172172546,5.529650115966797,5.2183870835737745,5.069666970859874,5.272326298193498,5.913366504149003,5.644741251251914,448771.2545454545,6,9,0,7,2,3,6,1.0,-2,5,-4,6,-7,-6,-2
1084,6.114228403770317,5.266630291534683,5.6165898032107595,4.6313522443933,5.808308042105982,6.209504014354641,5.798266650458514,717313.1355932204,9,E01001104,5,5,0,9,8,8,5.966955041406944,5.231183513749802,5.5410660947844335,4.800936217292096,5.616754950488292,6.209724624021396,5.848546028137207,915408.1204013377,9,5,3,1,9,8,9,1.0,0,0,-2,1,0,0,1
1085,5.911858129501343,5.32527703444163,5.567629676394993,4.7596659878889716,5.582202360365126,6.217170525921715,5.784589272075229,703707.45,8,E01001105,6,4,2,7,8,8,6.407186448574066,5.670531213283539,4.730234652757645,4.982799381017685,5.1770830899477005,5.669324338436127,5.230681091547012,448944.5,9,9,0,5,1,0,0,1.0,1,3,-4,3,-6,-8,-8
1086,6.176201822879436,5.2781711959982065,5.496710123958531,4.568526446282327,5.714023353101255,6.042211085468441,5.729037580905376,649577.003003003,9,E01001107,5,3,0,9,5,8,5.888213830308107,5.347570403989954,5.409530145621225,4.8283670576388555,5.398861352552815,5.991460152180591,5.622828414073932,818023.4827586206,8,7,1,2,5,5,6,1.0,-1,2,-2,2,-4,0,-2
1087,6.176149990969089,5.295026161295154,5.584483606038076,4.656345940334893,5.822535025767791,6.234004353428935,5.859972350763314,408303.22344322345,9,E01001108,5,4,1,9,8,9,5.974542365755354,5.282367163045066,5.558691444993019,4.787402304581233,5.571510962077549,6.163778380836759,5.861081175718989,529797.3214285715,9,6,4,1,9,8,9,1.0,0,1,0,0,0,0,0
1088,5.319481163728432,5.328816322029614,5.396253930414961,5.040618502377161,5.322270586190979,5.815634426523427,5.285530117040124,711035.6010928962,1,E01001109,6,1,7,1,2,1,5.230051131148613,5.301092305108515,5.426429169340284,5.182483912762547,5.228113750512687,5.705802805760768,5.2053456730867556,903236.3246073298,1,6,2,8,1,0,0,1.0,0,0,1,1,0,-2,-1
1089,5.457115671406053,5.242493064436194,5.55948396578227,4.955987508166326,5.441753426643267,5.91283771273208,5.433864533901215,714061.8630136986,3,E01001110,4,4,6,4,3,3,5.469311372653858,5.1702222832151365,5.632657638272724,4.992986780566138,5.41762705106993,5.914512745431952,5.462516291721447,907017.777027027,4,4,5,5,6,3,3,1.0,1,0,1,-1,2,0,0
1090,5.556066407932072,5.204035195778674,5.604991685687088,4.904769223506056,5.421951765150536,6.038541168678464,5.4894161843878075,711049.2677165355,4,E01001111,4,4,5,3,5,4,5.349548267091022,5.145226405823932,5.525082259493716,5.0116040952065415,5.2354638962184685,5.902903417454047,5.468205946333268,899693.1911764706,2,4,3,6,1,3,3,1.0,-2,0,-1,1,-2,-2,-1
1091,5.457254406809807,5.402228442827861,5.547105933229129,5.051004067063332,5.3578453183174135,5.966627154747645,5.4500757892926535,521107.25833333336,3,E01001112,7,4,7,2,4,3,5.32914776677516,5.339474461861511,5.491823637663429,5.0799592190714025,5.197389535939515,5.925664209607822,5.405463175097508,660690.1268656716,2,7,3,7,1,4,2,1.0,-1,0,-1,0,-1,0,-1
1092,5.50422325424659,5.312169814721132,5.554499728557391,4.999824118919862,5.403536222684077,5.934510493125671,5.45524156322846,711050.1153846154,3,E01001113,5,4,7,3,3,3,5.298306895501958,5.203400812808822,5.549284878017017,5.054886036698923,5.233867140685987,5.855848478071345,5.408896899073379,903224.3018867924,1,4,4,6,1,2,2,1.0,-2,-1,0,-1,-2,-1,-1
1093,5.481200865469873,5.173776992596686,5.566761979833245,5.017140908166766,5.384063431993127,5.888024639338255,5.366341114975512,712871.7578125,3,E01001114,3,4,7,2,3,2,5.334761833356431,5.220007210723625,5.52756159955805,5.151312942347251,5.240731791031262,5.794390278414261,5.3753260088361,905645.1900826446,2,5,3,8,1,1,1,1.0,-1,2,-1,1,-1,-2,-1
1094,5.54485350388747,5.399180992291524,5.5197018675315075,5.009907437440677,5.398917170671316,5.925909658273061,5.429811247648337,715771.0833333334,4,E01001115,7,3,7,3,3,3,5.401230960242493,5.327235526284255,5.511156924700333,5.129933127575675,5.262726386388143,5.822622090409705,5.34343828723929,909067.2937853107,3,7,3,8,2,2,1,1.0,-1,0,0,1,-1,-1,-2
1095,5.490936529636383,5.167824093103409,5.582448307275772,5.029704858064651,5.414461140632629,6.0077467286586765,5.438065028190612,713083.32,3,E01001116,3,4,7,3,5,3,5.41343628704001,5.119022410943968,5.628540187800696,4.89887316292579,5.305775119624006,5.943585750159867,5.39401903830537,905763.5963302752,3,3,5,3,3,4,2,1.0,0,0,1,-4,0,-1,-1
1096,5.586160478346488,5.107389867305756,5.719305201488383,4.819824993610382,5.4928706568830155,6.086892266483868,5.564430227174478,716541.7205882353,4,E01001117,2,6,3,5,6,5,5.5095405602941705,4.9626069458163515,5.719754100656834,4.93072906967734,5.413230071262437,6.039129639969391,5.620035649967843,909973.5850340136,4,1,7,4,5,6,5,1.0,0,-1,1,1,0,0,0
1097,5.227191086386291,5.456945004597516,5.3896038842872835,5.1228907586823045,5.303183425480212,5.763805893105521,5.296190660604289,713938.5352112676,0,E01001118,8,1,8,1,1,1,5.229111412593297,5.272737113067082,5.414607574258532,5.125961599179677,5.310528077398028,5.739460282666343,5.255572253465653,906644.0285714286,1,6,1,8,3,1,0,1.0,1,-2,0,0,2,0,-1
1098,5.544402416093009,5.548607589857919,5.3823116609028405,4.932647805213929,5.412909269332886,5.921244350160872,5.479682878766741,348556.82285714283,4,E01001119,9,1,5,3,3,4,5.445261622850712,5.600145378938088,5.265950907499362,5.117131412793428,5.267643719911575,5.826150429554475,5.467318796958679,446752.51923076925,3,9,0,7,2,2,3,1.0,-1,0,-1,2,-1,-1,-1
1099,5.7632894012434726,5.3421707924070025,5.590934297134137,4.852586266295663,5.552774135408731,6.039536486411917,5.6249745190143585,346752.9913793103,6,E01001120,6,4,4,6,5,6,5.564440524466684,5.31882394585654,5.514869235386358,4.9723504692594584,5.383661377095731,5.969931114499814,5.6594946150467775,444586.5420560748,5,6,3,5,5,5,6,1.0,-1,0,-1,1,-1,0,0
1100,6.060882367911162,5.405469633914806,5.354485772274159,4.665011306162234,5.701442389135008,5.980563967316239,5.535553635491265,349768.5925925926,9,E01001121,7,1,1,9,4,5,5.91304832419187,5.391155248474477,5.266376275742781,4.927672819851974,5.404235116469818,5.949434248777274,5.479864647738823,448089.1218637993,8,8,0,4,5,4,3,1.0,-1,1,-1,3,-4,0,-2
1101,6.103575158213812,5.338249482805767,5.485549532231831,4.623351000131122,5.69868915232401,6.027065170662744,5.64770623994252,345649.8968253968,9,E01001122,6,3,0,9,5,7,6.0442691481474675,5.336436786886417,5.407347915750561,4.772657857248277,5.453309344974431,6.032563102967812,5.657046167687937,443201.8939393939,9,7,1,1,6,6,6,1.0,0,1,-2,1,-3,1,-1
1102,6.047751746831402,5.2547829386688045,5.618990832278805,4.592691602726137,5.795745887102619,6.277134522795677,5.81017908021327,345952.5564516129,9,E01001123,4,5,0,9,9,8,5.859854652526531,5.272846058074464,5.558630230071697,4.819080490254342,5.541886996208353,6.2209233699960915,5.867978326310503,443581.99574468087,8,6,4,2,8,9,9,1.0,-1,2,-1,2,-1,0,1
1103,5.976283795038859,5.341671823925442,5.5276431602901885,4.716706190639072,5.695193163553873,6.141829769346449,5.691645899348789,347557.94666666666,8,E01001124,6,3,1,9,7,7,5.730224048936522,5.391736110051473,5.425582684995808,4.890910541340387,5.455722225692881,6.015063318855319,5.6600624002935565,445456.8268398268,7,8,2,3,6,5,6,1.0,-1,2,-1,2,-3,-2,-1
1104,5.825767897571307,5.104257329757967,5.732707619049388,4.686088970905758,5.602436439978644,6.164624089404091,5.756565955636415,347037.33678756474,7,E01001125,2,6,1,7,7,8,5.586156222317785,5.2230024968562105,5.579417031976674,4.926371388371216,5.369081490777533,6.047074228124234,5.70225376986602,444976.31838565023,5,5,4,4,4,6,7,1.0,-2,3,-2,3,-3,-1,-1
1105,5.516181384644857,5.486843027719638,5.451857930276452,4.963159640387791,5.450503933720473,6.0279025333683665,5.566840519265431,347198.96341463417,3,E01001126,8,2,6,4,5,5,5.400015018395418,5.54596773407163,5.269062313102406,5.179032639638912,5.277268255956074,5.892100763038771,5.546988887899726,444940.05917159765,3,9,0,8,2,3,4,1.0,0,1,-2,2,-2,-2,-1
1106,5.934985467445019,5.232135263154673,5.650226411154104,4.728480835848076,5.704756421821062,6.292720999828605,5.694377861466519,340470.0930232558,8,E01001127,4,5,2,9,9,7,5.55503753029694,5.195304892830929,5.5036740277783345,5.049516408625296,5.344401618686773,5.921334560139704,5.688683404760845,436840.4406779661,5,4,3,6,4,4,7,1.0,-3,0,-2,4,-5,-5,0
1107,5.377121651274527,5.490137796116691,5.359570407459879,5.074696659022926,5.436739104425805,5.882430873365483,5.345409576709454,340637.28205128206,2,E01001128,8,1,8,3,3,2,5.170817681866834,5.344612457813361,5.291556666040013,5.260358181774107,5.056524145297515,5.6617416438893375,5.399197220802307,437057.53846153844,0,7,0,9,0,0,2,1.0,-2,-1,-1,1,-3,-3,0
1108,5.833862501186329,5.223353521509485,5.700178124092438,4.7561484431172465,5.711777334684854,6.386150628655821,5.881241159124689,340121.5824175824,7,E01001129,4,6,2,9,9,9,5.424757086828853,5.097314833255297,5.615173992146267,5.01976423183184,5.30786345781905,5.95693356937237,5.712417417027977,436428.4831460674,3,3,5,6,3,4,7,1.0,-4,-1,-1,4,-6,-5,-2
1109,5.313239803579118,5.585287703408135,5.239308349291483,5.122265023655362,5.4769653969340855,5.874345580736796,5.108798160817888,341339.22222222225,1,E01001130,9,0,8,4,2,0,4.9901260708240756,5.565521214870697,5.274050687221771,5.373129731797158,4.958239202803754,5.44411083865673,5.295752668634374,437849.5106382979,0,9,0,9,0,0,0,1.0,-1,0,0,1,-4,-2,0
1110,5.403875259337602,5.6589150318393004,5.220161069322516,5.066787036480727,5.379437806429686,5.7323155966069965,5.025982238628246,326773.7962962963,2,E01001131,9,0,8,2,1,0,5.087715076417038,5.688845312472472,5.1585880223008775,5.3069363021359,5.159555318429298,5.56372761480587,4.9161655571042875,419678.2989690722,0,9,0,9,0,0,0,1.0,-2,0,0,1,-2,-1,0
1111,5.77995752608567,5.3698626427274005,5.4963658744828745,4.839852271372812,5.68980776636224,6.110315056223619,5.6277324661873935,326743.3596491228,6,E01001132,6,3,4,9,7,6,5.642682359852922,5.394039538475352,5.430387828328194,5.0438786876311,5.34822234538717,6.038183640996251,5.640997900875337,419647.49541284406,6,8,2,6,4,6,6,1.0,0,2,-1,2,-5,-1,0
1112,5.774465073526433,5.403979156397085,5.544493907320816,4.832724552238937,5.638351382407467,6.155982097693249,5.721659046358766,329185.88495575223,6,E01001133,7,3,4,8,7,7,5.5612799188103335,5.29138521714644,5.496438294950158,5.031123602029049,5.327563187690696,5.956842123860061,5.778122745379053,423173.0505050505,5,6,3,6,3,4,8,1.0,-1,-1,0,2,-5,-3,1
1113,5.726962343642586,5.494621509627292,5.458341580943057,4.918416493189962,5.476368673224198,5.999508335088429,5.500211287172217,328155.6052631579,6,E01001134,8,2,5,4,5,4,5.668318062761555,5.316713248646778,5.46579568852549,4.975359879887622,5.3712413202161375,5.948104591991591,5.635866546112558,421496.8086956522,6,6,2,5,4,4,6,1.0,0,-2,0,0,0,-1,2
1114,5.867969275372369,5.302289269651685,5.62839960030147,4.752585603935378,5.683110191992351,6.211398755652564,5.690833606464523,329366.3857142857,7,E01001135,5,5,2,9,8,7,5.72590277295608,5.138803724344674,5.650367944271533,4.897215902031242,5.4532042884981475,6.064872873293889,5.68655648246988,422047.8409090909,7,3,5,3,6,6,7,1.0,0,-2,0,1,-3,-2,0
1115,5.738589412149261,5.142835571485407,5.666844327660168,4.84336756169796,5.580076324589112,6.068515011492898,5.555033758282661,342759.8823529412,6,E01001136,3,5,4,7,6,5,5.600403535933721,5.051225082403948,5.692267138941759,4.955036868043497,5.458667729176631,6.011240138488562,5.595702957944805,441996.25850340136,5,2,6,4,7,5,5,1.0,-1,-1,1,0,0,-1,0
1116,6.088004368146261,5.233805297215779,5.606342684427897,4.65055866877238,5.688382218678792,6.04090296321445,5.60795397705502,576774.4755555555,9,E01001137,4,4,0,9,5,6,5.97213975519072,5.272937855345713,5.636159107674678,4.744016670243709,5.645011842511106,6.031814275350112,5.5782513988070095,734877.9388646288,9,6,5,1,9,6,5,1.0,0,2,1,1,0,1,-1
1117,6.17571408800084,5.229014310047781,5.646030181603466,4.555851382317303,5.757872547177102,6.172310426080827,5.742946420642112,335187.02877697843,9,E01001138,4,5,0,9,7,8,6.068678796670999,5.124709266765862,5.7620424958551,4.670229072783403,5.632472129384423,6.106589103200633,5.607402536519773,427952.6178343949,9,3,7,0,9,7,5,1.0,0,-1,2,0,0,0,-3
1118,5.848348854281378,5.09439491380191,5.737139634206786,4.690410772113935,5.609916742811811,6.255055677806232,5.734665814866411,530511.9007092199,7,E01001139,2,6,1,7,8,8,5.7501391423375985,5.007807504861875,5.844081161613751,4.741359721449085,5.467650657309625,6.225012087284174,5.742780676461701,651668.6917293234,7,2,8,1,7,9,7,1.0,0,0,2,0,0,1,-1
1119,5.886043836088741,5.259526962993526,5.625779047733595,4.670481457429774,5.609411794598363,6.092347327400656,5.665899070371099,446233.87394957984,7,E01001140,4,5,1,7,6,7,5.839934259435556,5.158471598242321,5.726665807466437,4.725171512060792,5.588469618428363,6.10446807415816,5.6787520464319385,588847.4087591241,8,4,7,0,9,7,6,1.0,1,0,2,-1,2,1,-1
1120,5.804266401365692,5.285200171610889,5.613281044305539,4.717403896883423,5.624212825999541,6.093759812560736,5.606595700862361,330805.5,7,E01001141,5,5,1,8,6,6,5.705273528711511,5.186595092125989,5.630582997558314,4.915706217835803,5.423327533476943,6.032902520730955,5.668856199728239,424749.25688073394,7,4,5,4,6,6,6,1.0,0,-1,0,3,-2,0,0
1121,5.8439873554421675,5.099917275350799,5.731022032551795,4.832136806452049,5.646149357909676,6.226092996837208,5.838023454888062,331150.53459119494,7,E01001142,2,6,4,8,8,9,5.814265565499247,5.092942674732741,5.767682119454752,4.884713501237624,5.644392979211648,6.221035898730742,5.795292727774082,425147.54189944133,8,3,7,3,9,9,8,1.0,1,1,1,-1,1,1,-1
1122,5.571111362013552,5.310688420302338,5.513772051367495,4.923105933600002,5.488125087486373,5.971223384141922,5.3660379714436,329696.4375,4,E01001143,5,3,5,5,4,2,5.4759835526891,5.197800034154071,5.526581941729915,4.971019579546295,5.2425903090595325,5.9264809284767095,5.448854736168019,423403.74452554743,4,4,3,5,1,4,2,1.0,0,-1,0,0,-4,0,0
1123,6.090124476787656,5.018272731193276,5.862098752066147,4.678645889426386,5.627930943356004,6.432407864304476,5.886660614679026,441730.67441860464,9,E01001144,1,8,1,8,9,9,5.981142735481262,4.930213001039293,5.884002722634209,4.688631273640526,5.491748931672838,6.423600631290012,5.814211059941186,568761.4333333333,9,1,8,0,7,9,8,1.0,0,0,0,-1,-1,0,-1
1124,5.434024821045578,5.086797464278437,5.575301452349591,4.947240447485319,5.431330655210761,5.789017315833799,5.338996206560442,330255.5268817204,2,E01001145,2,4,6,3,1,2,5.38878936305338,5.1101612886604,5.558118907772765,5.057273981522541,5.326482062437097,5.789031809690047,5.405707193880665,424093.9081632653,3,3,4,6,3,1,2,1.0,1,1,0,0,0,0,0
1125,5.550150212119608,5.115459643158258,5.741511613714929,4.863293518038357,5.500805006307714,6.223776492418027,5.6088408453791745,714748.225490196,4,E01001146,2,7,4,5,8,6,5.591826634179978,5.245401119050525,5.670875930786133,5.016566562652588,5.447936286245073,6.061491466703869,5.486457836060297,907765.1904761905,5,5,6,6,6,6,3,1.0,1,3,-1,2,1,-2,-3
1126,5.510771167480339,5.304289049011166,5.669191512010865,4.908973558474395,5.457243509211783,6.041619523096893,5.572573163751828,716664.3220338983,3,E01001147,5,5,5,4,5,5,5.339456905448247,5.375394632892003,5.634540821824755,5.017625153064728,5.289301555308085,5.967876203476437,5.530915204494718,910004.1031746032,2,7,5,6,2,4,4,1.0,-1,2,0,1,-2,-1,-1
1127,5.707960925550542,5.17887876685868,5.656188477817763,4.8835903823885145,5.450453010379759,6.177557619208963,5.57931175802508,715202.0341880342,6,E01001148,3,5,5,4,7,5,5.6411687726648445,5.195986648910066,5.676894208304902,4.894023532541389,5.438897925564366,6.099564833518786,5.514182384197529,907830.3931623931,6,4,6,3,6,7,3,1.0,0,1,1,-2,2,0,-2
1128,5.806261977979115,5.128670111298561,5.653534463473728,4.810981370508671,5.512933701276779,6.186467609235218,5.636788743947234,710337.6607142857,7,E01001149,2,5,3,5,8,6,5.679734231187747,5.2085979878902435,5.5593642844603615,4.943326765528092,5.443951902481226,6.031772386569243,5.459661507835755,902363.875,6,5,4,4,6,6,3,1.0,-1,3,-1,1,1,-2,-3
1129,5.864096656726424,5.177528290991571,5.592762009353395,4.801052903673451,5.554924703707361,6.045456365415245,5.610626276131648,710511.9044585987,7,E01001150,3,4,3,6,5,6,5.744024064265141,5.147516825572163,5.649617217835926,4.840451150524373,5.468015244217957,5.948841430702988,5.613112805651969,902527.9931972789,7,4,5,2,7,4,5,1.0,0,1,1,-1,1,-1,-1
1130,5.563364561527006,5.210211950925089,5.627682024432767,4.808916891774824,5.476571806015507,6.157355375828281,5.5445807297383585,715964.7741935484,4,E01001151,4,5,3,4,7,5,5.387877152516292,5.3378169944143705,5.4463710479247265,5.075691601150056,5.321525529918508,6.022766887632191,5.537124357671819,909345.5897435897,3,7,2,7,3,6,4,1.0,-1,3,-3,4,-1,-1,-1
1131,5.447869274967401,5.153142535409262,5.695929268533869,4.894891348920127,5.443104653395424,6.016652329023494,5.514149796131045,715253.2635658914,3,E01001152,3,6,5,4,5,4,5.398198865890503,5.160815605163574,5.6454982147216795,5.036663869857788,5.33138610458374,5.892486421585083,5.460997199058533,908479.584,3,4,5,6,3,3,3,1.0,0,1,-1,1,-1,-2,-1
1132,5.81704439591924,5.089780330657959,5.838000522841007,4.7093243183345965,5.574137772988836,6.2847121702421695,5.652708599326807,714197.5779816514,7,E01001153,2,8,1,7,9,7,5.73680063127314,5.000096097733211,5.764829374054103,4.840911997174754,5.542403461863693,6.182539798681018,5.601076370304071,907131.9029126214,7,1,7,2,8,8,5,1.0,0,-1,-1,1,1,-1,-2
1133,5.417374695373686,5.168685072305187,5.611262330945754,5.023721338897351,5.360754181217674,5.9578035856714315,5.383618768477282,713179.0463576159,2,E01001154,3,5,7,2,4,2,5.3747386189474575,5.1520082319992175,5.675446293492248,5.096127727757329,5.259205485599629,5.8756793720134795,5.389050519120866,905661.5942028986,2,4,6,7,2,3,1,1.0,0,1,1,0,0,-1,-1
1134,5.27289540313539,5.2402850468953455,5.6399441333044145,5.129312388102213,5.249275879632859,5.83316593851362,5.293797166006906,714816.3428571429,1,E01001155,4,5,8,0,2,1,5.1699963020241775,5.267220062794893,5.527194898024849,5.1804666094158005,5.191374467766804,5.732218790054321,5.313052088281383,907873.2869565217,0,6,3,8,1,1,1,1.0,-1,2,-2,0,1,-1,0
1135,6.073833132547046,5.264170977804396,5.582435193515959,4.651730511869703,5.753684255811903,6.130724905029176,5.709052232522813,633604.8571428572,9,E01001156,5,4,0,9,7,7,5.940134419997533,5.323038238286972,5.531218792001407,4.787788007656733,5.606390184164047,6.038045817613602,5.601596832275391,803303.2666666667,9,7,3,1,9,6,5,1.0,0,2,-1,1,0,-1,-2
1136,5.68855910510132,5.238791798807911,5.582478072225433,4.844550334301191,5.572986927229104,6.121750558774496,5.632543291627746,650279.2371134021,5,E01001157,4,4,4,7,7,6,5.35959405529088,5.257089673445143,5.533084976262059,5.057487870084828,5.353633608283667,6.083258291770672,5.6989616093964415,832450.3965517242,2,5,3,6,4,7,7,1.0,-3,1,-1,2,-3,0,1
1137,5.664164456077244,5.11699320440707,5.613393051727958,4.926743224392767,5.501531058809031,6.037581879159679,5.440843998867533,685440.1217391305,5,E01001158,2,5,5,5,5,3,5.4983165254277635,5.081840229428504,5.612730771056877,4.944525017226038,5.503291827588042,6.004370854905814,5.466499078372293,872054.5371900826,4,2,5,4,7,5,3,1.0,-1,0,0,-1,2,0,0
1138,5.874817722248581,5.3208958562814965,5.559389831322544,4.710045669438704,5.675783238320981,6.113655027353539,5.655835334984761,636989.9858490566,7,E01001159,6,4,1,9,7,7,5.633144610904042,5.165010245970493,5.627796936529288,4.907947749053876,5.526113302596492,6.112696820590163,5.740661093608085,808174.4352331606,6,4,5,3,8,7,7,1.0,-1,-2,1,2,-1,0,0
1139,5.439598183723012,5.308150923935471,5.625436278665141,4.939505750206625,5.473955808931096,6.035841325286087,5.419299913060134,671787.5796178344,2,E01001160,5,5,6,4,5,3,5.190579749797952,5.325633818527748,5.465981197357178,5.126511279467879,5.218258060258011,5.88099836316602,5.548333480440337,867146.0137931034,1,7,2,8,1,3,4,1.0,-1,2,-3,2,-3,-2,1
1140,5.588653616832964,5.371582049312013,5.550834709947759,4.850288752353553,5.522625303629673,6.162651708631804,5.583570960796241,691693.5681818182,4,E01001161,6,4,4,6,7,6,5.362230498215248,5.524912284982616,5.406874737246283,5.063516624220487,5.366349624765331,6.051960660671366,5.568121674143035,876115.0,2,9,1,7,4,6,4,1.0,-2,3,-3,3,-2,-1,-2
1141,5.863292645202594,5.306061750047662,5.554850582326396,4.751152447770151,5.6079496701111955,6.112383987126726,5.623493822103136,631014.9213483146,7,E01001162,5,4,2,7,7,6,5.655583792823856,5.271318507396568,5.5866648140600175,4.8943071688635875,5.3983714600740855,6.023800645844411,5.53130439075373,795957.6991525424,6,6,4,3,5,6,4,1.0,-1,1,0,1,-2,-1,-2
1142,5.68542931424944,5.2242191920154974,5.580861010049519,4.770831188873241,5.530899759970214,6.099762477372822,5.619891820769561,633833.7302631579,5,E01001163,4,4,2,6,6,6,5.566085446352339,5.2384184444018,5.6360296879784535,4.82324078258148,5.406185763030402,6.029904023402155,5.553163615997228,800948.0395480226,5,5,5,2,5,6,4,1.0,0,1,1,0,-1,0,-2
1143,5.757745575638457,5.056200365114479,5.712333640572745,4.756265784109105,5.55173883091804,5.961134102091443,5.513313994727321,569435.2569832403,6,E01001164,2,6,2,6,4,4,5.708148926060375,5.0080839029172575,5.756507503695604,4.845778856044863,5.49320358067024,5.9678845859155425,5.5298128721190665,727205.668292683,7,2,7,2,7,4,4,1.0,1,0,1,0,1,0,0
1144,5.632145503352832,5.2276325783977615,5.64169437347809,4.927770057854625,5.486652392183425,6.071249887433355,5.532117162825744,644118.0057803468,5,E01001165,4,5,5,5,6,5,5.432264848128377,5.180147942218035,5.574297036538577,5.08101035296584,5.3614567198566885,5.899276720078964,5.352031069094909,818361.3407821229,3,4,4,7,4,3,1,1.0,-2,0,-1,2,-1,-3,-4
1145,5.351063070799175,5.350306011501112,5.485810722802815,5.041109856178886,5.324430466325659,5.784267695326554,5.303268298349883,719372.3157894737,2,E01001166,6,3,7,1,1,1,5.365253918700748,5.307262357186388,5.461054061298017,5.1885894327252,5.268634573177055,5.778727304052423,5.270964953634474,913478.9675925926,2,6,2,8,2,1,0,1.0,0,0,-1,1,1,0,-1
1146,5.564247587510141,5.340134833131769,5.507973436939761,5.001232819803526,5.408453684891282,5.976474482634851,5.501054984617057,588130.3616236162,4,E01001167,6,3,7,3,4,4,5.456204484936386,5.226033597885565,5.531433860195122,4.982281593574728,5.30792718866597,5.939290039515416,5.5771002027900725,749861.4715719064,3,5,3,5,3,4,5,1.0,-1,-1,0,-2,0,0,1
1147,5.634771288257756,5.194664668546964,5.552440146877341,4.9044348262760735,5.460857391357422,5.989912707511693,5.493833468384938,671000.3287671233,5,E01001168,3,4,5,4,4,4,5.520230353278602,5.259118037735856,5.559029431951126,4.984339380424295,5.34574225204903,5.914338046272329,5.464010666680816,856595.9127516778,4,5,4,5,4,3,3,1.0,-1,2,0,0,0,-1,-1
1148,5.717932734826599,5.464329225848419,5.436766135572183,4.8453184089275325,5.535903996289378,6.100963174694717,5.53015263152845,719840.6818181818,6,E01001169,8,2,4,6,6,5,5.553594432254829,5.298152207738102,5.521421377021487,4.860932410353481,5.354089603565707,6.062768901928817,5.466913102286877,914037.6732673268,5,6,3,2,4,6,3,1.0,-1,-2,1,-2,-2,0,-2
1149,5.804836525473484,5.179302115773046,5.62004829377167,4.824525750884714,5.572547761044761,6.005777597427368,5.618887002153914,718725.1472868217,7,E01001170,3,5,3,7,5,6,5.737938022613525,5.243115663528442,5.5614622097015385,4.930074388504028,5.42486155128479,6.002029335021972,5.554097328186035,912665.984,7,5,4,4,6,5,4,1.0,0,2,-1,1,-1,0,-2
1150,5.98605611258083,5.267008512384361,5.689529506696595,4.747713820801841,5.715672487186061,6.143822292486827,5.686794385313988,719164.6388888889,8,E01001171,5,6,2,9,7,7,5.8110396277373,5.373015805414528,5.6148304711481565,4.881717823872901,5.449752345965926,6.070927468075115,5.613332821305391,913223.9171974523,8,7,5,3,6,7,5,1.0,0,2,-1,1,-3,0,-2
1151,5.202580003478807,5.577207077540094,5.235690543849693,5.160854315689437,5.190605287565543,5.754188066567254,5.2640279128421685,628564.5644699141,0,E01001172,9,0,9,0,1,1,5.113158220166406,5.464936031957413,5.301191107778523,5.282155654735721,5.065610805064521,5.73896004393575,5.2583941503831415,793203.1307901908,0,9,0,9,0,1,0,1.0,0,0,0,0,0,0,-1
1152,5.96792989595495,5.370085539597489,5.468363337784317,4.741753274851506,5.704102362736617,6.062001560387438,5.653647408627047,722434.594059406,8,E01001173,6,2,2,9,6,7,5.8590240353231975,5.333585703448885,5.453412873350131,4.870550160575065,5.410389676974837,6.073004296630811,5.587780167342751,916589.6847133758,8,7,2,3,5,7,5,1.0,0,1,0,1,-4,1,-2
1153,5.591556124646088,4.992063794670434,5.776927437247901,4.769132212318223,5.4734629125430665,6.228533378962813,5.500510285640585,675343.9224137932,4,E01001174,1,7,2,4,8,4,5.517165021140976,5.004971994031774,5.732385607049016,4.968614931153779,5.186958007293172,6.160164422327929,5.7437079460314004,861606.9603960396,4,1,7,5,1,8,7,1.0,0,0,0,3,-3,0,3
1154,5.656217299974882,5.034175571722862,5.737513484098972,4.8096277346977825,5.42819384428171,6.185340208884997,5.62371272001511,716951.6666666666,5,E01001175,1,7,3,3,8,6,5.395077353365281,5.105862466026755,5.705173136206234,5.0171935698565315,5.231764799005845,5.93621041914996,5.423823767549852,910464.5411764706,3,3,6,6,1,4,2,1.0,-2,2,-1,3,-2,-4,-4
1155,5.434277501419513,5.312123143759957,5.52631162552938,5.060311628084113,5.264906656132998,5.981035622367023,5.545792423025535,543136.795620438,2,E01001176,5,3,8,1,4,5,5.304489783792688,5.2406607698274135,5.539413001713337,5.075598849546189,5.2101047831093705,5.930522470666258,5.543526311048725,687071.7718120805,2,5,3,7,1,4,4,1.0,0,0,0,-1,0,0,-1
1156,5.240819602230795,5.425086982109967,5.46248740308425,5.10490238199047,5.266289041712393,5.8496734457078325,5.240817154155058,284879.60130718956,1,E01001177,7,2,8,1,2,1,5.2068126091378275,5.296179663928258,5.43822927488757,5.219509980582089,5.082192511227778,5.820334768019659,5.434736887843623,360202.3583815029,1,6,2,9,0,2,2,1.0,0,-1,0,1,-1,0,1
1157,5.588721564837864,5.185877028320517,5.628045620662825,4.891900850193841,5.516825399228504,6.088380130273955,5.6122729533485005,708102.5267857143,4,E01001178,3,5,5,5,6,6,5.393847407275484,5.275872997655213,5.577762632879592,5.151859673834939,5.276053622478747,5.899575477338019,5.504350667691413,899344.2366412213,3,6,4,8,2,3,3,1.0,-1,3,-1,3,-3,-3,-3
1158,5.4349743658953376,5.176911233675362,5.571524032271735,4.8110867974781755,5.418588761055823,6.036574724877235,5.5062194307251735,554447.2970297029,2,E01001179,3,4,3,3,5,4,5.2889659881591795,5.07458714355122,5.558132017742504,4.935803819786418,5.157783119245009,5.955460401014848,5.489762748371471,705790.1363636364,1,2,4,4,0,4,3,1.0,-1,-1,0,1,-3,-1,-1
1159,5.205082010477781,5.284121574833989,5.524946974590421,5.059822569601238,5.230406679213047,5.898528695106506,5.424420851282775,486834.5234375,0,E01001180,5,3,8,0,3,3,5.159358724729339,5.188076391148923,5.532969419635943,5.142466341381643,5.0800756669756195,5.752750950073128,5.349899328466671,625837.5895522388,0,4,3,8,0,1,1,1.0,0,-1,0,0,0,-2,-2
1160,5.341119530154209,5.243687428680121,5.5708388580995445,5.018254961453232,5.326974686454324,5.891610755639918,5.464152661024356,679138.0784313725,1,E01001181,4,4,7,1,3,3,5.295142641521635,5.19886614822206,5.639914535340809,5.124932855651492,5.288370403789338,5.8787258420671735,5.3737771613257275,871980.2857142857,1,4,5,8,2,3,1,1.0,0,0,1,1,1,0,-2
1161,5.72325337462955,4.943924868106842,5.8694578382703995,4.76094958782196,5.532017536958059,6.2718693017959595,5.537816446357303,677158.4222222222,6,E01001182,1,8,2,6,8,5,5.55125979108548,4.938636709790711,5.725878107438394,4.889255891152478,5.280076103472928,6.064247301959116,5.538301590385787,886264.2201834862,5,1,7,3,2,6,4,1.0,-1,0,-1,1,-4,-2,-1
1162,5.45923531985452,5.056376076759176,5.719810893349614,4.914366637561338,5.452061109509028,6.007447936010699,5.395503552247447,717551.5531914893,3,E01001183,2,6,5,4,5,2,5.242532977574988,5.05004046687597,5.68416135220588,5.067240321937995,5.225706657276878,5.934180458889732,5.41610003573985,911495.6455696203,1,2,6,7,1,4,2,1.0,-2,0,0,2,-3,-1,0
1163,5.7480947106749145,5.142666518033206,5.765609264373779,4.809859133028722,5.579372998122331,6.301690002064128,5.587952089833689,699626.7252747252,6,E01001184,3,7,3,7,9,6,5.592201642990112,5.06405357837677,5.591298507054646,4.9385094006856285,5.392121003468831,6.245022741953532,5.862039165496826,866392.7866666666,5,2,4,4,5,9,9,1.0,-1,-1,-3,1,-2,0,3
1164,5.730448752016454,5.323700705608288,5.542971114178638,4.763010468516317,5.543350674889305,6.095352898110876,5.445422707737743,329834.6993006993,6,E01001185,6,3,2,6,6,3,5.735877254803976,5.172880601088206,5.631511454582214,4.817671910127004,5.418233119646708,6.073036815325419,5.538356932004293,423658.7733333333,7,4,5,2,6,7,4,1.0,1,-2,2,0,0,1,1
1165,5.513170465534809,5.191381265135372,5.622663869577296,4.934014056243148,5.4269276062647505,6.01974010701273,5.54175965458739,329850.96078431373,3,E01001186,3,5,5,3,5,5,5.351245539692732,5.2286528165523825,5.635209138576801,5.033853253492942,5.213279687441313,5.9226740667453175,5.580874576018407,423616.0,2,5,5,6,1,4,5,1.0,-1,2,0,1,-2,-1,0
1166,5.651730558765468,5.33122916274996,5.546293434812061,4.847836447295858,5.495922092181533,6.124015550115216,5.5949336103538965,334233.94029850746,5,E01001187,6,4,4,5,7,6,5.452534763129441,5.171930677407271,5.553806516674015,4.959207479770367,5.326011592691595,6.068225857261178,5.581235121180128,432191.67132867133,3,4,4,4,3,7,5,1.0,-2,-2,0,0,-2,0,-1
1167,5.29467197512904,5.363080475347262,5.495165762326396,4.981660126794314,5.284463189172406,5.912524106654715,5.316807276813696,330314.7943262411,1,E01001188,6,3,6,1,3,1,5.128192647928145,5.338535287031314,5.499846020122853,5.180611265141789,5.167137197604993,5.815258847504127,5.404230490690324,424203.18292682926,0,7,3,8,0,2,2,1.0,-1,1,0,2,-1,-1,1
1168,5.833205323393752,5.097038049523423,5.783743262290955,4.63220696332978,5.496214302574716,6.418377361646512,5.652551841445085,329182.9756097561,7,E01001189,2,7,0,5,9,7,5.621766964594523,5.112732169174013,5.7563506080990745,4.804638774622054,5.339464082604363,6.223942390510014,5.653465591725849,422778.10714285716,6,3,7,1,3,9,6,1.0,-1,1,0,1,-2,0,-1
1169,5.539471087455749,5.367904753684997,5.6075759649276735,4.828684245347977,5.481134879589081,6.188805294036865,5.447707682847977,329577.37,4,E01001190,6,5,3,5,8,3,5.389162419971667,5.150173612644798,5.54677455299779,4.976381388463472,5.195024829161794,5.926720423447458,5.397360761542069,423233.2842105263,3,4,3,5,1,4,2,1.0,-1,-2,-2,2,-4,-4,-1
1170,5.407726392343447,5.180145884489084,5.676773597667744,5.00476936241249,5.433780070249137,5.9187557310253,5.433500859644506,330052.8831168831,2,E01001191,3,6,7,3,3,3,5.368050701524082,5.074084137615404,5.667467363570866,5.052430861090359,5.315638879412099,5.922561684721394,5.427486586727594,423861.86842105264,2,2,6,6,3,4,2,1.0,0,-1,0,-1,0,1,-1
1171,5.416873172294995,5.203982744335143,5.62656088899975,4.894627536623931,5.400878664875819,5.99935971015741,5.4125840299385635,329343.3966942149,2,E01001192,4,5,5,3,5,3,5.387791041779307,5.12950455298466,5.625759569944534,4.976426380925474,5.279431977103242,5.887554021008246,5.459015554031439,422932.0,3,3,5,5,2,3,3,1.0,1,-1,0,0,-1,-2,0
1172,5.37888050831116,5.458670398136517,5.414880696717684,5.089568086572595,5.337086752728299,5.880671541970055,5.427398372340846,331390.8198198198,2,E01001193,8,2,8,2,3,3,5.336436068018277,5.274846097826957,5.437492990493775,5.173511387904485,5.289588904380798,5.949697597821554,5.545802638928095,425508.1666666667,2,6,2,8,2,4,4,1.0,0,-2,0,0,0,1,1
1173,5.731926395182024,5.122107381360573,5.7343398688132305,4.726281295742905,5.469668617374019,6.2468244757568625,5.539921109090772,329060.5701754386,6,E01001194,2,6,2,4,8,5,5.573005151748657,5.037600208365399,5.676393392811651,4.849756088464156,5.323298721728118,6.134148409055627,5.644860410690308,422632.4,5,2,6,2,3,8,6,1.0,-1,0,0,0,-1,0,1
1174,5.8565597683940105,5.34608935411252,5.593548919687319,4.835973733633607,5.544414576573588,6.22280440138812,5.741270037751701,419167.1557788945,7,E01001195,6,4,4,6,8,8,5.658823385238647,5.317143954634666,5.507171478271484,4.93314681828022,5.45943412065506,6.078492064476013,5.628902547359466,535032.645,6,6,3,4,7,7,6,1.0,-1,0,-1,0,1,-1,-2
1175,5.4714893039067585,5.337834856510162,5.524813260237376,4.949363152186076,5.41836340824763,5.886629146734873,5.390372298558553,417902.44,3,E01001196,6,3,6,3,3,2,5.450813868771428,5.257928742385059,5.559997526755244,5.113464781216213,5.357662925068636,5.86320830502125,5.536202452197578,533484.9068322981,3,5,4,7,4,2,4,1.0,0,-1,1,1,1,-1,2
1176,5.926611283074127,5.208283980199896,5.768726686027152,4.725873367186704,5.611497621594762,6.197085686256549,5.84633453272603,421618.28220858896,8,E01001197,4,7,2,8,8,9,5.848919379497003,5.17696184312512,5.735919145766847,4.8811310808101815,5.433014948211031,6.1440235012305715,5.842027681316444,538352.8383233533,8,4,7,3,6,8,9,1.0,0,0,0,1,-2,0,0
1177,6.271203648913038,4.783368617623717,6.120819510994377,4.506504922122746,5.7159419898148425,6.519572569773747,5.81330650979346,419151.5934065934,9,E01001198,0,9,0,9,9,9,6.018742801083459,4.835181105136871,6.164239833090041,4.632152097755008,5.58619528081682,6.418336719936795,5.8108778635660805,535081.2,9,0,9,0,9,9,8,1.0,0,0,0,0,0,0,-1
1178,5.954403636330053,4.917221974071704,6.03371064035516,4.653224628850033,5.663321921699925,6.361298661482961,5.805894184112549,421132.0,8,E01001199,0,9,1,8,9,8,5.931915337496465,4.995138150630611,6.003549502627684,4.636625605054421,5.583931989008837,6.258974533269901,5.818002529663615,537889.6732673268,9,1,9,0,9,9,8,1.0,1,1,0,-1,1,0,0
1179,5.925815430847374,5.015651500976838,5.963775323317932,4.6668162786208836,5.644601667249525,6.281283200324118,5.746197878777444,424019.4954954955,8,E01001200,1,9,1,8,9,8,5.830359134353509,4.992730530370183,5.924168608769649,4.75031885179151,5.403834721621345,6.138228005721789,5.625389798348691,541359.0168067227,8,1,9,1,5,8,6,1.0,0,0,0,0,-3,-1,-2
1180,6.198901559888702,4.921016369898295,6.081634344513883,4.545351651525989,5.667365681264818,6.4760732871969955,5.924625676931794,423724.40206185565,9,E01001201,0,9,0,8,9,9,6.127581126762159,4.874318152967126,5.912362390094334,4.584883668205955,5.493841744432546,6.4085581760213834,5.933224625057644,540976.6262626263,9,0,9,0,7,9,9,1.0,0,0,0,0,-1,0,0
1181,5.735635457294328,4.97661035827228,5.906165171946798,4.789341117654528,5.609630769916943,6.080488896795681,5.637977845966816,424176.73214285716,6,E01001202,1,8,3,7,6,6,5.720910411221641,4.929524326324463,5.799118556295123,4.848754952635084,5.481583589315415,6.019024365288871,5.59471892118454,541539.9,7,1,8,2,7,6,5,1.0,1,0,0,-1,0,0,-1
1182,5.652215521510055,4.9681732669109255,6.023232044243231,4.759254829185765,5.514341786140349,6.001737109044703,5.525491217287575,424305.0975609756,5,E01001203,1,9,2,5,5,5,5.577350952795574,4.872115813550495,5.875061148688907,4.848017090842838,5.489668871675219,5.901639356499627,5.490594042198999,541715.75,5,0,8,2,7,3,3,1.0,0,-1,-1,0,2,-2,-2
1183,6.054897908746761,5.081354427511674,5.8432877272585015,4.6110127607401274,5.63642483645112,6.422081026717694,5.802027170675514,424083.09489051095,9,E01001204,2,8,0,8,9,8,5.891744700793562,5.033501573266654,5.763940531631996,4.806995102454876,5.517283535003662,6.294297927001427,5.772865160580339,541509.7862068965,8,2,7,1,8,9,8,1.0,-1,0,-1,1,0,0,0
1184,5.786399031733419,5.4326211004466805,5.47419841996916,4.787310953978654,5.6669498433123575,6.0876852837237685,5.50228969343416,427647.978021978,6,E01001205,7,2,3,8,6,4,5.48825391934764,5.2884675427790615,5.330207187321879,5.060350985296311,5.295260009265715,5.880715092343669,5.439024370524191,547463.9032258064,4,6,1,7,2,3,2,1.0,-2,-1,-1,4,-6,-3,-2
1185,5.834746436492817,5.28777671504665,5.470826822358209,4.7401958671776026,5.506674714990564,5.967322107907888,5.439446070709744,438131.36486486485,7,E01001206,5,2,2,5,4,3,5.403150863590694,5.295177056675866,5.40960739340101,5.002759235245841,5.264381692523048,5.765899483646665,5.371801200367155,560350.7857142857,3,6,1,5,2,1,1,1.0,-4,1,-1,3,-3,-3,-2
1186,6.166654419090788,5.023600120665663,5.958245297609749,4.576114777791298,5.6683986166776235,6.367644277669616,5.7838998760207225,425567.76271186443,9,E01001207,1,9,0,8,9,8,5.965976474596107,5.0162187555561895,5.88446920229041,4.725468851172406,5.410916772096053,6.318572946216749,5.816968969676806,543284.2173913043,9,2,8,0,5,9,8,1.0,0,1,-1,0,-3,0,0
1187,6.031632925913884,5.218682164412279,5.6999250943844135,4.732978598888104,5.603713477574862,6.273851203918457,5.649181105540349,427709.08461538464,8,E01001208,4,6,2,7,8,7,5.743193211262686,5.106790419210467,5.71122858398839,4.851498018231308,5.413061086545911,6.178109321677894,5.740669941693022,544761.4210526316,7,3,6,2,5,8,7,1.0,-1,-1,0,0,-2,0,0
1188,6.2030217426794545,5.006332343595999,6.087099481511999,4.5374268381683915,5.729939933176394,6.544336762251677,5.839524240846987,421210.77037037036,9,E01001209,1,9,0,9,9,9,5.938026785850525,5.0420246961101,5.9106820584922435,4.7168503573398715,5.528244300393869,6.300171395011295,5.773861041921654,537879.8476821192,9,2,9,0,8,9,8,1.0,0,1,0,0,-1,0,-1
1189,5.691740736728761,5.43271048185302,5.493712377742054,4.877106502773316,5.498262201867452,6.0590416532221845,5.47996151350378,436187.9105691057,5,E01001210,7,3,4,5,6,4,5.579774568681003,5.348835745636298,5.42268290973845,4.979222407146376,5.34765410017805,5.92167617512398,5.482560740847166,556992.693877551,5,7,1,5,4,4,3,1.0,0,0,-2,1,-1,-2,-1
1190,6.167721847965293,5.087693533668779,5.905602711520783,4.560049872692317,5.761825963242413,6.264653705570796,5.748243193103843,421795.2876712329,9,E01001211,2,8,0,9,8,8,5.871522806308888,5.070578703909744,5.791752569469405,4.761077792556198,5.520436096338578,6.139761411113503,5.744917417749947,538596.8703703703,8,2,8,1,8,8,8,1.0,-1,0,0,1,-1,0,0
1191,6.039307794318749,5.268835233954283,5.6764295525275745,4.6330710632296705,5.576905460311816,6.142375913950113,5.700789577112748,422159.8125,9,E01001212,5,6,0,7,7,7,5.866792270872328,5.24299233118693,5.646136651568942,4.784194881651136,5.527421836853027,6.042320969899495,5.653302052815755,539067.7022222222,8,5,5,1,8,6,6,1.0,-1,0,-1,1,1,-1,-1
1192,5.467312705516815,5.25711223244667,5.76409681558609,4.908761740922928,5.409965345859527,6.196939787864685,5.668338222503662,441593.43,3,E01001213,4,7,5,3,8,7,5.445775567293167,5.179152830839157,5.677802374362946,4.880002868175507,5.337567743062973,6.098196732997894,5.620782957077027,564507.91,3,4,6,3,3,7,5,1.0,0,0,-1,-2,0,-1,-2
1193,5.400868120899907,5.248797620667352,5.65105433817263,5.011332977259601,5.386730447521916,6.018589961087263,5.651452757694103,441601.3703703704,2,E01001214,4,5,7,3,5,7,5.267400514475907,5.2070215804667415,5.642105366610274,5.074077730691886,5.281076152867909,5.996728305575214,5.694694565066809,564465.1202531646,1,5,5,7,2,5,7,1.0,-1,1,0,0,-1,0,0
1194,5.487224423367044,5.202557649819747,5.663413458285125,4.9364938860354215,5.3642945434736165,5.99546130221823,5.556709434675134,441350.38260869565,3,E01001215,4,5,6,2,4,5,5.437747721014352,5.117300172304285,5.618013046938797,4.953108076391549,5.356616305893865,5.959614359099289,5.533565001241092,564084.8448275862,3,3,5,4,4,4,4,1.0,0,-1,0,-2,2,0,-1
1195,5.452205538749695,5.3251583984023645,5.531238951181111,4.958589249535611,5.378069311903234,5.924944543001945,5.578886973230462,441613.6140350877,3,E01001216,6,3,6,2,3,5,5.391223050397018,5.300677787640999,5.500257532144415,5.084822677332779,5.243809451316965,5.935727263319081,5.713440904329563,564358.7672413794,3,6,3,7,1,4,7,1.0,0,0,0,1,-1,1,2
1196,5.398494411831253,5.405218757003363,5.626971489081353,5.00088259632602,5.433863835100747,5.9656785338934215,5.490620155275965,442724.0552147239,2,E01001217,7,5,7,3,4,4,5.147540102276621,5.327694023711772,5.5882464104060885,5.156518377080748,5.262563779384275,5.85700261592865,5.482556862167165,565541.2025316455,0,7,4,8,2,2,3,1.0,-2,0,-1,1,-1,-2,-1
1197,5.46560983936282,5.392910315172515,5.564908884737614,4.9554667864402715,5.376658104632023,5.937449186387723,5.349698219856206,443046.3284671533,3,E01001218,7,4,6,2,3,2,5.44199068804045,5.403587045701775,5.439793024514173,5.072367291192751,5.300866936509673,5.8762575162423625,5.321539690365663,566070.5135135135,3,8,2,7,3,3,1,1.0,0,1,-2,1,1,0,-1
1198,5.322713884632145,5.546785907407777,5.3346434768322295,5.060487106838058,5.325724400250258,5.833475684697649,5.380344857156804,443663.78761061945,1,E01001219,9,1,8,1,2,2,5.187453236665812,5.444127950582418,5.339259214229412,5.120050767520526,5.183099393372063,5.817933506793804,5.354192134496328,567279.1981981982,0,8,1,8,1,2,1,1.0,-1,-1,0,0,0,0,-1
1199,5.339232001878038,5.496259598792354,5.326371260836154,5.042941061001789,5.243811452690559,5.723477005958557,5.295605129833463,443479.59493670886,1,E01001220,8,1,7,0,1,1,5.41774755242196,5.460989328270609,5.3080269734967835,5.071122734384104,5.2036827822977845,5.72728628191081,5.3558007336475635,567005.4772727273,3,8,0,7,1,1,1,1.0,2,0,-1,0,1,0,0
1200,5.820142339734198,4.864706953173703,6.001856438164572,4.7086028207853,5.597294227590838,6.130464102458028,5.72189137831475,426062.91747572814,7,E01001221,0,9,1,7,7,7,5.764317010862255,4.842998301281648,5.911065207347611,4.850718665986039,5.489934544757481,6.045367969107304,5.6974577385915355,543910.3031674208,7,0,9,2,7,6,7,1.0,0,0,0,1,0,-1,0
1201,5.736144691441966,5.000535839426834,5.865028980558953,4.7861094073911685,5.531635491193923,6.083837180011041,5.632363374254345,426402.5398230089,6,E01001222,1,8,3,6,6,6,5.484671241603792,5.061023368500173,5.773889092728496,4.871658980846405,5.362215073779225,5.93727020919323,5.586937924847007,544048.796875,4,2,7,3,4,4,5,1.0,-2,1,-1,0,-2,-2,-1
1202,6.396043599541508,5.067683063336273,5.945627589723957,4.479367481238806,5.848322854113223,6.328966854223564,5.935634444898634,422452.30597014923,9,E01001223,2,9,0,9,9,9,6.0409747513372505,5.113443593480694,5.749981052839934,4.640724090497885,5.541878459168903,6.186442195479549,5.924298409205764,539396.8805970149,9,3,7,0,8,8,9,1.0,0,1,-2,0,-1,-1,0
1203,6.418093458602303,4.919432168728427,6.088061257412559,4.4547283578860135,5.831689560099652,6.501370039425399,6.059521251603177,422859.2039473684,9,E01001224,0,9,0,9,9,9,6.103280823387785,5.0085533628920595,5.894542027376369,4.6865783194581905,5.658517342127726,6.329746971587221,5.992964404785704,539894.371257485,9,2,8,0,9,9,9,1.0,0,2,-1,0,0,0,0
1204,6.13024081761324,5.068906650513033,5.98027191886419,4.618742643277856,5.712392435798162,6.254209003116511,5.866785070564173,423033.36075949366,9,E01001225,2,9,0,9,8,9,5.904559369520707,5.059644649245522,5.784999052683513,4.8402210372867005,5.4460584351510715,6.07617648153594,5.786388822035356,540211.9393939395,8,2,7,2,6,7,8,1.0,-1,0,-2,2,-3,-1,-1
1205,6.220438676365351,5.179158673448078,5.855584421400296,4.521423267105878,5.700240470595279,6.292874336242676,5.824413755182492,422763.9661016949,9,E01001226,3,8,0,9,9,9,5.979537969285792,5.134441681341691,5.787173182314093,4.6659232768145475,5.53263221654025,6.170958837595853,5.864655206420204,539815.8545454545,9,3,8,0,8,8,9,1.0,0,0,0,0,-1,-1,0
1206,6.325960131578667,4.941634708596754,5.947040886842003,4.555398078851922,5.786064578581226,6.386859420658082,5.93558640627898,423488.8682170543,9,E01001227,1,9,0,9,9,9,5.986041675242343,5.004260674927586,5.849265071772789,4.6648199807765875,5.643729338350222,6.242558009864748,5.812232322471086,540517.9689922481,9,1,8,0,9,9,8,1.0,0,0,-1,0,0,0,-1
1207,6.318610127483096,5.040275962579818,5.977887807857423,4.546608609103021,5.738876161830766,6.375373389039721,5.994081673168001,424132.10714285716,9,E01001228,1,9,0,9,9,9,6.01319725620014,5.020181922939237,5.870469841877175,4.776888397152863,5.5204061722622235,6.231602219895944,5.9067818066261335,541341.6927374302,9,2,8,1,8,9,9,1.0,0,1,-1,1,-1,0,0
1208,5.543500628000424,5.539285746621497,5.411003978164108,4.93459896908866,5.417804805584896,6.047529363337858,5.4130980997909734,200621.63580246913,4,E01001229,9,1,5,3,5,3,5.3281148485390535,5.516643445175815,5.36272509198591,5.1485710409750425,5.221939322460129,5.9109601486160095,5.412197962582829,253800.34939759035,2,9,1,8,1,3,2,1.0,-2,0,0,3,-2,-2,-1
1209,5.977812142267714,5.107305939180137,5.7892801953058175,4.733307418161935,5.634333206789337,6.186183311643392,5.791735542081568,426452.6131386861,8,E01001230,2,7,2,8,8,8,5.775524782967734,5.100535172682542,5.740741489650486,4.903742951113028,5.466162409815755,6.126567503789088,5.716569322806138,544332.4335664336,7,3,7,3,7,7,7,1.0,-1,1,0,1,-1,-1,-1
1210,5.895884855551654,5.214846712103637,5.743839151848296,4.773509947935008,5.604902004866006,6.195021786448043,5.799911978607353,281693.71428571426,7,E01001231,4,7,2,7,8,8,5.847620338602451,5.185006540986989,5.69142612106597,4.925053019694683,5.432093207611631,6.185493113214125,5.803489935237731,354981.0852017937,8,4,6,4,6,8,8,1.0,1,0,-1,2,-1,0,0
1211,5.674454427398412,5.376793958444511,5.467510881677138,4.8361959626189375,5.507183705810952,5.944936340889044,5.529327687963975,355054.77876106196,5,E01001232,6,2,4,5,4,5,5.61828729148223,5.224630906203083,5.530583114267509,5.000194297772702,5.2752066716969575,6.022056528340991,5.647914379556602,462100.2897196262,5,5,3,5,2,6,6,1.0,0,-1,1,1,-3,2,1
1212,5.763761113308094,5.36702460359644,5.681251592989321,4.851609184123852,5.523754635563603,6.0941481590271,5.4231601617954395,199019.15555555557,6,E01001233,6,6,4,6,6,3,5.575015328584179,5.219443677894531,5.608679581073023,4.957804345315503,5.37057420515245,6.038722413201486,5.567991441295993,248867.53225806452,5,5,5,4,4,6,4,1.0,-1,-1,-1,0,-2,0,1
1213,6.277835361419186,5.101263337750589,5.829772939989644,4.523980782108922,5.830439956726567,6.2672365280889695,5.907200365681802,425318.24516129034,9,E01001234,2,8,0,9,8,9,6.124696336040607,5.147005881188233,5.755637750460234,4.724134004874037,5.597037630963188,6.254231192473042,5.804246379460903,542998.0867052024,9,4,7,0,9,9,8,1.0,0,2,-1,0,0,1,-1
1214,6.279087161495738,5.1833865538130715,5.792174178318386,4.544931031491634,5.783360312454892,6.2787063174004105,5.8330060826600905,425518.2481751825,9,E01001235,3,7,0,9,9,9,6.019257714351018,5.183090163347049,5.648139840517288,4.82701562001155,5.542415582216703,6.178266650591141,5.733401324504461,542998.7307692308,9,4,5,2,8,8,7,1.0,0,1,-2,2,-1,-1,-2
1215,6.103396745828482,5.123938227311159,5.867000677646735,4.639718343050052,5.715706684650519,6.338380694389343,5.939812932258997,426425.60256410256,9,E01001236,2,8,0,9,9,9,5.973730694415957,4.996837394182072,5.914601170739462,4.769337156484293,5.611623237299365,6.248225259226422,5.819225919801135,544354.1162790698,9,1,9,1,9,9,8,1.0,0,-1,1,1,0,0,-1
1216,6.243650841456588,5.167127889330669,5.815675244536451,4.533787998460954,5.73293472490003,6.235673735218663,5.938776511017994,425916.20430107525,9,E01001237,3,7,0,9,8,9,6.16764888421018,5.017454671098831,5.815740956270949,4.765343525942336,5.5841538677824305,6.268167609864093,5.851305965413439,543668.659574468,9,2,8,1,9,9,9,1.0,0,-1,1,1,0,1,0
1217,5.215186000306964,5.504250915495904,5.290829712217981,5.25097683759836,5.142782515221899,5.656121751764318,5.277193555901776,417138.71428571426,0,E01001238,8,0,9,0,0,1,5.119268000125885,5.38976176540836,5.380989930988137,5.29581001108768,5.117090677903368,5.674218771504421,5.383908926661498,532501.0065359477,0,8,1,9,0,0,1,1.0,0,0,1,0,0,0,0
1218,5.349872648125828,5.466549118556599,5.320607799704712,5.151293636548637,5.315352732002145,5.698758568504069,5.227894527487235,320228.49504950497,1,E01001239,8,1,9,1,0,0,5.259223905178385,5.466334149924987,5.281667210093332,5.163016264591742,5.194333850790601,5.638170889758189,5.199998540068985,406132.3532110092,1,9,0,8,1,0,0,1.0,0,1,-1,-1,0,0,0
1219,5.673218372818473,5.532548359224013,5.499762321685577,4.879169747546003,5.480662751031089,5.990708612895512,5.441794156194566,267112.2097902098,5,E01001240,9,3,4,5,4,3,5.566207551956177,5.35151820341746,5.511652781963348,4.967196630636851,5.462179978688558,5.971443404356639,5.430400629838307,351069.68,5,7,3,5,7,5,2,1.0,0,-2,0,1,2,1,-1
1220,5.736712783081097,5.411116936588814,5.452126564900519,4.891324343602301,5.479163530123168,5.982393607250235,5.52413188686687,324780.0607734807,6,E01001241,7,2,5,5,4,4,5.710838263013722,5.347822418255088,5.551169711931617,4.953750732725701,5.4133429959812,5.948421114313919,5.553007243481358,416551.41592920356,7,7,4,4,5,4,4,1.0,1,0,2,-1,0,0,0
1221,6.057843758241973,5.116245368101301,5.7912940509127875,4.662415830758366,5.63425000914692,6.243632052066553,5.946860400429608,420069.45255474455,9,E01001242,2,7,1,8,8,9,5.966657891979924,5.1750238153669565,5.783567128358064,4.804403698885882,5.603477566330521,6.217553311807138,5.834292269636084,537934.088888889,9,4,7,1,9,8,8,1.0,0,2,0,0,1,0,-1
1222,5.593177635094215,5.178665219709791,5.494450209469631,4.902824729681015,5.502595217063509,5.97867125786584,5.5134703270320236,254914.3620689655,4,E01001243,3,3,5,5,4,4,5.575872380682763,5.154466715264828,5.640652144208867,4.933599340154769,5.4278509853579475,5.988567463895108,5.609925759599564,328273.8156028369,5,4,5,4,6,5,5,1.0,1,1,2,-1,1,1,1
1223,5.6420651036079486,5.152503029264585,5.64596278739698,4.893469988697707,5.518423617488206,5.930294068172724,5.526773453962924,321658.16161616164,5,E01001244,3,5,5,6,3,5,5.747039294937282,5.146193890895658,5.596268977933717,4.879729827630867,5.429212794720548,6.014586145438037,5.6114762789994765,421524.66019417474,7,4,4,3,6,5,5,1.0,2,1,-1,-2,0,2,0
1224,5.746078143517177,5.065147497256597,5.825936075051626,4.821276824673017,5.48555828332901,6.204412146409353,5.5927102337280905,255228.34166666667,6,E01001245,2,8,3,5,8,6,5.74290064913886,4.894474081482206,5.8610243226800645,4.811749832970755,5.428108781576157,6.18758019890104,5.612729982818876,328702.2428571429,7,0,8,2,6,8,5,1.0,1,-2,0,-1,1,0,-1
1225,5.1123771502239865,5.554850310382276,5.214023993156924,5.275087195752871,5.191208349301084,5.589681536254316,5.037416705695709,380640.12376237626,0,E01001246,9,0,9,0,0,0,5.035730759209057,5.403077418230614,5.282518864521441,5.276667520122708,5.068848696800898,5.547589501963471,5.104011659914592,494032.7358490566,0,8,0,9,0,0,0,1.0,0,-1,0,0,0,0,0
1226,5.141187391801065,5.579242305228837,5.208743336382008,5.2503606944720405,5.147029599466146,5.629030049103746,5.166038561072548,418622.57675753225,0,E01001247,9,0,9,0,0,0,5.048013862335321,5.449075338966919,5.264002151712023,5.2805483049214486,5.089535243733965,5.582402431302601,5.16290558408005,534475.1691919192,0,8,0,9,0,0,0,1.0,0,-1,0,0,0,0,0
1227,5.39756732736315,5.408555457932608,5.417035383496966,5.025657405853272,5.384813483783177,5.7882399559021,5.27429728439876,208127.13714285713,2,E01001248,7,2,7,2,1,1,5.410012560231345,5.325752005472288,5.4794647222036845,5.070143615151499,5.2539985579448745,5.8659196843157755,5.391747756318732,266091.6153846154,3,7,2,7,2,2,2,1.0,1,0,0,0,0,1,1
1228,5.378368703257136,5.086164132887576,5.630075851408374,5.02273330167562,5.3551596443192295,5.876509926900142,5.407982301311333,426700.3025210084,2,E01001249,2,5,7,2,2,3,5.274899530572956,5.14202301761731,5.66487320101991,5.1104550531932285,5.219927207953265,5.735128226734343,5.463392346083713,544628.387755102,1,3,6,7,1,1,3,1.0,-1,1,1,0,-1,-1,0
1229,5.591662166118621,5.209605618715286,5.71976876616478,4.86506899356842,5.494277498722076,6.019427118301391,5.430382760763169,435499.14,4,E01001250,4,6,4,5,5,3,5.463275253772736,5.218653573180145,5.660412571340237,4.983598953148104,5.2467193850931135,5.856351654484587,5.548278282273491,556442.4905660377,4,5,6,5,2,2,4,1.0,0,1,0,1,-3,-3,1
1230,5.8663903505973565,5.06989213454178,5.784664164960774,4.768345056016461,5.5300067546320895,6.134746598262413,5.537728735824037,442954.85620915034,7,E01001251,2,7,2,6,7,5,5.744421896934509,4.974538855552673,5.7246641858418785,4.76499863465627,5.364965511957805,6.094808983802795,5.547799127896627,566176.6133333333,7,1,7,1,4,7,4,1.0,0,-1,0,-1,-2,0,-1
1231,5.625107330264467,5.137462496757507,5.790479496031097,4.8975772041263,5.484869845708212,6.098222884264859,5.3815184390906134,441631.53939393937,5,E01001252,3,7,5,5,6,2,5.564372636086448,5.064753861400668,5.7660640737863895,4.90102263136283,5.328889176166258,6.053081701587698,5.502100293862753,564247.9385474861,5,2,7,3,3,6,3,1.0,0,-1,0,-2,-2,0,1
1232,5.519333830901554,5.306338513748987,5.529991121803011,4.864129854100091,5.362052839142936,5.898711139815195,5.246791912828173,331478.28571428574,3,E01001253,5,3,4,2,3,1,5.544141142121677,5.123978392009078,5.691734881236635,4.883539659401466,5.340990095302977,6.012456440103465,5.549953071824436,431887.6,5,3,6,3,3,5,4,1.0,2,-2,3,-1,1,2,3
1233,5.80758041796023,5.304345276233923,5.693199603226933,4.79747799626232,5.472211736832222,6.0796018516930355,5.4202824030479375,401488.7737226277,7,E01001254,5,6,3,4,6,3,5.603412588159521,5.21019433094905,5.634192125780599,4.886569647522239,5.3308413428860115,5.998072219895316,5.525906835402642,521798.82517482515,5,5,5,3,3,5,4,1.0,-2,0,-1,0,-1,-1,1
1234,6.270240988394226,4.943883720070425,6.1338676226259485,4.494692427943451,5.707068529996005,6.639418286506576,5.996556043624878,361952.64646464644,9,E01001255,1,9,0,9,9,9,6.048324466897891,4.860492596259484,5.9577393921522,4.607754575518461,5.490332429225628,6.485057406700575,6.0177381336688995,457796.9711538461,9,0,9,0,7,9,9,1.0,0,-1,0,0,-2,0,0
1235,5.349227387329628,5.609789460897446,5.231877718506189,5.221681467418013,5.282680801276503,5.776697592488651,5.1883345667658185,432350.275862069,1,E01001257,9,0,9,1,1,0,5.412240161383448,5.434112536020516,5.3460403907397565,5.155022031019542,5.282547035493141,5.899126429203128,5.385432172412715,552256.6198347107,3,8,1,8,2,3,1,1.0,2,-1,1,-1,1,2,1
1236,5.466321568615389,5.376512916672309,5.584498572823228,4.851676734867475,5.447532142234953,6.033682521605334,5.585994448882855,431842.98013245035,3,E01001258,6,4,4,4,5,6,5.439783545463316,5.26249440716159,5.665291595458984,4.953552223020984,5.372264583649174,6.016962657436248,5.573275619937528,551728.7096774194,3,6,6,4,4,5,5,1.0,0,0,2,0,0,0,-1
1237,5.49450470419491,5.334170432651744,5.608437462013309,4.866032449137263,5.457555907113211,6.035105386701953,5.58062756762785,433866.756302521,3,E01001259,6,5,4,4,5,5,5.370749690761305,5.202881261910478,5.662488966772001,5.037294022840996,5.366876378451308,5.956428103251,5.593382897442335,554314.4726027397,2,4,6,6,4,4,5,1.0,-1,-2,1,2,0,-1,0
1238,5.451281224553649,5.3193563367869405,5.608683784265776,4.828884423584552,5.386602788358121,6.089358713175799,5.572518624163963,434558.10135135136,3,E01001260,5,5,3,2,6,5,5.393100462016269,5.203784375501102,5.612164199704955,4.983768818646493,5.334127146816818,5.943099408460086,5.531142325796319,554681.325443787,3,4,5,5,3,4,4,1.0,0,-1,0,2,1,-2,-1
1239,5.346490649924929,5.3496474074897264,5.597816893707813,5.0171571775680075,5.336999939926921,5.897072883954658,5.3391670209195645,436613.22907488985,1,E01001261,6,4,7,2,3,2,5.1646206416483,5.252907798046202,5.545506880039305,5.1176944666021456,5.228578619130953,5.8098925079886365,5.354522629047003,557559.9960629921,0,5,3,7,1,2,1,1.0,-1,-1,-1,0,-1,-1,-1
1240,5.3791859355839815,5.395900262485851,5.438555495305494,4.960083552924069,5.361192605712197,5.922480403293263,5.431020086461848,431592.7454545455,2,E01001262,7,2,6,2,3,3,5.498555263504386,5.292017423547804,5.555949874222279,5.027504615485668,5.376502491533756,5.972302662208676,5.540867586620152,551262.8671875,4,6,4,6,4,5,4,1.0,2,-1,2,0,2,2,1
1241,5.393865514428992,5.692317047244624,5.192973168900139,5.0591377659847865,5.345604587228674,5.741463257764515,5.187403525804219,432026.5315789474,2,E01001263,9,0,8,2,1,0,5.62260816675244,5.52160203396672,5.284857365820143,5.014049828654588,5.421980254577868,5.8279993937473105,5.295291902440967,551810.2070707071,6,9,0,6,6,2,0,1.0,4,0,0,-2,4,1,0
1242,5.4287529025184975,5.494867446047537,5.38426709844825,4.9475751345077255,5.3321893489762635,5.896303148751848,5.411412394448613,431284.8595505618,2,E01001264,8,1,6,1,3,3,5.439070933935594,5.365162090379364,5.492535170243711,4.9361355754793905,5.334369353493866,5.9561494418552945,5.5122217244031475,550832.7397959183,3,7,3,4,3,4,3,1.0,1,-1,2,-2,2,1,0
1243,5.3194627583314835,5.479900603709013,5.372310971868211,5.12058755222726,5.254484389139258,5.793893939630997,5.403769572575887,431022.67149758455,1,E01001265,8,1,8,0,1,2,5.2721641063690186,5.496708107961191,5.374990841289899,5.174547644885811,5.273824889917631,5.8164642480042605,5.380485196908315,550435.3243243244,1,9,1,8,2,2,1,1.0,0,1,0,0,2,1,-1
1244,5.234477169349276,5.442105488941587,5.381177075977983,5.138736666071004,5.20353929585424,5.7890083275992295,5.4679906857424765,430027.2172413793,0,E01001266,7,1,9,0,1,4,5.178657144407102,5.4683075965044905,5.319918503000887,5.30162933023269,5.156883332024381,5.755744566949103,5.4720291410173685,549235.3322259136,0,9,0,9,0,1,3,1.0,0,2,-1,0,0,0,-1
1245,5.384855513591843,5.5566222385230315,5.283633100459853,5.131944939793353,5.277450631900006,5.751676567108277,5.275114956629803,430398.8353413655,2,E01001267,9,0,8,1,1,1,5.3555546683162,5.417102694511414,5.325836302629158,5.177391981455817,5.2221415211905295,5.759402464130032,5.2479919982490255,549676.4813432836,2,8,1,8,1,1,0,1.0,0,-1,1,0,0,0,-1
1246,5.653322300603313,5.408034266323171,5.5325969688354,4.844558046069197,5.443437344284468,6.0620845786986814,5.559939555583462,431097.9569892473,5,E01001268,7,3,4,4,6,5,5.715827869114123,5.3225784452337965,5.5041722222378375,4.912528267659639,5.448511153773258,6.037581776317797,5.65827476288143,550423.0210526315,7,7,3,3,6,6,6,1.0,2,0,0,-1,2,0,1
1247,5.4352205935223346,5.2949610635124404,5.572646478126789,4.951024878127821,5.3747607366792085,5.978322830693475,5.483843277240622,289721.0646551724,2,E01001269,5,4,6,2,4,4,5.382507537758869,5.253629031388656,5.5792665082475414,5.0556780421215555,5.303592216450235,5.9419960954914925,5.49395576145338,387250.93913043477,3,5,4,6,3,4,3,1.0,1,0,0,0,1,0,-1
1248,5.346693136475303,5.386635357683355,5.5161174589937385,5.012689493596554,5.314487579871308,5.951529234647751,5.462317084724253,429504.6306818182,1,E01001270,7,3,7,1,4,3,5.400527769989438,5.2613253189457785,5.68474900258912,5.113770596848594,5.420862854851617,5.952993312146929,5.492749143971337,548705.7944444445,3,5,6,7,6,4,3,1.0,2,-2,3,0,5,0,0
1249,5.49210139620241,5.3607798480482955,5.607046172732399,4.942918693577802,5.402941479254022,6.043768940779267,5.601941457501164,376495.75132275134,3,E01001271,6,5,6,3,5,6,5.4531563107585495,5.228466082444955,5.6344959931972225,4.983271684997526,5.404311106834577,5.964033581993797,5.548541856534554,479005.5541125541,3,5,5,5,5,4,4,1.0,0,-1,0,-1,2,-1,-2
1250,5.374982899320977,5.368441986186164,5.387321658432484,5.134387441511665,5.281150375625917,5.772875766136816,5.32147666439414,430284.28571428574,2,E01001272,6,1,8,1,1,1,5.255390354349643,5.406942845396855,5.315944465403819,5.245027010953879,5.290012097056908,5.72622732271122,5.363358903534805,549477.4345991561,1,8,0,9,2,1,1,1.0,-1,2,-1,1,1,0,0
1251,6.143250089310203,5.129515020418367,5.836262070484241,4.648478868117392,5.775927989552709,6.331767541095303,5.84851799998822,422318.1380753138,9,E01001273,2,8,0,9,9,9,5.8942405403434455,5.15976146598915,5.6853764211976685,4.835946303941471,5.574038907046958,6.136324092423245,5.792576820303351,539297.6536796537,8,4,6,2,9,8,8,1.0,-1,2,-2,2,0,-1,-1
1252,6.476632351676623,5.127012266467015,5.753169701745112,4.5319428114841385,5.87464772661527,6.361997036884229,5.74433237252136,420524.1822916667,9,E01001274,2,7,0,9,9,8,6.172009764430679,5.104822506414395,5.5827637955407114,4.709645409450353,5.520960955976326,6.251864922380893,5.700554983081105,536669.4252336449,9,3,4,0,8,9,7,1.0,0,1,-3,0,-1,0,-1
1253,6.189628221400796,5.127943871772453,5.876251566899966,4.594282027793257,5.7723788708856665,6.276428802372658,5.901958722774297,423027.23287671234,9,E01001275,2,8,0,9,8,9,6.009765121001232,4.981370612790313,5.815392103376268,4.7498204036604,5.585604602777505,6.202516979809049,5.844338459304616,540060.582278481,9,1,8,1,9,8,9,1.0,0,-1,0,1,0,0,0
1254,5.3120290608082,5.474760598928025,5.374133887221512,5.123424631299325,5.269675529118881,5.767893692822132,5.266592351556982,417337.359223301,1,E01001276,8,1,8,1,1,1,5.167921477065974,5.417252368741221,5.294906053192172,5.195241166915729,5.099132391281458,5.678653717041016,5.317339125649753,532679.3852813853,0,8,0,9,0,0,1,1.0,-1,0,-1,1,-1,-1,0
1255,5.432460636149542,5.460398289818618,5.324894005873741,5.121102247397547,5.229191246803093,5.790091159616008,5.43372172233454,419754.4373259053,2,E01001277,8,1,8,0,1,3,5.337903107435276,5.3741304458715975,5.363879959399884,5.151515196531247,5.177868379996373,5.720386361158811,5.375163291662167,536162.7307692308,2,7,1,8,1,1,1,1.0,0,-1,0,0,1,0,-2
1256,5.5760986288981655,5.473969067744354,5.410574049024439,4.983209655533976,5.423850415002054,5.9290360091337515,5.438296394561654,421094.4955223881,4,E01001278,8,1,6,3,3,3,5.493796179941551,5.361692695162404,5.408691057308236,5.111356131095982,5.269322391430936,5.816878491610139,5.3895449937887525,537716.1608040201,4,7,1,7,2,2,1,1.0,0,-1,0,1,-1,-1,-2
1257,6.287442880518296,5.14130947934115,5.999561826175547,4.560483423783817,5.8018923430519305,6.478257991413382,6.000388420839361,421246.35294117645,9,E01001279,3,9,0,9,9,9,5.972254810446785,5.085108743962787,5.732596744809832,4.768896377654302,5.588474635850815,6.291475858007159,5.934254887558165,537904.0333333333,9,3,7,1,9,9,9,1.0,0,0,-2,1,0,0,0
1258,6.089046475622389,5.258492910861969,5.688328756226434,4.654483334223429,5.650486523575253,6.075702423519559,5.635810191101498,421580.63333333336,9,E01001280,4,6,1,8,6,6,5.8764914858799715,5.265449685546068,5.510629507211538,4.749217623701463,5.494908154010773,5.990730370466526,5.599318458483769,538346.5288461539,8,6,3,1,7,5,5,1.0,-1,2,-3,0,-1,-1,-1
1259,6.400113138151758,5.107032091529281,5.921669642130534,4.511735369393855,5.745026723838147,6.423760559823778,5.8884368399043145,421366.1666666667,9,E01001281,2,8,0,9,9,9,6.074660527853318,5.044450016669285,5.821606918617531,4.565178780644028,5.6492361264464295,6.356239424811469,5.911578583128659,538060.3641975309,9,2,8,0,9,9,9,1.0,0,0,0,0,0,0,0
1260,6.005980388871555,5.259337943175743,5.755014914890816,4.667321557628697,5.679487263334209,6.261691730597923,5.77515394523226,437146.4396551724,8,E01001282,4,7,1,9,8,8,5.753007624329639,5.306598470992401,5.570125678006341,4.770917947552785,5.516745216706219,6.058734046310938,5.615893545270968,558511.1512605041,7,6,4,1,8,6,5,1.0,-1,2,-3,0,-1,-2,-3
1261,5.905560359432923,5.218612122891554,5.606256638000261,4.70498300251083,5.579325086441799,6.1721455706885795,5.707982003985353,437422.0497512438,8,E01001283,4,4,1,7,7,7,5.748495805580004,5.29340231682347,5.565464176435386,4.90337658614184,5.457881000189655,5.999881574537902,5.578464557111791,558756.1194690266,7,6,4,3,7,5,5,1.0,-1,2,0,2,0,-2,-2
1262,6.037361075138223,5.0412609542923414,5.814163613593442,4.719477643226755,5.705612474474414,6.383786793412833,5.7884994121803635,439485.2356321839,8,E01001284,1,7,1,9,9,8,5.735781177397697,5.084370507622644,5.7150843885087745,4.868928564308975,5.475283161286385,6.125523395252667,5.66558802072903,561525.267281106,7,3,7,3,7,7,6,1.0,-1,2,0,2,-2,-2,-2
1263,5.866858180876701,5.184089597578971,5.750964210879419,4.718166371314756,5.593719990022721,6.22569246907388,5.738631686087578,439882.0,7,E01001285,3,7,1,7,8,8,5.668429163369265,5.1951053266401415,5.600713158582712,4.8064885410395535,5.475839037399788,6.076821279216122,5.663886898523801,562212.2077922078,6,4,4,1,7,7,6,1.0,-1,1,-3,0,0,-1,-2
1264,5.790943511601152,5.39864221523548,5.602452228809225,4.740362051232108,5.603211587872998,6.185298216753993,5.569809641303687,441390.724137931,7,E01001286,7,4,2,7,8,5,5.456322386741638,5.326902235984802,5.479516901016235,4.953566386222839,5.323329879760742,5.928029518127442,5.466518872261047,563982.928,3,7,2,4,3,4,3,1.0,-4,0,-2,2,-4,-4,-2
1265,5.846902527979442,5.067706992228826,5.74143050681977,4.6992373537449605,5.691257221358163,6.2978888012114025,5.796311818418049,443174.78571428574,7,E01001287,2,7,1,9,9,8,5.66245102423888,5.038464650511742,5.612565546081616,4.877324137550134,5.4621882530359125,6.103262121860798,5.50939780817582,566567.625,6,2,5,3,7,7,3,1.0,-1,0,-2,2,-2,-2,-5
1266,6.082364347792163,5.040174307282438,5.948011779293571,4.636552793463481,5.726341014055862,6.505917782636033,5.7560287001206705,442790.3402061856,9,E01001288,1,9,0,9,9,8,5.96836408774058,4.843715216053857,5.962327278984917,4.656256975067986,5.50941849814521,6.343808356920878,5.88001004325019,566009.2666666667,9,0,9,0,8,9,9,1.0,0,-1,0,0,-1,0,1
1267,6.043541223574907,5.074846174472418,6.000968823066125,4.657417040604812,5.609762908556522,6.431801361915393,5.7185227152628775,442530.4358974359,9,E01001289,2,9,1,7,9,7,5.850062691248381,4.945493696591793,5.956593678547786,4.673901788699321,5.464513818422954,6.308705510237278,5.739310538157438,565674.6538461539,8,1,9,0,7,9,7,1.0,-1,-1,0,-1,0,0,0
1268,6.13811031215919,5.107055218633778,5.8429921786942165,4.590157882182184,5.7081325525295235,6.240386724472046,5.743878908499986,443095.5988023952,9,E01001290,2,8,0,9,8,8,5.934655442422266,5.0872835250190604,5.7147644316952535,4.769174859668668,5.537899637749182,6.152177655235839,5.671163406161313,566421.9392265193,9,3,7,1,8,8,6,1.0,0,1,-1,1,-1,0,-2
1269,5.46272561339294,5.366491110957399,5.607273959789146,4.979716218247706,5.407221108066793,5.944725523189622,5.488274639966536,435809.89795918367,3,E01001291,6,5,6,3,4,4,5.3214143822793245,5.296226041657584,5.650599992194143,5.031084567511162,5.381450387085376,5.8789052638877815,5.401628439118262,556471.7074829933,2,6,5,6,5,3,2,1.0,-1,0,0,0,2,-1,-2
1270,5.464797918309165,5.299759315522336,5.685198470373838,4.858701336449681,5.409252172675581,6.02089069824851,5.51315167134638,436710.6629834254,3,E01001292,5,6,4,3,5,4,5.157230588246365,5.278184777011677,5.537685868083214,5.046872423011429,5.264212281728278,5.801257840224674,5.353140497086,557815.1530612245,0,6,3,6,2,1,1,1.0,-3,1,-3,2,-1,-4,-3
1271,5.331475501811063,5.300365649991566,5.713357232235096,5.05334355102645,5.368715193536547,5.989811391742141,5.5385174475334304,436438.3425925926,1,E01001293,5,6,7,2,4,5,5.1806871140825335,5.290931569091205,5.654199139825229,5.25147341243152,5.321908917920343,5.904655507926283,5.300358882238125,557338.2327586206,0,6,5,9,3,3,0,1.0,-1,1,-1,2,1,-1,-5
1272,5.193002456351172,5.391115682789042,5.570279064057749,5.1911581384984755,5.218385117717936,5.883196634582326,5.516604836983017,438510.1835443038,0,E01001294,7,4,9,0,3,4,5.096318516211632,5.236792925840769,5.564376179988567,5.263960766486632,5.216075628231733,5.791305531293918,5.3540357786875505,560022.4102564103,0,5,4,9,1,1,1,1.0,0,-2,0,0,1,-2,-3
1273,5.2155419652776205,5.4137658693993735,5.654964040416155,5.133135600607525,5.343644458194111,5.968832185102063,5.511841818343761,438779.5348837209,0,E01001295,7,5,8,2,4,4,5.166700033637566,5.212589333697063,5.692405935225448,5.235254376884399,5.304034672132352,5.868275037625941,5.420017239524097,560861.6016260163,0,5,6,9,3,3,2,1.0,0,-2,1,1,1,-1,-2
1274,5.273989689761195,5.494734511293214,5.551732242107391,4.990506376685767,5.2570609974450075,5.967491852826085,5.478308286132483,440937.7155172414,1,E01001296,8,4,6,0,4,4,4.987562329931692,5.350939600305124,5.501908711411736,5.247276456518606,5.2048472558910195,5.838091563094746,5.35970114171505,563539.3295454546,0,7,3,9,1,2,1,1.0,-1,-1,-1,3,1,-2,-3
1275,5.2454674417459515,5.318554762798019,5.511723936358584,5.173523554319067,5.305237584476229,5.816240291052226,5.448216531850115,441534.83544303797,1,E01001297,5,3,9,1,2,3,5.195019705295563,5.246801245212555,5.546313083966573,5.246063991387685,5.296353385448456,5.884420138200124,5.46226646343867,564381.0533333333,1,5,3,9,2,3,3,1.0,0,0,0,0,1,1,0
1276,5.289564301733111,5.439440472204177,5.595852670122365,5.0370991151840965,5.325958725858907,5.885604844718683,5.466219265929988,441025.2786885246,1,E01001298,7,4,7,1,3,4,5.189165412433564,5.228677101551541,5.593784012491741,5.121147086696019,5.250130510519421,5.913606076013474,5.554790030396174,563693.373015873,0,5,4,8,2,3,4,1.0,-1,-2,0,1,1,0,0
1277,5.876750411345944,5.030808185973362,5.919607112979331,4.555083678479781,5.612528842792177,6.46991711332087,5.845093660884434,186104.865497076,7,E01001299,1,8,0,8,9,9,5.774669863382975,5.029742645422617,5.775896935462952,4.803482386271159,5.446222938696543,6.393435246149699,5.863972113927205,236006.54666666666,7,2,7,1,6,9,9,1.0,0,1,-1,1,-2,0,0
1278,6.191155452728271,4.940719250679016,6.095452608108521,4.45575834941864,5.679821746826172,6.592218063354492,5.829549711227417,185172.6,9,E01001300,0,9,0,9,9,9,6.043758994390984,4.869628499535954,5.9584527135897085,4.57394918273477,5.526969728349638,6.441146021129704,5.851938744552997,234367.82352941178,9,0,9,0,8,9,9,1.0,0,0,0,0,-1,0,0
1279,5.630823775817608,5.307131172048635,5.559240362561982,4.803513883722239,5.532895502550849,5.956668523262287,5.4561274216092865,184804.6896551724,5,E01001301,5,4,3,6,4,3,5.5111793077216955,5.239656063745606,5.482552988724139,5.039701348580654,5.283424071545871,5.9107706171911465,5.4629486634296445,233928.42767295596,4,5,2,6,2,3,3,1.0,-1,0,-2,3,-4,-1,0
1280,5.94591262846282,4.995583987597263,5.953965073282069,4.5777339375380315,5.683692375818889,6.43486257574775,5.867351022633639,185577.96212121213,8,E01001302,1,9,0,9,9,9,5.763598677680248,5.011897807046185,5.942764978709183,4.730142733243507,5.461517587421447,6.351715450211773,5.8325467607167765,234910.031496063,7,2,9,0,7,9,8,1.0,-1,1,0,0,-2,0,-1
1281,6.099240177045993,4.937882092910084,6.084447112509875,4.522647841189935,5.665327484045571,6.539887806264366,5.788249422864216,185103.66666666666,9,E01001303,0,9,0,8,9,8,5.912294191784329,4.939710669164304,5.945793755849203,4.676209818875348,5.513414838578966,6.3606560989662455,5.835471812884013,234293.02962962963,8,1,9,0,8,9,8,1.0,-1,1,0,0,0,0,0
1282,6.052921500699274,5.096611492935268,5.9026573855301425,4.606180826822917,5.610454151000099,6.450127086420169,5.690407857127573,185845.6551724138,9,E01001304,2,8,0,8,9,7,5.744612499128414,4.977681051326703,5.854423326782033,4.785420300085334,5.3927692069283015,6.2995582954793035,5.725399011298071,235327.03797468354,7,1,8,1,5,9,7,1.0,-2,-1,0,1,-3,0,0
1283,6.0559816064691185,5.109935879707336,5.949467266412606,4.639713702345253,5.635076883143949,6.482239074276802,5.7655108082563356,230703.29323308272,9,E01001305,2,9,0,8,9,8,5.745851842501692,4.96004454598172,5.869856403074191,4.808554056036563,5.36788968366521,6.299715588111003,5.851789860325005,295466.90839694656,7,1,8,2,4,9,9,1.0,-2,-1,-1,2,-4,0,1
1284,5.934807040073253,5.026745176977581,5.933491642828341,4.5321619477536945,5.6890540343743785,6.472944570912255,5.72502996524175,200612.4537037037,8,E01001306,1,9,0,9,9,8,5.798454896399849,4.970837214536834,5.878681415005734,4.753244289180689,5.3945245512744835,6.367338303934064,5.8073868950208025,255923.2894736842,8,1,8,1,5,9,8,1.0,0,0,-1,1,-4,0,0
1285,5.609437435488157,5.255399498758437,5.734241782864438,4.877695938454399,5.506771205346795,6.067711553996122,5.561522430256952,423015.32278481015,4,E01001307,4,6,4,5,6,5,5.422218716356176,5.280348535120135,5.600812450668515,5.042503131917242,5.328707345844021,5.875031574943362,5.549397110233645,533518.2130177515,3,6,4,6,3,3,4,1.0,-1,2,-2,2,-2,-3,-1
1286,5.760283437528108,5.224321223560133,5.570348954200744,4.856681894628625,5.573439702862188,6.051414881254497,5.462078922045858,403956.0,6,E01001308,4,4,4,7,5,3,5.617058002457176,5.220555948227951,5.4212377655137445,5.035731153389842,5.299284432352204,5.924407422542572,5.604002381722951,518260.42268041236,5,5,1,6,3,4,5,1.0,-1,1,-3,2,-4,-1,2
1287,5.1629395156394775,5.396340082949541,5.446545889058451,5.196737998113857,5.320305218846779,5.886407805240061,5.2225334343947765,62693.23622047244,0,E01001309,7,2,9,1,3,0,5.30896040567985,5.271064053131984,5.676599473219651,5.049058306217193,5.324463644394508,5.926913111026471,5.445578617316026,81680.64615384616,2,6,6,6,3,4,2,1.0,2,-1,4,-3,2,1,2
1288,5.410079516020398,5.338404256225433,5.467641960054436,5.098734455620683,5.331026718920509,5.928764322460098,5.3229308488384985,63005.31543624161,2,E01001310,6,2,8,1,3,1,5.519234772162004,5.28869652820356,5.6338127793687764,4.984687094977407,5.398966560941754,6.05504262230613,5.490836038733974,82078.70909090909,4,6,5,5,5,6,3,1.0,2,0,3,-3,4,3,2
1289,5.146815515481508,5.537086292413565,5.337001992188967,5.245449655789596,5.345488384136787,5.746587052712074,5.081541082492241,65372.97692307692,0,E01001311,9,1,9,2,1,0,5.107164469258539,5.383529905615182,5.402192171688737,5.187760596439756,5.224136687969339,5.700816458669202,5.173120822577641,91142.75862068965,0,8,1,8,1,0,0,1.0,0,-1,0,-1,-1,-1,0
1290,5.60546957663376,5.320764916656661,5.685248416705723,4.8466176003435235,5.575440914961543,6.102255386157627,5.503365485337529,71398.48175182482,4,E01001312,6,6,4,7,6,4,5.499713007300417,5.160191621595216,5.67933288129788,4.945569473562888,5.415963066434397,5.93662854382907,5.5886800898703175,91862.25566343042,4,4,6,4,5,4,5,1.0,0,-2,0,0,-2,-2,1
1291,5.726812159805967,5.218370664537999,5.844153966820031,4.76707868304169,5.707808638873853,6.307685366848059,5.589800487484848,77896.49122807017,6,E01001313,4,8,2,9,9,6,5.426144977947613,5.178606620779982,5.627807249894014,5.083554005837655,5.337711909869769,6.157384122814144,5.627177288940361,93039.54054054055,3,4,5,7,3,8,6,1.0,-3,0,-3,5,-6,-1,0
1292,5.786940164733351,5.341026285238433,5.63069130245008,4.838008234375401,5.601962596700902,6.0733505780236765,5.526732528418825,177421.20175438595,6,E01001314,6,5,4,7,6,5,5.701743021878329,5.231763955679807,5.561021609739824,4.910910832881927,5.40901812098243,5.962955015355891,5.535209507291968,212066.4,7,5,4,3,5,4,4,1.0,1,-1,-1,-1,-2,-2,-1
1293,5.395091776772747,5.572091161735415,5.357878310473885,5.1187995709772185,5.264719962135074,5.7823261276004825,5.245260873178798,227395.4960629921,2,E01001315,9,1,8,1,1,1,5.430105142945411,5.389890183538398,5.439860817570015,4.977507994478981,5.34710294688308,5.864674137742727,5.39729846483909,304179.73154362413,3,8,2,5,4,2,2,1.0,1,-1,1,-3,3,1,1
1294,5.513689082680327,5.538423321463845,5.334131643627629,5.026704244541399,5.382467985153198,5.9320845992276166,5.488345511934974,168712.48484848486,3,E01001316,9,1,7,2,3,4,5.625264968321874,5.371456369986901,5.512118755854093,4.972337242273184,5.525356549483079,6.055038239405706,5.525762568987333,197160.73846153845,6,7,3,5,8,6,4,1.0,3,-2,2,-2,6,3,0
1295,5.436589619334863,5.615935424152686,5.2511648535728455,5.022726084504809,5.346914701924032,5.862357660823939,5.33232777580923,263913.9744897959,2,E01001317,9,0,7,2,2,1,5.537898418854694,5.445676725129692,5.368962913143392,5.0233714665685385,5.375962529255419,5.9262026341594,5.427675789716292,330519.8367346939,4,8,1,6,4,4,2,1.0,2,-1,1,-1,2,2,1
1296,5.572328371204413,5.548619951735535,5.349160537358714,4.917518756367055,5.350982347873483,5.970978031399122,5.457598093556305,345100.45110410097,4,E01001318,9,1,5,2,4,3,5.725564747243314,5.403378712969857,5.506476508604513,4.952289383959126,5.4827313254008425,6.04419876272614,5.527954551013741,479065.9864864865,7,8,3,4,7,6,4,1.0,3,-1,2,-1,5,2,1
1297,5.256473572924733,5.49616009183228,5.5054107224568725,5.151858675293624,5.311313582584262,5.930842883884907,5.410918219015002,429152.7890625,1,E01001319,8,3,9,1,3,3,5.270623237678879,5.349022319442348,5.571219024689574,5.1110147825981445,5.318242793804721,5.921297409816792,5.322574657044913,548107.427631579,1,7,4,7,3,4,1,1.0,0,-1,1,-2,2,1,-2
1298,5.1181453899903735,5.6976605473142685,4.963879387788098,5.3197055416877825,4.995697499525668,5.483005318978821,4.955178339071948,411354.29292929295,0,E01001320,9,0,9,0,0,0,5.30681224912405,5.536341713368893,5.060944923758507,5.218283396959305,5.092631338536739,5.561944910883904,5.032832215726375,549447.025,2,9,0,9,0,0,0,1.0,2,0,0,0,0,0,0
1299,5.403556077945523,5.475163836304734,5.2548423520917815,5.038147603593221,5.211829732588636,5.824417953568745,5.362304876005746,431534.10975609755,2,E01001321,8,0,7,0,2,2,5.4998089039427605,5.394589880083362,5.440407710707086,5.020146440236997,5.4039716720581055,5.893202393482893,5.344053205261883,550783.0341880342,4,8,2,6,5,3,1,1.0,2,0,2,-1,5,1,-1
1300,5.33464949960294,5.483613096631092,5.27415565615115,5.117087616091189,5.256918749601945,5.766457799206609,5.2791016060373055,430923.8869565217,1,E01001322,8,0,8,0,1,1,5.352259734563068,5.335501201384891,5.421356585173481,5.1055388007543785,5.317023748845125,5.805341392491771,5.347989611921057,550236.6902654867,2,7,1,7,3,2,1,1.0,1,-1,1,-1,3,1,0
1301,5.492603416289758,5.3863205559756775,5.383004241580263,4.966596971958055,5.278574662471036,5.87335767111647,5.41331017892295,431758.63302752294,3,E01001323,7,1,6,1,2,3,5.510529215519245,5.365994381216856,5.482795885549142,5.004852658280959,5.311429612338543,5.914635114944899,5.3713012016736545,551450.5528846154,4,7,2,5,3,3,1,1.0,1,0,1,-1,2,1,-2
1302,5.296732843459189,5.736551706855361,5.264063146737245,5.116283505886525,5.223987477319735,5.73059234103641,5.264625361373833,432871.9009009009,1,E01001324,9,0,8,0,1,1,5.405217629671097,5.608811728159586,5.234160022934278,5.165754288434982,5.249306438366572,5.732099395990372,5.26588748494784,552862.975,3,9,0,8,2,1,0,1.0,2,0,0,0,2,0,-1
1303,5.466598081442476,5.455634504739492,5.45620228176468,4.959732666337417,5.458927959020884,5.998798765287809,5.419870057720348,433811.46625766874,3,E01001325,8,2,6,4,5,3,5.522986921142129,5.352190169166116,5.567861399229835,4.994529316705816,5.497131789431853,6.0213917535894055,5.505044904175927,553923.4647058824,4,7,4,5,7,6,3,1.0,1,-1,2,-1,3,1,0
1304,5.291963044998577,5.742871506714526,5.0999025626437655,5.143793182117949,5.160543148409682,5.621511810110429,5.132856578493315,432997.2057613169,1,E01001326,9,0,9,0,0,0,5.430035559368915,5.5755953857156095,5.120435981965456,5.126678602617295,5.15493746614847,5.730422197795305,5.231817233757894,552978.8893442623,3,9,0,8,0,1,0,1.0,2,0,0,-1,0,1,0
1305,5.528248691051564,5.624514951097204,5.238463792902358,4.980187013301443,5.371841108545344,5.832204617845251,5.298590931486576,433547.5361702128,3,E01001327,9,0,6,2,2,1,5.679718489018978,5.404821296778235,5.469516745320073,4.963703492050799,5.50731802084809,6.025263839297825,5.549427121264454,553694.2592592592,6,8,2,5,8,6,4,1.0,3,-1,2,-1,6,4,3
1306,5.370781477292379,5.63664592046004,5.258185465519245,5.190537417240632,5.250617079245738,5.762886895888891,5.335851186361069,433613.1794871795,2,E01001328,9,0,9,0,1,2,5.384586573857342,5.505412944682359,5.331850753822907,5.11740355564253,5.342133015545492,5.878404676611654,5.367527961730957,553746.1624365483,3,9,1,7,4,3,1,1.0,1,0,1,-2,4,2,-1
1307,5.534203222934032,5.432970583838904,5.487640156841918,4.994039286703071,5.451855357061296,5.956855612313188,5.468596061604135,433929.8389261745,4,E01001329,7,3,6,4,4,4,5.57626351809046,5.365526299567739,5.591756005196055,4.944600092377632,5.455960077844607,6.08309112005173,5.599698949771322,554119.3694267516,5,7,4,4,6,7,5,1.0,1,0,1,-2,2,3,1
1308,5.317509599270359,5.602191080970149,5.142033389499111,5.147138784970006,5.260311768900964,5.637761085264144,5.189736306667328,434653.8629032258,1,E01001330,9,0,9,0,0,0,5.432664432402315,5.542058764860548,5.325665218049083,5.167340126530878,5.389627940695862,5.7909329307490385,5.175444143599477,554927.2586206896,3,9,1,8,5,1,0,1.0,2,0,1,-1,5,1,0
1309,5.164368034464069,5.6780438507552695,5.199314640686575,5.247471641650242,5.276172129453811,5.7755787815667885,5.201421213361014,434124.203539823,0,E01001331,9,0,9,1,1,0,5.371532136360101,5.594522767362341,5.324915134801274,5.117116379526864,5.380523174209932,5.853570317800066,5.35493024155102,554371.1327433628,2,9,1,7,5,2,1,1.0,2,0,1,-2,4,1,1
1310,5.367242578304175,5.638625159408107,5.1878468966243245,5.202100677923723,5.363872727962455,5.717157048408431,5.143287771880025,433995.89898989897,2,E01001332,9,0,9,2,1,0,5.585674811812008,5.5378392829614524,5.414523830600813,5.054063634545195,5.493128094018674,5.980865579025418,5.406070796882405,554252.568627451,5,9,1,6,7,5,2,1.0,3,0,1,-3,5,4,2
1311,5.395367396183503,5.249613108543249,5.52170010866263,4.879147174266668,5.358462470464217,5.910084989590523,5.334236318484331,245763.58974358975,2,E01001333,4,3,4,2,3,1,5.398647262750427,5.17938300950931,5.434935849221026,5.033281295025935,5.236979964652348,5.763034363261989,5.284237128789307,311821.08196721313,3,4,2,6,1,1,0,1.0,1,0,-1,2,-1,-2,-1
1312,5.223301022052765,5.488180329799652,5.28506984591484,5.08477933049202,5.366639688014984,5.784245300292969,5.2134530174732205,202726.49,0,E01001334,8,0,8,2,1,0,5.018633132783052,5.410406178403123,5.2602827203608005,5.190104973650424,5.07742639679775,5.640598762815244,5.267539082286514,258036.31775700935,0,8,0,8,0,0,0,1.0,0,0,0,0,-2,-1,0
1313,5.842242676764727,5.324173614382744,5.5550062743326025,4.72665891610086,5.640620561937491,6.098860920717319,5.695701673006018,203515.28125,7,E01001335,6,4,2,8,6,7,5.7835863187909125,5.288147802650928,5.494655649363994,4.8140706568956375,5.488704530894756,6.068565443903208,5.795067684352398,259189.825,7,6,3,2,7,7,8,1.0,0,0,-1,0,-1,1,1
1314,5.382612267523322,5.427932044931951,5.362585830324479,5.032856879343513,5.3647363431581105,5.851801035058408,5.406581154306426,203697.33587786258,2,E01001336,7,1,7,2,2,3,5.406584582587545,5.338778090107349,5.463879491007606,4.982465284739354,5.219946860342986,5.930915220763332,5.562960327133652,259446.4031007752,3,7,2,5,1,4,4,1.0,1,0,1,-2,-1,2,1
1315,5.493327717073099,5.4750313639120245,5.381931479320776,4.947860867696037,5.38677920368561,5.874268528675929,5.369539056282377,373480.4104803493,3,E01001337,8,1,6,3,2,2,5.429884591286589,5.41263027666466,5.404796573893433,5.051657011271289,5.220429642790767,5.796044598821658,5.406412492227708,491958.9807073955,3,8,1,6,1,1,2,1.0,0,0,0,0,-2,-1,0
1316,5.350327758669104,5.428538969477767,5.470461166129922,5.067283466177167,5.324537064294395,5.801394907183617,5.4629207017286765,389223.8113207547,1,E01001338,7,2,8,1,1,3,5.180533940023412,5.376993185184041,5.326449538840622,5.212860556899524,5.135650105163699,5.72450935775465,5.416413992480502,501507.262295082,0,7,1,9,0,1,2,1.0,-1,0,-1,1,-1,0,-1
1317,5.432491474054955,5.507793553777643,5.2605769110692515,5.035660861311732,5.388648328748909,5.812589445629635,5.293636753752425,255822.77702702704,2,E01001339,8,0,7,3,2,1,5.29506873951278,5.493032237670941,5.192435122735008,5.1374056618972865,5.176479480120057,5.778242372267739,5.382764811622364,337052.1955307263,1,9,0,8,0,1,1,1.0,-1,1,0,1,-3,-1,0
1318,5.409375474566505,5.58607437922841,5.277103861172994,5.103296418984731,5.290804388977232,5.84574518317268,5.324270547855468,443678.39285714284,2,E01001340,9,0,8,1,2,1,5.192074601273788,5.521650742229663,5.21407146328374,5.315993730645431,5.081902507731789,5.690070004212229,5.2982787182456565,567215.0421052632,1,9,0,9,0,0,0,1.0,-1,0,0,1,-1,-2,-1
1319,5.315694496035576,5.211213357746601,5.801741393076049,5.000519341892666,5.365857926507791,5.98440033942461,5.331490787367026,414413.81944444444,1,E01001341,4,7,7,2,4,1,5.012761120583601,5.315854300359252,5.564239072951541,5.171814239708481,5.068773625003304,5.7911038710053555,5.472929489081073,529071.2738853503,0,6,4,8,0,1,3,1.0,-1,2,-3,1,-2,-3,2
1320,5.34973055322965,5.278647866845131,5.778213854630788,4.989025766650836,5.361630539099376,5.947949600219727,5.168503212928772,413937.10833333334,1,E01001342,5,7,6,2,4,0,5.184589764586201,5.428714255491893,5.493397264568894,5.025720755259196,5.167385162026794,5.8574777311748925,5.423240072197384,528375.6018518518,0,8,3,6,0,2,2,1.0,-1,3,-4,0,-2,-2,2
1321,5.1551491516941,5.3405273410509215,5.534770374028188,5.052284630589515,5.295132957164596,5.791800919568764,5.195074691712481,414147.0440251572,0,E01001343,6,3,7,1,1,0,4.9899876448415945,5.469139697474818,5.457484413731483,5.260568580319805,5.144617822862441,5.647444867318677,5.404430497077204,528610.3354838709,0,9,2,9,0,0,2,1.0,0,3,-1,2,-1,-1,2
1322,5.539723062615016,5.394177668264222,5.498017927093985,4.986728095609274,5.402522175880655,5.912569461507278,5.354484716219882,414722.6945606695,4,E01001344,7,3,6,3,3,2,5.283952151092828,5.394893287677391,5.361722433333304,5.1881333295036764,5.247860386792351,5.75089069815243,5.444895375476164,529484.4392156863,1,8,1,8,2,1,2,1.0,-3,1,-2,2,-1,-2,0
1323,5.481123398388585,5.2829064899875275,5.6588247322267105,4.8861819188441,5.45969549878951,6.168248503438888,5.507360940018008,415144.02419354836,3,E01001345,5,5,5,4,7,4,5.240145259433323,5.320628610363713,5.572918755919845,5.071564337942335,5.104959019025167,5.988077734134816,5.541518292603669,529925.1185185185,1,7,4,7,0,5,4,1.0,-2,2,-1,2,-4,-2,0
1324,5.551800608634949,5.2122779682625175,5.760682148988857,4.941248256106709,5.545371657194093,6.023986539175344,5.510760748802229,427091.75581395347,4,E01001346,4,7,6,6,5,4,5.273580941025186,5.302888135979141,5.624693636732977,4.988603518780879,5.374074776967366,5.855111885761869,5.6555860837300616,544847.5217391305,1,6,5,5,4,2,6,1.0,-3,2,-2,-1,-2,-3,2
1325,5.3251051011124275,5.425595201127898,5.485831707473693,5.095935279760903,5.325364762690009,5.787073966448869,5.348910743628091,415582.18292682926,1,E01001347,7,3,8,1,1,2,5.190967274062774,5.437931710744605,5.333386973861386,5.177492473055334,5.161685061367119,5.707894539570107,5.378014032893321,530633.7573529412,1,8,1,8,0,0,1,1.0,0,1,-2,0,-1,-1,-1
1326,5.487582848872989,5.484737127553672,5.277172890026122,5.0888190804980695,5.243462464772165,5.760704999789596,5.250805023591965,420253.60546875,3,E01001348,8,0,8,0,1,1,5.320182374932549,5.482423680556285,5.216527078832899,5.163635606502558,5.149120764298872,5.663137065899837,5.290631039189054,537365.6266233766,2,9,0,8,0,0,0,1.0,-1,1,0,0,0,-1,-1
1327,5.406374328732491,5.545797443389892,5.282935269474983,5.097884329557419,5.26458379983902,5.778691611886025,5.352909902334213,429767.025,2,E01001349,9,0,8,1,1,2,5.274649133192044,5.499815242312779,5.194927734749339,5.196850025208197,5.166453952544203,5.752126578415666,5.3828518986701965,548716.3317757009,1,9,0,9,0,1,1,1.0,-1,0,0,1,-1,0,-1
1328,6.238868110584763,5.065811093123454,5.9415234023669985,4.628068524711537,5.773088981520455,6.3755747822095765,5.9804981542083455,424971.19811320753,9,E01001350,2,9,0,9,9,9,6.172661852836609,5.088120742277666,5.880089939724315,4.7327132896943525,5.614790081977844,6.352943275191567,5.947017985040492,542332.1545454545,9,3,8,0,9,9,9,1.0,0,1,-1,0,0,0,0
1329,5.763708574631635,5.004074668183046,5.772222721576691,4.782392342651591,5.550613270086401,6.0175382628160365,5.64482346983517,424692.56470588234,6,E01001351,1,7,2,6,5,6,5.709079052914273,4.9949141571467575,5.821397029540756,4.857428106394681,5.493579011071812,6.065394466573542,5.702029934660955,542206.2670454546,7,1,8,2,7,6,7,1.0,1,0,1,0,1,1,1
1330,6.230007838457823,4.85894607193768,5.980403969064355,4.545970973558724,5.707805164158344,6.406202334910631,5.979947934858501,425272.5859375,9,E01001352,0,9,0,9,9,9,6.066252267151548,4.8327016129828335,5.949414939211126,4.657266258147725,5.549092313699555,6.328212123168142,5.974301575568685,542898.2192982456,9,0,9,0,8,9,9,1.0,0,0,0,0,-1,0,0
1331,6.002884704815714,4.981128578123293,5.8370515782582135,4.605619808560924,5.671043129343736,6.204387289913077,5.636916496251759,415357.2236842105,8,E01001353,1,8,0,8,8,6,5.933863896590013,4.917399148146312,5.90907228910006,4.694674965662834,5.48889573262288,6.150179908825801,5.735481193432441,538466.217948718,9,1,9,0,7,8,7,1.0,1,0,1,0,-1,0,1
1332,6.087318987418444,5.007296318427111,5.935441045424877,4.555177826147813,5.623867866320488,6.401261603220915,5.8554475750678625,425080.5,9,E01001354,1,9,0,8,9,9,5.97582521900054,4.944778146282319,5.912648520931121,4.706035522491701,5.504272917009169,6.362532441846786,5.870662245442791,542669.9935483871,9,1,9,0,8,9,9,1.0,0,0,0,0,0,0,0
1333,5.869562744125118,4.937380573613857,5.9477343103749964,4.688028932586918,5.576397294920635,6.238041514303626,5.69957196809412,375241.55284552847,7,E01001355,0,9,1,7,8,7,5.801590129977367,4.90403112427133,5.874014115724408,4.7176623227166345,5.438909794463486,6.080442409046361,5.65375189898444,478143.7295081967,8,1,8,0,6,7,6,1.0,1,1,-1,-1,-1,-1,-1
1334,5.496022078920813,5.2785830462680146,5.4744035286061905,4.902310010264902,5.4113273059620575,5.807971358299255,5.434923694414251,424642.79411764705,3,E01001356,5,2,5,3,2,3,5.412400870180842,5.183051458045618,5.608788572140594,5.043574500439772,5.368502134707437,5.868595671297899,5.591319340378491,542099.3582089553,3,4,5,6,4,3,5,1.0,0,-1,3,1,1,1,2
1335,5.763506762186686,5.245867679913839,5.687718426386516,4.76563389937083,5.670675029754639,5.968452399571737,5.458951814969381,230591.09333333332,6,E01001357,4,6,2,8,4,3,5.622148113486207,5.102739510712801,5.5396188983210815,4.901231653896379,5.460993619612705,5.848543764632425,5.3906362719006005,292002.2098765432,6,3,3,3,7,2,2,1.0,0,-1,-3,1,-1,-2,-1
1336,5.085901092429188,5.476429503925598,5.249683310972393,5.279347310408703,5.207243826507863,5.551287262479245,5.122133696935453,192450.11602209945,0,E01001358,8,0,9,0,0,0,4.95515620203876,5.3757096566851175,5.347283054911901,5.342618240881219,5.125409685114704,5.521558499210095,5.167242989969001,238314.49735449735,0,7,1,9,0,0,0,1.0,0,-1,1,0,0,0,0
1337,5.475248983928135,5.103607978139605,5.7468174826197265,4.844117317880903,5.429441610304248,6.101747148177203,5.459850513634562,440648.5294117647,3,E01001359,2,7,4,3,6,3,5.413069125797067,5.07852814240115,5.694417592670236,4.986768569265093,5.291139743157795,6.11445316033704,5.462020685630185,563395.6428571428,3,2,6,5,2,7,3,1.0,0,0,-1,1,-1,1,0
1338,5.513169457427169,5.199159143245326,5.785496452213389,4.975851958831854,5.3406150087846065,6.24507486714726,5.503401278394513,441992.26548672566,3,E01001360,3,7,6,2,8,4,5.377166772710866,5.126177418848564,5.73297412436584,5.174161869904091,5.202406698259814,6.0625636885906085,5.374287630977301,565000.7068965518,2,3,7,8,1,6,1,1.0,-1,0,0,2,-1,-2,-3
1339,5.416576084494591,5.070241500139236,5.756318177580834,5.024938404560089,5.422359193563461,5.75090911090374,5.354426964521408,441578.675,2,E01001361,2,7,7,3,1,2,5.266759945377367,5.086827599838989,5.570348731459004,5.112204840738479,5.2295785271413795,5.699079167897298,5.295256576037298,564481.0045662101,1,3,4,7,1,0,0,1.0,-1,1,-3,0,-2,-1,-2
1340,5.558100926357767,5.137545432215152,5.725045741122702,4.887499908778978,5.43613035886184,6.0690999611564305,5.577744486020959,441647.94782608695,4,E01001362,3,6,5,3,6,5,5.374527636074251,5.1154697422058355,5.617477152616747,5.002660531190134,5.236627807540279,5.96387392282486,5.555966043664563,564539.3306451613,2,3,5,5,1,4,4,1.0,-2,0,-1,0,-2,-2,-1
1341,5.319581617429418,5.340716635139243,5.608283619278843,5.077272284378126,5.298171289916177,5.961793489826536,5.32668719824078,438791.00970873784,1,E01001363,6,5,8,1,4,1,5.132705546841763,5.342257418254815,5.549161431813004,5.095810008521127,5.209875636761732,5.852534334258277,5.319024625391063,560570.0891089109,0,7,4,7,1,2,1,1.0,-1,1,-1,-1,0,-2,0
1342,5.4603544822553305,5.513619087091306,5.4386217245241495,5.07764430743892,5.382465667840911,6.040147490617706,5.453828249035812,441353.4756097561,3,E01001364,8,2,8,2,5,3,5.528168587849058,5.089182727638332,5.520814007726209,4.9936848974776,5.3935682307714705,6.1020534065948135,5.617797084238338,564118.1034482758,4,3,3,5,5,7,5,1.0,1,-5,1,-3,3,2,2
1343,5.721066851040413,5.216287942795918,5.702876851476472,4.942126704701062,5.361875935875136,6.186179368660368,5.5044533476747315,439263.8275862069,6,E01001365,4,6,6,2,8,4,5.310750278830528,5.237976201623678,5.4098370663821695,5.186946818232537,5.102822083979845,5.846516497433186,5.220793627202511,487095.06875,2,5,1,8,0,2,0,1.0,-4,1,-5,2,-2,-6,-4
1344,5.105893478877302,5.454409995804662,5.517338134240413,5.172754388788472,5.259128954099572,5.839997371037801,5.265935097915539,207173.69565217392,0,E01001366,8,3,9,0,2,1,4.971027072459933,5.340585107841189,5.457828266280038,5.310297603645022,5.111944637601337,5.761075390709771,5.268698298741901,261755.7380952381,0,7,2,9,0,1,0,1.0,0,-1,-1,0,0,-1,-1
1345,5.113405778176254,5.354495847390758,5.429451841447088,5.120357062253687,5.14730312095748,5.649401967724164,5.160147151185407,223885.5,0,E01001367,6,2,8,0,0,0,5.128242210982597,5.224735967916985,5.403074006511741,5.209285220871233,5.142156503788413,5.6242184492006695,5.1606317595259785,280511.3630136986,0,5,1,9,0,0,0,1.0,0,-1,-1,1,0,0,0
1346,5.065217642734448,5.370418265461922,5.514789771288633,5.1844751834869385,5.248476133992274,5.809840542574723,5.296205258617799,202023.04166666666,0,E01001368,6,3,9,0,2,1,4.974009753453849,5.449177981603263,5.550517882450973,5.475352580004399,5.045000501198344,5.7591022075993,5.41614842296827,256949.94059405942,0,8,4,9,0,1,2,1.0,0,2,1,0,0,-1,1
1347,5.39136791040027,5.345671813639384,5.474127231136201,5.008031309597076,5.37871682927722,5.90276875382378,5.353900006839207,203029.6349206349,2,E01001369,6,2,7,2,3,2,5.354295575257503,5.292705144846078,5.442060827305823,5.126642006816286,5.201036232890504,5.864283950039835,5.3304513972817045,258430.3409090909,2,6,2,8,1,2,1,1.0,0,0,0,1,-1,-1,-1
1348,5.14743551780016,5.482422824395009,5.387386291455,5.118136756848067,5.286376967185583,5.751506766294821,5.206416504811018,203599.92307692306,0,E01001370,8,1,8,1,1,0,5.063090794014208,5.3449193829237815,5.322468195298706,5.393670340981147,5.007145068862221,5.653260177434093,5.268471711211735,259348.71717171717,0,7,0,9,0,0,0,1.0,0,-1,-1,1,-1,-1,0
1349,5.428434042173011,5.197572031867838,5.563612371961647,4.889391338713815,5.380408122160724,5.936261368689136,5.361629964035248,203807.3551401869,2,E01001371,3,4,5,2,3,2,5.431594284914308,5.180865781792139,5.57694858211582,5.000319573838832,5.226961555117268,5.9040095300997715,5.352887168779212,259896.2372881356,3,4,4,5,1,3,1,1.0,1,1,0,0,-1,0,-1
1350,5.287516644795736,5.306369180679321,5.54996826171875,4.980995184580485,5.291802639961243,5.884899775187175,5.292639764149984,203248.49333333335,1,E01001372,5,4,6,1,3,1,5.274050949617874,5.180989894756051,5.5431919680085295,5.1093692419140835,5.171226373938627,5.795510497204093,5.26360148191452,258698.9534883721,1,4,3,7,0,1,0,1.0,0,-1,-1,1,-1,-2,-1
1351,5.181990523149471,5.329970227609767,5.487980597090013,5.005191232898448,5.24419386552112,5.842605220209254,5.098767647648802,227620.34653465348,0,E01001373,6,3,7,0,2,0,5.215739355043128,5.025967849625482,5.574369013309479,5.151291403505537,5.144873856394379,5.6655567200095565,5.282090193695492,290458.4537037037,1,2,4,8,0,0,0,1.0,1,-4,1,1,0,-2,0
1352,5.804790415394474,5.0957255623709985,5.824671090488702,4.71188537083881,5.580746309857973,6.239787691915539,5.52710614321937,184196.01408450704,7,E01001374,2,8,1,7,8,5,5.622498408058621,5.0219682968215436,5.75496506690979,4.834297113860679,5.363649706177364,6.0558466390268695,5.571784748936331,233067.80132450332,6,2,7,2,4,6,5,1.0,-1,0,-1,1,-3,-2,0
1353,6.293564836184184,4.8033129417647915,6.116683741410573,4.456941655526559,5.771443595488866,6.602428731818994,5.99375502889355,223733.14583333334,9,E01001375,0,9,0,9,9,9,6.09965841953571,4.701381181447934,6.035789899336986,4.505017902912238,5.54555595104511,6.425597490408482,5.979959708605057,287965.3282051282,9,0,9,0,8,9,9,1.0,0,0,0,0,-1,0,0
1354,5.853746751303314,5.124918181409118,5.800429064740417,4.714073415725462,5.601937199151644,6.247270414906163,5.6582474195829,228904.8494623656,7,E01001376,2,7,1,7,8,7,5.715401651958625,5.021689136823018,5.794156054655711,4.712570209056139,5.407104945431153,6.118809210757415,5.62424370025595,305010.46875,7,2,8,0,5,7,6,1.0,0,0,1,-1,-2,-1,-1
1355,6.32609385281653,4.8307435239725445,6.069151190382924,4.440146486557539,5.810151249615114,6.51410681216871,5.999491349974675,185428.4278606965,9,E01001377,0,9,0,9,9,9,6.130386091914832,4.851822075306201,6.006515241721097,4.559683237590042,5.602542627091501,6.347603754670012,5.9603225489457445,234748.75980392157,9,0,9,0,9,9,9,1.0,0,0,0,0,0,0,0
1356,6.205145228826082,4.959991467916049,6.026102599730859,4.487640750408173,5.735259479742783,6.544599907214825,5.908599818669833,182923.05384615384,9,E01001379,1,9,0,9,9,9,5.975172160249768,4.8384853673703745,6.0336698257561885,4.616764622204231,5.56097704894615,6.338915138533621,5.834408543326638,231240.62121212122,9,0,9,0,8,9,8,1.0,0,-1,0,0,-1,0,-1
1357,6.0191039982296175,5.04990795274981,5.9268823643119966,4.659878199603281,5.620661982062723,6.350687673302735,5.750519261068227,188922.50340136053,8,E01001380,1,9,1,8,9,8,5.738349257244004,4.971398147443931,5.814583816462093,4.804433579246203,5.418283520473374,6.147269344992107,5.594543019930522,239628.99305555556,7,1,8,1,6,8,5,1.0,-1,0,-1,0,-2,-1,-3
1358,5.551490877248064,5.109811812010496,5.643072607648021,4.893868764241536,5.454603906925217,5.981763600800107,5.424851616223653,319843.1856540084,4,E01001381,2,5,5,4,4,3,5.525997836302227,5.054206946016749,5.694130325131843,4.918218347812905,5.354017306858464,5.925812946219389,5.541108821152713,401225.5719844358,4,2,6,4,4,4,4,1.0,0,0,1,-1,0,0,1
1359,6.425001438321738,4.8853465493383075,6.167296088975052,4.454690681449298,5.824315730867715,6.676996231079102,6.093917223913916,389853.5431034483,9,E01001382,0,9,0,9,9,9,6.199795635735116,4.962009481298245,6.010915215422467,4.52320769162682,5.61615405528526,6.550781300397423,6.058888660213811,505133.10569105693,9,1,9,0,9,9,9,1.0,0,1,0,0,0,0,0
1360,6.3476728708655745,4.920926031139162,6.1322970478623,4.489912687628357,5.7367226371058715,6.664487428135342,5.953016784456041,427589.1759259259,9,E01001383,0,9,0,9,9,9,6.16739319392613,4.888469830013457,6.013873890468052,4.623580954188392,5.451019928568885,6.519833903085618,6.010914207640148,545778.1047619048,9,0,9,0,6,9,9,1.0,0,0,0,0,-3,0,0
1361,5.6860705680317345,5.135767342867674,5.85438707139757,4.8318099611335334,5.444276500631262,6.219030380249023,5.480953719880846,416325.52777777775,5,E01001384,3,8,4,4,8,4,5.608873128890991,5.092942392187459,5.773315415850708,4.893350701246943,5.324632089052882,6.132587764944349,5.673102740730558,537376.2857142857,5,3,7,3,3,8,6,1.0,0,0,-1,-1,-1,0,2
1362,6.031722471930764,4.971129706772891,6.03944869258187,4.602008266882463,5.667352364280007,6.508893697912042,5.83653720183806,206824.18181818182,8,E01001385,1,9,0,8,9,9,5.867586926619212,4.817209231853485,5.893049701054891,4.775470838944117,5.492945969104767,6.391450174649557,5.931349116563797,265084.825,8,0,8,1,7,9,9,1.0,0,-1,-1,1,-1,0,0
1363,6.046158631642659,5.023764390321005,5.876389345952442,4.611615592525119,5.633906959068208,6.342667441992533,5.782494436417307,368113.86904761905,9,E01001386,1,8,0,8,9,8,5.993286541345957,4.941253893439834,5.909740321700637,4.6447411408295505,5.605218338321995,6.305978425773414,5.8328384831145,474635.9027027027,9,1,9,0,9,9,8,1.0,0,0,1,0,1,0,0
1364,6.010571298145113,5.064443693680017,5.823442720231556,4.656771937195136,5.678543473587555,6.214416198179024,5.843394713336918,427081.3333333333,8,E01001387,2,8,1,9,8,9,5.983962952733754,5.095905475987646,5.808001506828262,4.773509222590281,5.5502580782610496,6.18587568063222,5.825899531741342,545099.5628742515,9,3,8,1,8,8,8,1.0,1,1,0,0,-1,0,-1
1365,5.773005089615331,5.195966966224439,5.6576140201453,4.812383926998486,5.529661399667913,6.010447190024636,5.572400236129761,426936.3151515151,6,E01001388,3,5,3,6,5,5,5.64089410007,5.154228704671065,5.5906927573184175,4.998898221800725,5.421137417977055,5.917736946294705,5.506960179656744,544947.625,6,4,4,5,6,3,3,1.0,0,1,-1,2,0,-2,-2
1366,5.765237610974758,5.121128674891355,5.9102735142056035,4.768011609427363,5.505084031777416,6.210355945628324,5.734578428508566,427736.6330935252,6,E01001389,2,8,2,5,8,8,5.622624593929653,5.083166299945247,5.746222527357784,4.886317354919266,5.360147874720775,6.054319353869362,5.774742702498053,545999.7226277372,6,3,7,3,4,6,8,1.0,0,1,-1,1,-1,-2,0
1367,6.063261617933001,5.04891760576339,6.031228742145356,4.657431820460729,5.66309806505839,6.43504185222444,5.870328946340652,507371.99047619046,9,E01001390,1,9,1,8,9,9,5.86817398324477,4.884954485218082,5.964879894678572,4.796027417731496,5.557644709021644,6.283859132665448,5.854168619729776,641995.0353982301,8,0,9,1,8,9,9,1.0,-1,-1,0,0,0,0,0
1368,5.928841979004616,5.020817929922148,5.799652303374091,4.800498197245044,5.580361929050712,6.214319134867469,5.72974372464557,529858.7790697674,8,E01001391,1,7,3,7,8,8,5.852476657122031,4.961203871102168,5.7982314962080155,4.749278109649132,5.544036262336818,6.226712936642526,5.687494974026735,664098.8275862068,8,1,8,1,8,9,7,1.0,0,0,1,-2,1,1,-1
1369,5.949550838366042,5.036488023987652,5.842645138719656,4.683055964699627,5.588221619599057,6.275140054034491,5.71704454143552,453253.3868613139,8,E01001392,1,8,1,7,8,7,5.769238656759262,5.164475866726467,5.810092520713806,4.931388477768217,5.4607996412685935,6.193997137887138,5.643274388142994,585697.1642857143,7,4,8,4,7,8,6,1.0,-1,3,0,3,0,0,-1
1370,5.849316816811168,5.055715743554842,5.873852734172016,4.625085114339076,5.544187077688514,6.250098370630806,5.654754965677174,501208.5871559633,7,E01001393,2,8,0,6,8,7,5.666563200478507,5.008672886555738,5.8769911563042365,4.852553362893586,5.395294696977823,6.079311453469909,5.596465355098838,640563.1782178218,6,2,8,2,5,7,5,1.0,-1,0,0,2,-1,-1,-2
1371,5.6076831933524875,5.2368905858861075,5.71794898642434,4.864135204917854,5.389374226331711,6.152114296952884,5.58565075447162,568588.2152777778,4,E01001394,4,6,4,3,7,6,5.486312239745567,5.1175823869376345,5.686877107620239,5.0294797741133594,5.2389455877501385,6.059341660861311,5.607247238323606,715951.6068965517,4,3,6,6,1,6,5,1.0,0,-1,0,2,-2,-1,-1
1372,5.770110424075808,5.263014231409345,5.684776565858296,4.870240251932826,5.5633789492504935,6.182636192866734,5.596869985972132,483977.8035714286,6,E01001395,5,6,4,7,8,6,5.422970326668626,5.166218576081302,5.6564495738493195,5.008079562712153,5.3264482393177275,6.040221542393396,5.599849306115317,636742.8532110092,3,4,5,5,3,6,5,1.0,-3,-1,-1,1,-4,-2,-1
1373,5.766640031879598,5.053834744475105,5.911059319972992,4.765981953252446,5.55868645418774,6.21888869729909,5.721987880089066,405402.4318181818,6,E01001396,1,8,2,6,8,7,5.501399909963413,4.9970007782079735,5.841277645558727,4.993284303314832,5.385968402940399,6.052302394594465,5.686575857960448,517598.9693877551,4,1,8,5,5,6,7,1.0,-2,0,0,3,-1,-2,0
1374,5.385160957613299,5.565243530177301,5.275298233474454,5.159220372476885,5.26319075495966,5.7561029253467435,5.264551170410648,665180.1653225806,2,E01001397,9,0,9,1,1,1,5.216034091543406,5.446791605558246,5.282450899947435,5.1528021935373545,5.08949431637302,5.7684555924497545,5.273486211895943,842778.5625,1,8,0,8,0,1,0,1.0,-1,-1,0,-1,-1,0,-1
1375,5.977113265826785,5.089373502238043,5.864037913289564,4.624183541330798,5.683852670932638,6.25895525011523,5.711410009449926,658556.7586206896,8,E01001398,2,8,0,9,8,7,5.8462933696431225,5.078200485208909,5.871505967147058,4.78635821411078,5.541852719492192,6.256778705034325,5.774637640808984,834541.2589928057,8,2,8,1,8,9,8,1.0,0,0,0,1,-1,1,1
1376,5.769290940471427,5.255024614788237,5.681364045572028,4.881870833023515,5.552453396812318,6.111168933293176,5.615198323335597,658412.8201058201,6,E01001399,4,6,4,6,7,6,5.530605073856271,5.238699322161467,5.494026452302933,5.002480091608089,5.327313346059426,6.037551684224087,5.655525270363559,834258.304347826,4,5,3,5,3,6,6,1.0,-2,1,-3,1,-3,-1,0
1377,5.799386453077283,5.230970705864746,5.7133341014729755,4.853858487454453,5.509318586029758,6.137569201474934,5.625892989897315,659384.1213872832,7,E01001400,4,6,4,5,7,6,5.570143358555832,5.205675979570158,5.686672535934889,4.888201047919389,5.396057062066359,6.161887354933458,5.744098602691826,835556.5549132949,5,4,6,3,5,8,8,1.0,-2,0,0,-1,0,1,2
1378,5.664194332666634,5.275113627930318,5.621076600610717,4.874316217485538,5.551379191973978,6.088447744196111,5.60390288278091,657175.1818181818,5,E01001401,5,5,4,6,6,6,5.377446716361575,5.222531835238139,5.645125940110948,4.968677292929756,5.377979867988163,6.093387381235758,5.710071353117625,832773.3888888889,2,5,5,5,4,7,7,1.0,-3,0,0,1,-2,1,1
1379,5.727125178683888,5.221203785297299,5.669987580007758,4.862756338001283,5.463881580790212,6.111672932451421,5.677770887032028,660947.8429752066,6,E01001402,4,6,4,4,7,7,5.569379258710285,5.18807590007782,5.626827486725741,4.967194315999053,5.3402482892191685,6.0915749682936555,5.707214183031127,837367.0511627907,5,4,5,5,3,7,7,1.0,-1,0,-1,1,-1,0,0
1380,5.705624148322315,5.256810358675515,5.5824869027951864,4.896239341759101,5.47860909322413,6.0178737117023005,5.471246201817582,659831.5268292683,5,E01001403,4,4,5,5,5,4,5.593006631044241,5.234312660266191,5.660972985243186,4.9254627869679375,5.398182485653804,6.051035640178583,5.652671101765755,836075.9384615384,5,5,6,4,5,6,6,1.0,0,1,2,-1,0,1,2
1381,5.673686644077301,5.3196719455718995,5.535263982772827,4.938833871364594,5.462084243297577,5.994310451507569,5.550158618927002,660506.904,5,E01001404,6,3,6,4,4,5,5.5212105825600934,5.345171178169692,5.510807311672962,5.1409762439580495,5.292987879638966,5.99269666358771,5.512429488671793,837031.3359073359,4,7,3,8,2,5,3,1.0,-1,1,0,2,-2,1,-2
1382,6.1943787494417055,5.20464860339191,5.7259461879730225,4.607941686777779,5.768730270269826,6.142107946438025,5.687301524436276,658879.8011049724,9,E01001405,4,6,0,9,7,7,6.0660776579776385,5.229008209369981,5.687924625318678,4.648731770112996,5.722357799330026,6.17740430978253,5.705765486373316,834942.9386189259,9,5,6,0,9,8,7,1.0,0,1,0,0,0,1,0
1383,5.74650713307968,5.17152035710038,5.644756457663529,4.748001225736757,5.4824359835378385,6.089099212987533,5.585806865565824,657613.0264900662,6,E01001406,3,5,2,5,6,6,5.6179582436342494,5.114125221967697,5.67657930867092,4.835978052906088,5.426005905544436,6.075816541104703,5.56672038258733,833372.9391891892,5,3,6,2,6,7,4,1.0,-1,0,1,0,1,1,-2
1384,5.614488470938898,5.4178096656837775,5.431401953581841,4.909325205510663,5.444674098683942,5.8580714060414225,5.295125784412507,666541.6290322581,4,E01001407,7,2,5,4,2,1,5.5221424061198565,5.396811179412428,5.315798765005067,5.00959452778794,5.306260294692461,5.779543162778366,5.3121822208397145,843338.8953488372,4,8,0,6,3,1,1,1.0,0,1,-2,1,-1,-1,0
1385,5.587103334889895,5.280470642490664,5.6370484397031255,4.856731823389081,5.44232117611429,6.006972368212714,5.421843480372774,670522.4130434783,4,E01001408,5,5,4,4,5,3,5.475917721903602,5.106106666631477,5.6956383997155715,4.92083881622137,5.372177078742389,5.925895260285961,5.384085350258406,849279.550387597,4,3,6,4,4,4,1,1.0,0,-2,1,0,0,-1,-2
1386,5.277097969711898,5.576922468796462,5.316684348854476,5.118119234096504,5.269560252834937,5.721052278301673,5.1658548016748025,660883.6107784432,1,E01001409,9,1,8,1,1,0,5.18676118864178,5.488843453805999,5.26920790254733,5.245929240506921,5.132101341829461,5.643691550540385,5.315625736942399,837358.3163841808,0,9,0,9,0,0,1,1.0,-1,0,-1,1,-1,-1,1
1387,5.521483316863935,5.557643428291242,5.430833519119577,4.9765388560049315,5.434617015504346,6.004799702732833,5.297878878632772,659798.7628865979,3,E01001410,9,2,6,3,5,1,5.093643574487595,5.389918753079006,5.101970206177424,5.03840468611036,5.056600982234592,5.293949567136311,5.169038589984652,836808.0476190476,0,8,0,6,0,0,0,1.0,-3,-1,-2,0,-3,-5,-1
1388,5.544474624417311,5.2480233695609435,5.721653341515664,4.9266254550840225,5.447276268268656,6.082043222123128,5.441138755324428,670753.6134969326,4,E01001411,4,6,5,4,6,3,5.498943254961605,5.151907017356471,5.692874683971294,4.925950199539899,5.36218942327109,6.020384393937406,5.552259731013873,849540.701754386,4,4,6,4,4,6,4,1.0,0,0,0,-1,0,0,1
1389,5.7040096285473325,5.735392619821037,4.812731869980952,5.018074678649973,5.306805851663609,5.547114299633367,5.027670316749412,662253.4882133995,5,E01001412,9,0,7,1,0,0,5.824299984078739,5.613819010447065,4.982635684106106,5.016775501315366,5.297711261184328,5.661981808308457,5.202293703776318,846481.3545380875,8,9,0,6,3,0,0,1.0,3,0,0,-1,2,0,0
1390,6.0250636863131675,5.311338286726706,5.496967457955884,4.7181257615166325,5.634295025660146,6.081791909471635,5.612951609876848,673035.2943548387,8,E01001413,5,3,1,8,6,6,5.915375305601388,5.236582780179899,5.4971319461657,4.7890064667079075,5.543865225039238,6.0928635971605285,5.691601813824708,852563.3636363636,8,5,3,1,8,7,7,1.0,0,0,0,0,0,1,1
1391,5.864933126053567,5.455683694047443,5.399705674688695,4.9007661049648865,5.445426579249108,5.88629764419491,5.47064205549531,670903.4576271187,7,E01001414,8,1,5,4,3,4,6.077119943691276,5.488556874425788,5.372036034600777,4.696493599847046,5.599708977498506,6.058432107780412,5.524457092870746,850909.5730994152,9,9,1,0,9,6,4,1.0,2,1,0,-5,5,3,0
1392,5.798645544510621,5.334971904754639,5.423946939217738,4.7985719327743235,5.5392044732968015,5.887012360187677,5.4844241100244036,459200.391025641,7,E01001415,6,2,3,6,3,4,5.874902224606754,5.3115506921778755,5.5527114102054504,4.79088874801044,5.558956467874163,6.039524808154542,5.63509870004786,588159.6980609419,8,6,4,1,8,6,6,1.0,1,0,2,-2,2,3,2
1393,5.67812265478415,5.375387466498438,5.6006811209741585,4.988021003413321,5.550106511503307,6.079248469493111,5.694537769719429,624030.5355329949,5,E01001416,6,4,6,6,6,7,5.667301673067814,5.2662882154638115,5.655315916504016,4.960155307961423,5.514853891003074,6.159834607936549,5.895756198458694,798747.2727272727,6,6,5,4,8,8,9,1.0,1,0,1,-2,2,2,2
1394,6.011054864776469,5.55244510040105,5.162548705350573,4.7652039701693525,5.612754281658993,5.813287599732942,5.271800107376598,647035.2205607477,8,E01001417,9,0,2,8,2,1,6.078963237948122,5.481538112606622,5.228356822402076,4.801452842644886,5.5888609510607425,5.916834903396336,5.39316139938557,801800.2,9,9,0,1,9,3,2,1.0,1,0,0,-1,1,1,1
1395,5.74172469751894,5.369634428792748,5.581467957536051,4.918970807524752,5.541575649553094,6.033808509180369,5.692689829621433,447993.7727272727,6,E01001418,6,4,5,6,5,7,5.706340790291628,5.334944917758306,5.603023825089137,4.9204398880402245,5.54178140660127,6.1065535595019655,5.724377928177516,572917.075,7,7,5,4,8,7,7,1.0,1,1,1,-1,2,2,0
1396,5.703942613282674,5.51225998452012,5.4546574660589995,4.9101348485745175,5.501891442587678,6.02413474170255,5.569740767210302,478553.1549295775,5,E01001419,8,2,5,5,5,5,5.74685593459167,5.320380739867687,5.470945738648114,4.861979629648359,5.455559781507442,6.027885480146659,5.618512131665883,611130.5953947369,7,7,2,2,6,6,5,1.0,2,-1,0,-3,1,1,0
1397,5.649391770362854,5.492463496542468,5.415381162436967,4.887508631981525,5.564018856618822,5.952611257120506,5.527773573226535,447663.206185567,5,E01001420,8,2,5,7,4,5,5.693962574656544,5.363725683076786,5.524685766527561,4.941524278922159,5.549518579993743,6.054936918404584,5.599156715179402,572541.8032786886,6,7,3,4,8,6,5,1.0,1,-1,1,-1,1,2,0
1398,5.734559170743252,5.407864759154354,5.452831736693145,4.927005584358324,5.434779343030131,5.971552586724572,5.481896980434445,447291.21276595746,6,E01001421,7,2,5,3,4,4,5.658157430499433,5.353092809039426,5.58077727742942,4.906482711613896,5.4386823155793795,6.0447651923420915,5.574213152190289,572104.7409638554,6,7,4,3,6,6,5,1.0,0,0,2,-2,3,2,1
1399,6.228888371005291,5.32474177167183,5.582595307652543,4.603559891988591,5.803026867348973,6.201790047128026,5.7372398768983235,733000.6097560975,9,E01001422,6,4,0,9,8,8,6.132349363339492,5.281637355003482,5.5443582269880505,4.694174796537636,5.662189248730154,6.246881691458958,5.6968429688534705,927922.1797385621,9,6,3,0,9,9,7,1.0,0,0,-1,0,0,1,-1
1400,5.529978894851577,5.333999093989251,5.565355176657018,5.036942821992954,5.362505155549923,6.003982396192954,5.503994350701991,657639.1197183098,3,E01001423,6,4,7,2,5,4,5.579114982745791,5.11905195569032,5.6807437071064175,4.9463926193698144,5.455155887059718,6.083538314640122,5.592823192577234,833371.3758389262,5,3,6,4,6,7,5,1.0,2,-3,2,-3,4,2,1
1401,5.328016757965088,5.45492612747919,5.299069495428176,5.076443638120379,5.282978103274391,5.824464536848522,5.426882931164333,656984.6666666666,1,E01001424,8,0,8,1,2,3,5.480376094579697,5.101664282381535,5.563310697674751,5.059415712952614,5.4077597707509995,5.921956732869148,5.589654505252838,832514.6875,4,3,4,6,5,4,5,1.0,3,-5,4,-2,4,2,2
1402,5.478081269936415,5.446252485203848,5.307520081293215,5.030690957796206,5.317588603969187,5.7542721232653715,5.252055411296794,663970.9383259912,3,E01001425,7,0,7,1,1,1,5.4244164722235135,5.263285293239929,5.427651234251685,4.997026084357226,5.246191360461662,5.8070826670115965,5.439879401957141,841301.8535564854,3,6,2,5,2,2,2,1.0,0,-1,2,-2,1,1,1
1403,5.332813339168522,5.430424907580525,5.401386055816599,5.0094483425828065,5.280749775114513,5.826118621696421,5.248077167945654,608320.612244898,1,E01001426,7,1,7,1,2,1,5.289471239057081,5.255091018512331,5.445842220043314,5.096656219712619,5.1836735026589755,5.837576198577881,5.376013082471387,772080.0275862069,1,5,2,7,1,2,1,1.0,0,-2,1,0,0,0,0
1404,4.81496991037477,5.7886938080720025,4.79081698533491,5.503019129976313,4.88775989180761,5.206037085318396,4.745247080182353,609709.1134751773,0,E01001427,9,0,9,0,0,0,4.9393340313324225,5.55336434090579,4.972404233283466,5.429382394861292,4.980471417031906,5.3633939841831175,4.8879696177663625,773104.3067129629,0,9,0,9,0,0,0,1.0,0,0,0,0,0,0,0
1405,5.634983272448073,5.4072429237574555,5.460725504116421,4.89470435581068,5.428513747932267,6.016083565941693,5.444249557752679,659000.7737226278,5,E01001428,7,2,5,3,5,3,5.599096286375791,5.2274457018896445,5.653828652489264,4.840372269516749,5.506342652617701,6.074016182627899,5.658640364937435,834827.7549668874,5,5,5,2,8,7,6,1.0,0,-2,3,-3,5,2,3
1406,5.180276513933302,5.469049292010861,5.407188645609609,5.16006320089727,5.136770916985465,5.662246395657946,5.370501721655573,618832.5804195805,0,E01001429,8,1,9,0,0,2,5.209950808459108,5.32831860713239,5.443105561178435,5.156151066036345,5.228201743941637,5.760663544606863,5.359467734330855,785136.1446540881,1,7,2,8,1,1,1,1.0,1,-1,1,-1,1,1,-1
1407,5.428142748002348,5.322168974013164,5.553071743455426,4.942034673074196,5.43892397551701,5.864093595537646,5.339856437568007,642865.6724137932,2,E01001430,6,4,6,4,2,2,5.341668531946514,5.200693854819173,5.554848751296168,5.017667261154755,5.289129953021589,5.894790613132974,5.389962393304576,819073.4021739131,2,4,4,6,2,3,2,1.0,0,-2,0,0,-2,1,0
1408,5.424823507808504,5.50194247904278,5.435634233838036,5.086255764961242,5.296467568760827,5.825642349606468,5.323060089065915,608600.5333333333,2,E01001431,8,2,8,1,2,1,5.38956222931544,5.275449459459267,5.573097532870722,5.139084862727745,5.287385572405422,5.784171543869317,5.322014507125406,772408.1960784313,3,6,4,8,2,1,1,1.0,1,-2,2,0,1,-1,0
1409,5.254723484884172,5.321899919701902,5.55018157286932,5.079604264073724,5.298897340793737,5.877247485538457,5.256595918796206,631140.7718120805,1,E01001432,6,4,8,1,2,1,5.165681685462142,5.1751814150449,5.521576205889384,5.17592543182951,5.178520783330455,5.750664942192309,5.304724169499947,805974.9166666666,0,4,3,8,1,1,1,1.0,-1,-2,-1,0,0,-1,0
1410,5.177787526448568,5.599262201786042,5.280859629975425,5.136929870314068,5.223246928056081,5.760199629598194,5.283878582053714,650429.1166666667,0,E01001433,9,0,9,0,1,1,5.173541777630143,5.491116295006069,5.264795477620236,5.224980705885717,5.1178953823099285,5.773681327776256,5.306059299386697,824655.9543147208,0,9,0,9,0,1,1,1.0,0,0,0,0,0,0,0
1411,5.150717094089046,5.584289276238644,5.366210482337258,5.218632010799466,5.2246588441458615,5.783969463724079,5.277227814450408,650820.8787878788,0,E01001434,9,1,9,0,1,1,4.948176909018965,5.5244448745951935,5.383504616863587,5.456279631923227,5.068591132760048,5.765853124506333,5.397297992425806,825131.7426470588,0,9,1,9,0,1,2,1.0,0,0,0,0,0,0,1
1412,5.123880088329315,5.607469081878662,5.417035863949702,5.110334272568043,5.26283270579118,5.796796966057557,5.264940877373402,652475.6923076923,0,E01001435,9,2,8,1,1,1,5.0265845687119,5.433196191935195,5.423322977478971,5.316700669908032,5.133579910415964,5.752564029595287,5.36987302598265,827033.5360824743,0,8,1,9,0,1,1,1.0,0,-1,-1,1,-1,0,0
1413,5.450869183242321,5.345998590439558,5.578433725237846,4.965447597205639,5.374595370143652,6.009699876606464,5.5329305194318295,651691.0625,3,E01001436,6,4,6,2,5,5,5.323845414245653,5.280696320083906,5.541624277642688,5.097157317887312,5.295413577331687,6.01571820292083,5.628139586568628,826117.8679245283,2,6,3,7,2,5,6,1.0,-1,0,-1,1,0,0,1
1414,5.00354607573492,5.729775269905885,5.003737100140604,5.403751270326679,5.059505475546889,5.400255133489329,4.978972090747887,651554.4248496994,0,E01001437,9,0,9,0,0,0,5.00928372746647,5.643742298135663,4.995514858595215,5.4785184279526815,4.9913339527526706,5.466650715676865,5.110899037889915,826026.0257425742,0,9,0,9,0,0,0,1.0,0,0,0,0,0,0,0
1415,5.402738982026682,5.316879916490999,5.523486465028247,5.10779537794725,5.344241169263732,5.887375116348267,5.290776332219441,651250.6163522012,2,E01001438,5,3,8,2,3,1,5.230494559556246,5.341524735093117,5.514434963464737,5.20077056735754,5.204126427322626,5.824126391112804,5.389582927525043,825670.70625,1,7,3,9,1,2,1,1.0,-1,2,0,1,-1,-1,0
1416,5.3143325628859275,5.363135394085659,5.541091805093743,4.994172190012557,5.330845556232367,5.867661956990703,5.436380626780264,653242.2303370787,1,E01001439,6,3,6,1,2,3,5.239186376497891,5.21720826625824,5.511434744076175,5.102737097450383,5.169311308070441,5.870789160385975,5.4791513648481,828100.0994475138,1,5,3,7,0,3,3,1.0,0,-1,0,1,-1,1,0
1417,5.501699847834451,5.439966190428961,5.536963184674581,4.9534392449117846,5.440521290614491,5.960906275681087,5.485670208930969,653483.5416666666,3,E01001440,7,3,6,4,4,4,5.398834923903148,5.363881363073985,5.476442920366923,5.114414825439453,5.285475335121155,5.898862466812134,5.539015284379324,828539.8533333334,3,7,2,7,2,3,4,1.0,0,0,-1,1,-2,-1,0
1418,5.40194567673498,5.466079639016296,5.468871282158996,5.026370312670152,5.354766110722109,5.8837144357695,5.368483595710864,651679.165467626,2,E01001441,8,2,7,2,3,2,5.152505238560865,5.437375224419754,5.425921320045082,5.275762935624505,5.196397864905587,5.775628761653483,5.3206142126208675,826147.5401459854,0,8,2,9,1,1,1,1.0,-2,0,0,2,-1,-2,-1
1419,5.494997562397094,5.337854283196585,5.591348435197558,4.956751586425872,5.40736367163204,5.984751292637417,5.403608520825704,651486.8571428572,3,E01001442,6,4,6,3,4,2,5.196614495345524,5.305298256022589,5.60761486916315,5.168759724923542,5.254885618175779,5.893592479683104,5.396423402286711,825921.3095238095,1,6,5,8,2,3,2,1.0,-2,0,1,2,-1,-1,0
1420,5.215772593792398,5.6085948819544775,5.233307537747852,5.139234051182496,5.183182718148872,5.77494225632492,5.247696217612841,650490.0597014925,0,E01001444,9,0,9,0,1,1,5.11778781829624,5.611893946971368,5.1728435711029475,5.315115295418906,5.025071819441034,5.674720391221003,5.253372543448702,824604.0825688073,0,9,0,9,0,0,0,1.0,0,0,0,0,0,-1,-1
1421,5.410109736956656,5.762530105188489,4.981875274640818,5.133651580040653,5.150906193070114,5.5673102323586745,5.056180423436065,649759.0026041666,2,E01001445,9,0,8,0,0,0,5.502866003773,5.632592009632501,5.064053486282676,5.0961699556596205,5.158379540191625,5.724295581528063,5.28809118310217,823935.2772277228,4,9,0,7,0,1,0,1.0,2,0,0,-1,0,1,0
1422,5.495509045330558,5.349926867822963,5.617920941255224,5.025294359274737,5.39240118837732,6.002264227454118,5.3475729180133245,651052.3307086615,3,E01001446,6,5,7,3,5,2,5.3290986561960025,5.212241809497508,5.66397779117259,5.105498609616775,5.388791976048965,5.98891266187032,5.426867224449335,825409.4573643411,2,5,6,7,5,5,2,1.0,-1,-1,1,0,2,0,0
1423,5.367720369663504,5.42326541741689,5.408500851028496,5.145833627217346,5.287847691939937,5.792564045223925,5.287912250392967,650316.1180555555,2,E01001447,7,1,9,1,1,1,5.229148459518756,5.348754823839706,5.565832857529603,5.125270765156291,5.224536851101123,5.879089375687993,5.392764902788843,824511.9752650177,1,7,4,8,1,3,2,1.0,-1,0,3,-1,0,2,1
1424,5.52819527387619,5.273046894506975,5.616494791074232,5.0090128562667156,5.373446810245514,6.0454029430042615,5.446597974950617,650829.2272727273,3,E01001448,5,5,7,2,5,3,5.434289537943327,5.217991419709646,5.786240221216128,5.071877886469547,5.389136713284713,5.966050835756155,5.3693650766060905,825173.4903846154,3,5,7,7,5,4,1,1.0,0,0,2,0,3,-1,-2
1425,5.08672168450569,5.627714536083278,5.332879168773765,5.263221198943124,5.126692112702043,5.73278306847188,5.286568638104112,649890.2835820896,0,E01001449,9,1,9,0,1,1,5.003320065411654,5.449828240004453,5.380667712471702,5.281705543127927,5.1586967685005884,5.7716618732972576,5.264830802787434,824126.7818181819,0,8,1,9,0,1,0,1.0,0,-1,0,0,0,0,-1
1426,5.575341230172377,5.22606467344822,5.6818595629472,4.877995896950746,5.486064702425248,5.975348395567674,5.52882125561054,659926.0307692308,4,E01001450,4,6,4,5,4,5,5.554272111058236,5.16835983812809,5.680449202060699,4.8996610540151595,5.423815470933914,5.949450436234474,5.59460697889328,836254.125,5,4,6,3,6,4,5,1.0,1,0,0,-1,1,0,0
1427,5.97653097173442,5.325516333902516,5.637661153567586,4.667874913284744,5.618500663462468,6.14124347967802,5.681185560525903,660724.4347826086,8,E01001451,6,5,1,8,7,7,5.918114849994349,5.284155733363573,5.71202598200288,4.752821828736815,5.6312284483466035,6.130502180997715,5.74616564567699,837242.1744186047,8,6,6,1,9,7,8,1.0,0,0,1,0,1,0,1
1428,5.947225385808689,5.279527781481411,5.542358261378691,4.694899362038801,5.622169662924374,6.049387808152061,5.672702634398313,661227.0,8,E01001452,5,3,1,8,5,7,5.9042689581460595,5.156463905980315,5.723600108412247,4.826000502592401,5.665484734728366,6.1777525793148,5.8574650996847994,837988.2183544304,8,4,7,2,9,8,9,1.0,0,-1,4,1,1,3,2
1429,6.115500269544886,5.21638089037956,5.8066575131517775,4.631526471706147,5.819872956580304,6.351366223680212,5.808382914421406,665244.6936170213,9,E01001453,4,7,0,9,9,8,5.982192726135254,5.255329745610555,5.690165085262723,4.7630699274275035,5.652818796369765,6.3018043327331545,5.819678765932719,843110.4844444444,9,5,6,1,9,9,8,1.0,0,1,-1,1,0,0,0
1430,5.961224154649277,5.24164668790895,5.736093447758601,4.695054871464207,5.662955115823185,6.266493523282703,5.651427530595081,662732.3348416289,8,E01001454,4,6,1,8,8,7,5.8705079555511475,5.237540001218969,5.751703004042308,4.892769833405812,5.576874247103026,6.278181449933485,5.896904367389101,839979.6363636364,8,5,7,3,9,9,9,1.0,0,1,1,2,1,1,2
1431,5.746629507495807,5.238752518135768,5.657341359899594,4.783479251540625,5.492829306767537,6.095780272896473,5.542892689315172,660067.5432692308,6,E01001455,4,5,2,5,6,5,5.6071711134428925,5.248163259390629,5.698065663828994,4.963306110916716,5.432685782210996,6.061760492999144,5.572202808327145,836417.0505050505,5,5,6,5,6,6,5,1.0,-1,1,1,3,1,0,0
1432,5.954206831753254,5.229215373285115,5.870396105572581,4.721617599017918,5.627794811502099,6.36207002773881,5.906054944731295,661884.5625,8,E01001456,4,8,1,8,9,9,5.873313475847244,5.125976386070252,5.828251104354859,4.745001966953278,5.592543439865112,6.290070676803589,5.980748829841613,838570.38,8,3,8,1,9,9,9,1.0,0,-1,0,0,1,0,0
1433,5.952651082330449,5.244795793181012,5.677190255207621,4.704255330334803,5.566455627702604,6.12495662452309,5.704185726536307,661694.4649681528,8,E01001457,4,6,1,7,7,7,5.737557679414749,5.176204209144299,5.748021671405206,4.838547572493553,5.550123262863893,6.1199884208349085,5.606318888755945,838343.125,7,4,7,2,8,7,5,1.0,-1,0,1,1,1,0,-2
1434,5.229981301696437,5.422718900783806,5.3546659164367965,5.100356393558964,5.234984888392649,5.644234027072883,5.2626714622898465,664670.8343949044,0,E01001458,7,1,8,0,0,1,5.174917717532414,5.385963752502349,5.264519126676932,5.196108320864235,5.03384900383833,5.631162137520023,5.239618492562596,842239.8292682926,0,8,0,9,0,0,0,1.0,0,1,-1,1,0,0,-1
1435,5.4310535567147395,5.3292231449059075,5.551002534798213,4.89323536498206,5.353454669884273,5.997246847833906,5.357485888685499,657583.9928571428,2,E01001459,6,4,5,2,4,2,5.432067950846443,5.220263455955076,5.6830001599352125,4.9137794602085165,5.254345739391488,6.0169783813852655,5.522197580673326,833347.4718309859,3,5,6,3,2,5,4,1.0,1,-1,2,-2,0,1,2
1436,5.555521810596639,5.309009924530983,5.656936068426479,4.96893807026473,5.368302880363031,6.026626906611702,5.437690007415685,657004.4431818182,4,E01001460,5,5,6,2,5,3,5.465198593578119,5.162748962983318,5.671103795369466,4.943439358952402,5.375839411527261,6.001366601593193,5.509542933825789,832666.091954023,4,4,6,4,4,5,3,1.0,0,-1,1,-2,2,0,0
1437,5.750940332879553,5.334337904736712,5.506495389071378,4.901498237689892,5.466921236131575,5.983537967388447,5.4822126543605245,658697.6293706293,6,E01001461,6,3,5,4,4,4,5.629374922977553,5.289440168274774,5.685637467437321,4.891469514204396,5.482685724066363,6.002597366770108,5.536092796259457,834701.2986111111,6,6,6,3,7,5,4,1.0,0,0,3,-2,3,1,0
1438,5.460980857119841,5.377524615736569,5.5323553870705995,4.9656665016623105,5.3251221656799315,5.971711537417243,5.497619884154376,657930.305882353,3,E01001462,6,3,6,1,4,4,5.570237690752203,5.107139814983714,5.788985861973329,4.96311105652289,5.4655552208423615,6.010387726805427,5.492798981341449,833761.3068181818,5,3,8,5,7,5,3,1.0,2,-3,5,-1,6,1,-1
1439,5.446287072679532,5.3073644840492396,5.520123109877485,5.008065435121644,5.376442122009565,5.9980214436848955,5.412267715676026,659945.8616352201,3,E01001463,5,3,7,2,5,3,5.6088366111119585,5.118393995058843,5.626425468004667,4.9076493214338255,5.3928024210991,6.063925680441734,5.571750224400789,836201.1474358974,5,3,5,3,5,6,5,1.0,2,-2,2,-4,3,1,2
1440,5.619909870342945,5.360450855390293,5.535407451194103,4.895999487929457,5.401019849176482,6.01332501351364,5.555629141687408,660177.2519685039,5,E01001464,6,3,5,3,5,5,5.670023038877663,5.183292240115768,5.69810551616317,4.778232679299429,5.520566848998374,6.099863534278058,5.621735552523998,836615.3120567376,6,4,6,1,8,7,5,1.0,1,-2,3,-4,5,2,0
1441,5.473497696411916,5.421794840005728,5.400471930626111,5.0227062335381145,5.319711998792795,5.847035442254482,5.370613066966717,663359.5487179487,3,E01001465,7,1,7,1,2,2,5.326763880186976,5.3942945418436885,5.356424051753724,5.20376240416785,5.155345775804467,5.8160595604069325,5.433984940223272,840611.4198895028,2,8,1,9,0,2,2,1.0,-1,1,0,2,-1,0,0
1442,5.621802954838194,5.12486539078855,5.781781829636673,4.720336977092699,5.484033513343197,6.0787358941703005,5.583100451820198,663936.4942528736,5,E01001466,2,7,1,5,6,5,5.509036580721538,5.147328983992338,5.668543095390002,4.867525501797597,5.18006598452727,5.9985191822052,5.686913043260574,841255.1979166666,4,4,6,3,1,5,7,1.0,-1,2,-1,2,-4,-1,2
1443,5.636498549710149,5.124699526506921,5.832266447336777,4.691331575746122,5.43113316660342,6.126352893269581,5.561540985884874,663899.3695652174,5,E01001467,2,8,1,3,7,5,5.537808028134433,5.108090013652653,5.710097870269379,4.853038146898344,5.1923472711018155,6.084128469615788,5.708214722670518,841180.2727272727,4,3,6,2,1,7,7,1.0,-1,1,-2,1,-2,0,2
1444,5.715175535794947,5.490653304125039,5.334657504763943,4.871465632531526,5.429363047585505,5.847431942764739,5.400479761848735,671358.9737827715,6,E01001468,8,1,4,3,2,2,5.4859441287558655,5.471772804342467,5.304841631959224,5.130258928599028,5.329684491815238,5.7864455683477996,5.369954076820407,850015.4827586206,4,9,0,8,3,1,1,1.0,-2,1,-1,4,0,-1,-1
1445,5.790232664829976,5.434458514806386,5.492469533714088,4.8068869062372155,5.569829532906816,6.035103425464115,5.569053566133654,671055.1135135135,6,E01001469,7,3,3,7,5,5,5.598053665084635,5.352226953455471,5.5451632897484116,4.942294821382206,5.507636343094116,6.025712279712453,5.578022919236657,849928.7914438503,5,7,3,4,8,6,5,1.0,-1,0,0,1,1,1,0
1446,5.887091193214689,5.458231585033554,5.351071752632091,4.775967925301592,5.613455371282,5.964446710841275,5.489230397469834,670184.4039087947,7,E01001470,8,1,2,8,4,4,5.862186122563929,5.404255441201278,5.390502295852486,4.866942753199658,5.5431199408824146,5.9879568176331865,5.45049430264367,848888.2058823529,8,8,1,3,8,5,2,1.0,1,0,0,1,0,1,-2
1447,6.036971536420641,5.389811305772691,5.601062533401308,4.750177943280765,5.693637985558737,6.036371135995502,5.64801789252531,671873.2916666666,8,E01001471,7,4,2,9,5,7,5.88410500554662,5.303745480744462,5.574388577749855,4.784588238126354,5.521575216399996,6.127042163359492,5.6659029463404105,850947.322368421,8,6,4,1,8,7,6,1.0,0,-1,0,-1,-1,2,-1
1448,5.871968089163988,5.266320454663243,5.720839223642459,4.696383148774333,5.546607819781906,6.162252626199832,5.654755258012092,669010.1781609196,7,E01001472,5,6,1,6,7,7,5.886277449205986,5.207085386012335,5.781402830807668,4.747411856111491,5.687488819818077,6.14824393260404,5.648579355305846,848054.0817610063,8,5,7,1,9,8,6,1.0,1,0,1,0,3,1,-1
1449,5.8485607249396185,5.455430564426241,5.421364613941738,4.80824114822206,5.6410109190713795,6.079142403034937,5.649553308032808,667750.8,7,E01001473,8,2,3,8,6,7,5.950088638477225,5.3370031421146695,5.562371999498398,4.717247163177167,5.609804711013875,6.199641737357649,5.803337801701177,846055.3492063492,9,7,4,0,9,8,8,1.0,2,-1,2,-3,1,2,1
1450,5.986038827184421,5.339117235805265,5.6156629341751785,4.724284304908259,5.617892361992034,6.144464070524149,5.69131659453188,666612.0945273632,8,E01001474,6,5,1,8,7,7,5.957199219163957,5.345373600393861,5.676334378483531,4.760280027494326,5.608638255150764,6.199408595378582,5.653492833231832,845236.1978021978,9,7,6,1,9,8,6,1.0,1,1,1,0,1,1,-1
1451,6.033803459025023,5.375622285352208,5.485091403806853,4.815737228670556,5.6189659270013514,6.1019114488388,5.763463652480192,669014.0705394191,8,E01001475,6,3,3,8,6,8,6.131740187914177,5.323418479787105,5.7364370195489185,4.669950165246663,5.668508786333805,6.317744655472239,5.9913254291817335,847493.7846889952,9,7,7,0,9,9,9,1.0,1,1,4,-3,1,3,1
1452,5.371185078742398,5.351253721364744,5.551022447598208,5.03428899482557,5.279372358777721,5.8850805896103004,5.466752082678922,605156.0127388535,2,E01001476,6,4,7,1,3,4,5.174711643772967,5.329629285370602,5.537685532780254,5.3367183322415634,5.1660570362034965,5.848308969946468,5.359743823899942,768274.3014705882,0,7,3,9,0,2,1,1.0,-2,1,-1,2,-1,-1,-3
1453,5.501026546323536,5.589011907577515,5.287080367669365,5.000753957704203,5.218054379848455,5.804604097312649,5.30078253327616,605396.5562913907,3,E01001477,9,0,7,0,1,1,5.465891070663929,5.503852548175736,5.370200740271493,5.040752282660258,5.199691912453425,5.866085541091468,5.287544851240359,768549.5625,4,9,1,6,1,3,0,1.0,1,0,1,-1,1,2,-1
1454,5.576649929347791,5.306451103840655,5.595004650584438,4.872872027040225,5.387145449543557,6.051539000014813,5.55974168735638,649664.5321637427,4,E01001478,5,4,4,3,5,5,5.669040952297236,5.195754859621162,5.6747860253251945,4.856565051520897,5.420642664890416,6.171624129971131,5.660538372614526,831513.2781456953,6,4,6,2,6,8,6,1.0,2,-1,2,-2,3,3,1
1455,5.475370358930875,5.242910433305453,5.573094572106453,4.99537360913133,5.381174951383512,5.91081573865185,5.443235060123548,605929.8356164383,3,E01001479,4,4,6,2,3,3,5.3265578633262995,5.141368235860552,5.715760380232415,4.995230658524702,5.2995528412513995,5.930288517556223,5.402261557222223,768931.918367347,2,3,7,5,3,4,2,1.0,-1,-1,3,-1,1,1,-1
1456,5.5963489914572,5.4022033672459076,5.438806391709687,4.821165762200261,5.344524119073982,5.949291271879184,5.539838404844928,657246.357615894,4,E01001480,7,2,3,2,4,5,5.561566165865284,5.202798188549199,5.623716524202529,4.839471011945646,5.377706554654527,6.031047122119224,5.687144368478696,832986.3972602739,5,4,5,2,4,6,7,1.0,1,-3,3,-1,2,2,2
1457,5.140099242409283,5.382752279546809,5.482067238200795,5.166322789090202,5.198162667891559,5.759768252704233,5.218195096694212,605743.8181818182,0,E01001481,7,2,9,0,1,0,5.057637939427761,5.460633171365616,5.472234164146667,5.3575554496430335,5.126446203348484,5.725781707053489,5.172627773690731,768978.1861702128,0,8,2,9,0,1,0,1.0,0,1,0,0,0,0,0
1458,5.480487049144247,5.309234177547952,5.533978968081267,4.96898222591566,5.380525980825009,5.969916244175123,5.396227198061736,605990.2260869566,3,E01001482,5,3,6,2,4,2,5.356362127221149,5.299420081014219,5.621399017002272,5.102346938589345,5.322930578563525,5.952402809391851,5.38550310238548,769244.1652173913,2,6,5,7,3,4,1,1.0,-1,1,2,1,1,0,-1
1459,5.3760203344877375,5.686032666716465,5.161659135374912,5.102054055346999,5.228864451480466,5.672137254892394,5.215534111095029,606439.1337209302,2,E01001483,9,0,8,0,0,0,5.334891846030951,5.5576646566390995,5.335274258255959,5.11660670414567,5.18770580291748,5.792948187887669,5.211635106056929,769654.11875,2,9,1,7,1,1,0,1.0,0,0,1,-1,1,1,0
1460,5.20835255075384,5.34395877343637,5.436726658432572,5.079247969168204,5.173854389897099,5.819478008482191,5.205153270120974,626449.0444444445,0,E01001484,6,2,8,0,2,0,5.0185288747151695,5.426854181289673,5.4688319957617555,5.256055210575913,5.098455948540659,5.795805318427808,5.253369246107159,800604.5696969697,0,8,2,9,0,1,0,1.0,0,2,0,1,0,-1,0
1461,5.403813482240866,5.302144003278427,5.589616648113455,5.006794201508733,5.291814484669052,5.867325908355131,5.351203057602162,607016.4198473282,2,E01001485,5,4,7,1,2,2,5.340996016551109,5.16534469597531,5.675910649508455,4.966235633314091,5.2872814496938325,5.8686426364592394,5.341822931366245,770471.2773722628,2,4,6,5,2,3,1,1.0,0,-1,2,-2,1,1,-1
1462,5.320680647888439,5.490973261378755,5.399952670071749,5.057832170652863,5.24488881290359,5.79324861420881,5.2152119594932405,607609.899328859,1,E01001486,8,1,8,0,1,0,5.336120149184918,5.343185621294482,5.581489183984954,5.126689259759311,5.244847029653089,5.834163894324467,5.272041558397227,771177.448275862,2,7,4,8,1,2,0,1.0,1,-1,3,0,1,1,0
1463,5.485174235430631,5.201052362268621,5.765544910864397,4.990227913856506,5.395696617256512,6.038019691814076,5.467261570150202,606097.3727272727,3,E01001487,3,7,6,3,5,4,5.424471891131894,5.043065535611119,5.855013670592473,4.997965407782588,5.345053069550415,5.982139211276482,5.466756916251676,769366.1465517242,3,2,8,5,4,5,3,1.0,0,-1,1,-1,1,0,-1
1464,5.629479788780213,5.151543643951416,5.6740297546386715,4.859535730361938,5.406743666648865,6.018771517753601,5.378139747619629,631154.088,5,E01001488,3,6,4,3,5,2,5.622698880792633,5.170566871883423,5.6810138254630855,5.015490623993602,5.4165768700886545,5.961978532434479,5.401266066039481,805943.4796747967,6,4,6,6,5,4,2,1.0,1,1,0,2,2,-1,0
1465,5.485338181882471,5.144411768112983,5.61992883682251,4.90811924584262,5.399612175001131,5.990961241555381,5.46754894473336,606395.9020979021,3,E01001489,3,5,5,3,4,4,5.300905392851148,5.165697478396552,5.73684834923063,5.091887847866331,5.381541466712951,5.928547125203269,5.372584852150508,769740.35,2,4,7,7,5,4,1,1.0,-1,1,2,2,2,0,-3
1466,5.566479649475153,5.181237056100969,5.629713274592119,4.907144000204347,5.351541289322668,5.91374533296489,5.466875574571623,615425.0143884892,4,E01001491,3,5,5,2,3,4,5.519127927507673,5.095764264890126,5.712770204884666,4.899826697792325,5.370553937980107,6.002750354153769,5.5507996167455405,780441.1928571429,4,3,6,3,4,5,4,1.0,0,0,1,-2,2,2,0
1467,5.3719206290729975,5.147088887327809,5.62405624632108,4.981801478539483,5.288449924881175,5.981889825756267,5.3169106103606145,607166.7966101695,2,E01001492,3,5,6,1,4,1,5.3947271490469575,5.156594309024513,5.679601199924946,4.971879297867417,5.339068801142275,5.971931742504239,5.293146795593202,770714.4296875,3,4,6,5,3,5,0,1.0,1,1,1,-1,2,1,-1
1468,5.7587905053434705,5.247857473019896,5.774664560268665,4.733017301764981,5.537689788588162,6.281292484752063,5.747167162854096,662275.0431034482,6,E01001493,4,7,2,6,9,8,5.547603236868026,5.363789051137072,5.645044940583249,4.930868585058984,5.4029653934722255,6.211466637063534,5.740354867691689,839351.340425532,5,7,5,4,5,8,7,1.0,-1,3,-2,2,-1,-1,-1
1469,5.6201881696437965,5.186550806308615,5.68578267590753,4.947282664529208,5.443924398257814,6.073387583370867,5.668067433094156,662051.9724137931,5,E01001494,3,6,6,4,6,7,5.342385879045801,5.295785279213628,5.679520382156855,5.130189711534524,5.266961208627194,6.01789994179448,5.683879219278505,839107.7468354431,2,6,6,8,2,5,7,1.0,-3,3,0,2,-2,-1,0
1470,6.18868846713372,4.864197589316458,6.014602812955964,4.661135625164464,5.627351043359289,6.535234419804699,5.910308399290408,663553.9716981133,9,E01001495,0,9,1,8,9,9,5.796840947927888,5.011030528963227,5.859147801841657,4.81128282645314,5.457567260437405,6.304427454152058,5.787585185975144,840731.9793814434,7,2,8,2,7,9,8,1.0,-2,2,-1,1,-1,0,-1
1471,5.75257746600572,5.235599824836134,5.767406037399889,4.8241198961961205,5.5172624847742435,6.243213934605348,5.642385915005007,663246.6312849162,6,E01001496,4,7,3,5,8,6,5.527857908047736,5.150921591557562,5.7381074875593185,5.02741518151015,5.368472808972001,6.248003961518407,5.799328972585499,841003.765625,4,4,7,6,4,9,8,1.0,-2,0,0,3,-1,1,2
1472,5.476455054256354,5.432262999957867,5.453270633568924,5.064410213674052,5.32616550533959,5.925555064437095,5.436847154344066,662529.4269662921,3,E01001497,7,2,8,1,3,3,5.1656038510865265,5.415072050542463,5.499940069999484,5.284496231632338,5.1208815574646,5.851826320036999,5.358485107922422,839461.4198895028,0,8,3,9,0,2,1,1.0,-3,1,1,1,-1,-1,-2
1473,5.651355429434441,4.917640135321818,5.910951012456921,4.81756532947782,5.519099953308912,6.099849511200274,5.594849663721004,665785.5915492958,5,E01001498,0,8,3,6,6,6,5.529534124348261,4.906315018052924,5.831125354113644,4.956161677020869,5.3763218636382115,6.0296046448080505,5.573592814680648,843371.4726027397,4,1,8,4,4,6,5,1.0,-1,1,0,1,-2,0,-1
1474,5.335687757552939,5.4826411952363685,5.470040661730665,5.0861346863685775,5.24847312430118,5.835271581690362,5.36188523820106,664151.6680851064,1,E01001499,8,2,8,0,2,2,5.034238508043363,5.426188713820406,5.359811897425688,5.31804061813872,4.977336664070455,5.738469482392304,5.395449627277463,841604.8178294573,0,8,1,9,0,1,2,1.0,-1,0,-1,1,0,-1,0
1475,5.712680575522509,5.245968610048294,5.688839966600591,4.843466606104013,5.468120979540275,6.086937821272648,5.571331004301707,665209.0303030303,6,E01001500,4,6,4,4,6,5,5.408990571861132,5.235350973614534,5.573437355432409,5.066788980059405,5.187538794830916,5.948749788237124,5.498917707706087,842878.0600706714,3,5,4,7,1,4,3,1.0,-3,1,-2,3,-3,-2,-2
1476,5.702523515823691,5.27124200147741,5.638128248765507,4.892863107237586,5.4617346008831165,6.019909950501141,5.54119474365112,666226.6737967915,5,E01001501,5,5,5,4,5,5,5.53471061559481,5.243681007456557,5.52503269632286,5.056028279188637,5.264961658237136,5.963084585198732,5.591356852901316,844167.953271028,4,5,3,6,2,4,5,1.0,-1,0,-2,1,-2,-1,0
1477,5.254711328798039,5.477669136539387,5.387609134054488,5.22289001334245,5.264612219895527,5.785426766249784,5.25469036390827,643330.3248407643,1,E01001502,8,1,9,1,1,1,5.029369279628492,5.296208206023879,5.383585564962781,5.2275315241049265,5.097277331898231,5.709547980141093,5.135657441525059,812551.6106870229,0,6,1,9,0,0,0,1.0,-1,-2,0,0,-1,-1,-1
1478,5.323929134583631,5.429318913560829,5.527231543269378,5.0335473216922075,5.285045513254127,5.932576174767601,5.33785137672298,653296.8741721854,1,E01001503,7,3,7,1,3,2,5.285458636283875,5.292237655869846,5.577464802511807,5.151710679613311,5.237520092931287,5.8627601393337905,5.359014716641656,828443.2413793104,1,6,4,8,1,2,1,1.0,0,-1,1,1,0,-1,-1
1479,5.320261665012525,5.468406433644502,5.448924680378126,5.046317401139633,5.3046015076015305,5.880021903825843,5.339426546511443,652913.7739130434,1,E01001504,8,2,7,1,3,2,5.160918550613599,5.464251043450119,5.399731988580818,5.261833137936062,5.118252547378214,5.820033927249093,5.482548068731259,827631.1367521368,0,9,1,9,0,2,3,1.0,-1,1,-1,2,-1,-1,1
1480,5.428660951742605,5.33733690285883,5.591566446448574,5.026950992456003,5.367489622420623,5.963347445015146,5.451760295058499,652885.6722689075,2,E01001505,6,4,7,2,4,3,5.243921067755101,5.330272781646858,5.6174207501492255,5.126492385136879,5.237380480362197,5.982442683082516,5.5604826444286415,827585.2627118644,1,7,5,8,1,5,4,1.0,-1,1,1,1,-1,1,1
1481,5.152874382808037,5.641074093346743,4.999537411424303,5.2423927320033,5.131390865623336,5.472888234657111,5.029546588044806,644786.9845360825,0,E01001506,9,0,9,0,0,0,5.185276665123813,5.6000451486686185,5.0713645663167455,5.308589146935881,5.048428822914368,5.589596507878139,5.214903264210142,818149.9975369459,0,9,0,9,0,0,0,1.0,0,0,0,0,0,0,0
1482,5.14977445036678,5.399016088685073,5.452462363377803,5.154492250943588,5.157769410623669,5.630714124205422,5.151593889893785,653461.7457627119,0,E01001507,7,2,9,0,0,0,5.141119604700067,5.328949675801095,5.471687057045068,5.192902011817761,5.141128398729174,5.728366214237856,5.29252123229959,828276.5674157303,0,7,2,8,0,1,0,1.0,0,0,0,-1,0,1,0
1483,5.400584626371843,5.411160358547294,5.496531991192894,4.971864293961629,5.3239428605476435,5.9282824279618085,5.370593457326402,653632.1532846715,2,E01001508,7,3,6,1,3,2,5.357309667817478,5.285979485511779,5.550729748298382,5.037816452980041,5.227304365717131,5.892214558042329,5.458942211907486,828507.9172413793,2,6,4,6,1,3,3,1.0,0,-1,1,0,0,0,1
1484,5.385498098105439,5.559694034994141,5.432675618770694,5.092025964713294,5.3772050595480545,5.83490208554859,5.313483519002426,653691.214876033,2,E01001509,9,2,8,2,2,1,5.333352221051852,5.352964406212171,5.514814527829488,5.184875716765721,5.336598940690359,5.9314445952574415,5.380674863855044,828571.675,2,7,3,8,3,4,1,1.0,0,-2,1,0,1,2,0
1485,5.1422518619469235,5.615603682540712,5.030970188833418,5.290038623980114,5.1040349545932955,5.522911053328287,5.120154424792244,633681.6666666666,0,E01001510,9,0,9,0,0,0,4.922009287160986,5.677065369662117,4.9217988715452305,5.489368513051201,4.906498118007884,5.383114828782923,4.895901602857253,803262.7058823529,0,9,0,9,0,0,0,1.0,0,0,0,0,0,0,0
1486,5.229292461542579,5.490610972168,5.351994152476148,5.113067417609982,5.135319306598446,5.73965062261597,5.314583041319033,655926.8089430894,0,E01001511,8,1,8,0,1,1,5.219694679517012,5.353964668970842,5.416967815160751,5.155611936404155,5.12742706491397,5.808637006007708,5.385595580247732,831264.973076923,1,7,1,8,0,2,1,1.0,1,-1,0,0,0,1,0
1487,5.607086035589509,5.245864171066032,5.636252076420563,4.897134620622293,5.420582038677291,6.0640136627172,5.481270841415355,658912.2847682119,4,E01001512,4,5,5,3,6,4,5.53136741939713,5.201078412287376,5.741501092910767,4.867122367024422,5.373878708657096,6.0949559860369735,5.664042005644125,834840.2720588235,4,4,7,3,4,7,6,1.0,0,0,2,-2,1,1,2
1488,5.219064212749025,5.577810040020734,5.260947991738166,5.117039839310827,5.131631914102649,5.678718776118998,5.142088645401223,656809.0349854227,0,E01001513,9,0,8,0,0,0,5.152043879511529,5.566755036246681,5.268538131470974,5.241588339409304,5.084580870799661,5.691439636271377,5.259165812433565,832911.9865951743,0,9,0,9,0,0,0,1.0,0,0,0,1,0,0,0
1489,5.665910085727429,5.248892342222148,5.63527237546855,4.835199746592291,5.458681224749006,6.090631893996535,5.436913412192772,657762.8448275862,5,E01001514,4,5,4,4,6,3,5.650404532750447,5.175234446922938,5.709357116619746,4.908531575401624,5.35567352771759,6.0495210647583,5.615022213260333,833537.35,6,4,6,3,4,6,5,1.0,1,0,1,-1,0,0,2
1490,5.385974063759758,5.4114874393220935,5.478660636478001,4.942490568236699,5.396457779975164,5.887367297732641,5.25151655882124,656348.1746031746,2,E01001515,7,2,6,3,3,1,5.2787233452464255,5.317968155986579,5.505039029343184,5.0584443299345265,5.263134057207625,5.906941530316375,5.411276684250942,831852.5116279069,1,6,3,6,2,3,2,1.0,-1,-1,1,0,-1,0,1
1491,5.23982637454937,5.541056375998955,5.281576084781003,5.181539422196227,5.2516444237201245,5.757789712757259,5.235612691532482,660243.8467532467,1,E01001516,9,0,9,0,1,1,5.12556388798882,5.5214477210121355,5.312522119379299,5.2446087471304095,5.076027659808888,5.796292266743706,5.399526993858623,835713.973262032,0,9,0,9,0,1,2,1.0,-1,0,0,0,0,0,1
1492,5.152645641937852,5.538898658938706,5.386869553476572,5.118244028650224,5.294272113591433,5.742808778770268,5.2168045891448855,654776.65625,0,E01001517,9,1,8,1,1,0,5.117949716250101,5.572205688556036,5.331916277607282,5.298383727669716,5.134813362360001,5.767110842466354,5.310774514079094,829611.0916666667,0,9,1,9,0,1,1,1.0,0,0,0,1,-1,0,1
1493,5.742743078950812,5.263991765950987,5.579859315412831,4.865322290290712,5.460687793986335,6.121968822329456,5.602518364397019,659630.4869109947,6,E01001518,5,4,4,4,7,6,5.54404143659692,5.289845789106269,5.5324219716222665,4.936408148313824,5.348551865627891,6.048367057348552,5.601684565293161,835901.7894736842,5,6,3,4,4,6,5,1.0,-1,1,-1,0,0,-1,-1
1494,5.453116954748447,5.261904878799732,5.556751715219938,4.997715442914229,5.382856972400958,5.838574190323169,5.44671460206692,573605.8692307692,3,E01001519,5,4,7,2,2,3,5.4592101724524245,5.20058474415227,5.607377023027654,5.017248158287583,5.351062222112689,5.9038009760672585,5.441422635630557,727709.4070175439,3,4,5,6,4,3,2,1.0,0,-1,1,-1,2,1,-1
1495,5.7506681326663855,5.200070876063722,5.691085806759921,4.786218812971404,5.586857211951053,6.185179055820812,5.653095563252767,658454.0363636364,6,E01001520,3,6,3,7,8,7,5.815270667950783,5.156880807594435,5.71877550373416,4.857114164786931,5.566663131205993,6.142743792054215,5.714287146308719,832924.7041420118,8,4,7,2,9,8,7,1.0,2,1,1,-1,2,0,0
1496,6.123060875214064,5.320839225099637,5.654279843545877,4.602228109080058,5.742145145168672,6.2011418629151125,5.814424488980037,613471.8365384615,9,E01001521,6,5,0,9,8,9,5.921761019121517,5.292750877141953,5.5557449194518,4.745154573158785,5.510377157818187,6.080935024131428,5.772401964664459,764681.6409090909,8,6,4,1,8,7,8,1.0,-1,0,-1,1,-1,-1,-1
1497,5.885886905059008,5.350807888407103,5.4800105178859875,4.83376553360845,5.659222470202916,6.074231782429655,5.713771725204629,668042.1267605633,7,E01001522,6,2,4,8,6,7,5.958760606276022,5.347038261793755,5.550049757635271,4.8013714801620795,5.6241968145241605,6.199552853365202,5.7901007750549836,846271.4864864865,9,7,4,1,9,8,8,1.0,2,1,2,-3,1,2,1
1498,5.840997240278456,5.2906136612097425,5.658815048800575,4.748143164316813,5.67778731584549,6.159166818194919,5.7349937028355065,667923.05,7,E01001523,5,5,2,9,7,8,5.7196389605169715,5.306499584861424,5.615211902753167,4.883069316330164,5.504571762421857,6.074834363616032,5.704192274938459,846130.9673913043,7,6,5,3,8,7,7,1.0,0,1,0,1,-1,0,-1
1499,5.765740493069524,5.335526180440101,5.703055570091027,4.8092703050461365,5.667872924735581,6.1181821771289995,5.648708682993184,585421.8260869565,6,E01001524,6,6,3,8,7,7,5.755981821002382,5.317902649893905,5.703160816972906,4.915510649030859,5.5843054607059015,6.116691717595765,5.679713115547642,759784.303030303,7,6,6,4,9,7,7,1.0,1,0,0,1,1,0,0
1500,5.759501680815961,5.348637022541068,5.655535300572713,4.844177984921946,5.536250006681108,6.159129906508882,5.568422074371812,465791.6779661017,6,E01001525,6,5,4,6,7,5,5.570969613822731,5.246716634002892,5.703255860869949,4.891418045920295,5.453475682799881,6.077838191470584,5.657539541012532,598547.6270270271,5,5,6,3,6,7,6,1.0,-1,-1,1,-1,0,0,1
1501,6.076704551533955,5.1521467740942795,5.779967738360893,4.65197248938607,5.732475186266551,6.273277871492432,5.702456107226814,668753.4329268293,9,E01001526,3,7,0,9,8,7,5.9880261197686195,5.28631456270814,5.7746796071529385,4.829249709099531,5.6531732231378555,6.288861533999443,5.870482911914587,847128.79375,9,6,7,2,9,9,9,1.0,0,3,0,2,0,1,2
1502,5.8999349301861175,5.253480865109351,5.673868850995135,4.780387305444287,5.5737460883714816,6.064616633999732,5.671636753184821,666883.0053763441,8,E01001527,4,6,2,7,6,7,5.784956246471861,5.263665331037421,5.566224215703718,4.92756158712378,5.375040374874498,6.058091781926497,5.717152775759902,845005.8947368421,7,6,4,4,4,6,7,1.0,-1,2,-2,2,-3,0,0
1503,5.264561517864254,5.573729721366936,5.265121104869436,5.112645132321838,5.20698622017042,5.638518238743992,5.186146965263583,444825.1773049645,1,E01001528,9,0,8,0,0,0,5.117667490327862,5.391726905191448,5.29139862513878,5.257628241894951,5.0108861587416955,5.668410193752235,5.276411551824758,568540.5563380282,0,8,0,9,0,0,0,1.0,-1,-1,0,1,0,0,0
1504,5.773814247855058,5.325792305858423,5.651302718101664,4.869293096217703,5.512346245718341,6.068537636851588,5.5678255744014225,450866.1134751773,6,E01001529,6,5,4,5,6,5,5.536669598144739,5.283468738705123,5.484332837215086,4.9909489187253575,5.3534318662825084,5.965115279567485,5.48773103749671,577019.6598639456,4,6,2,5,4,4,3,1.0,-2,0,-3,1,-1,-2,-2
1505,5.61523446371389,5.304074010876722,5.5803327636663305,4.94381758085517,5.392032443090927,6.0526882396187895,5.572287554657737,560827.3488372093,4,E01001530,5,4,6,3,5,5,5.393871485517266,5.1997590125276805,5.550463920228936,5.040540741400772,5.194242689046967,5.929971611901616,5.53638201081351,711438.0337078652,3,4,4,6,1,4,4,1.0,-1,-1,0,0,-2,-1,-1
1506,6.247928266065666,5.132634136332086,5.9864998366459306,4.53782863861107,5.689139178000301,6.510657518743033,5.993073673133391,668256.6445783132,9,E01001531,3,9,0,9,9,9,6.046349612020311,5.046341980497043,5.879567987862087,4.796528432340849,5.553442184414182,6.408263127009074,6.0250344425439835,846511.494047619,9,2,8,1,8,9,9,1.0,0,-1,-1,1,-1,0,0
1507,6.1481271174130026,5.116713055828273,5.863734398912263,4.592600290407271,5.656858586624965,6.405458194297432,5.982843710272104,667610.0872483222,9,E01001532,2,8,0,8,9,9,6.002810901906117,5.1003079543630765,5.850781354559473,4.751147481332342,5.496115144476833,6.274049149938376,5.911125954375209,845863.6927710844,9,3,8,1,7,9,9,1.0,0,1,0,1,-1,0,0
1508,6.024670983723231,5.1943916348048615,5.724305975096566,4.7321974434171405,5.717736336844308,6.276646243504116,5.954568271636963,584989.1314285714,8,E01001533,3,6,2,9,8,9,5.819351386237931,5.216301845325218,5.707299382477016,4.87622472676602,5.501541093155578,6.217113058645647,5.879161340194744,744117.6703296703,8,5,6,3,7,8,9,1.0,0,2,0,1,-2,0,0
1509,5.825642918618981,5.2513618993298445,5.707011545913807,4.821081668282477,5.571813169884797,6.184414347588728,5.7767045618831245,450535.76328502415,7,E01001534,4,6,3,7,8,8,5.596741911310416,5.1922682007917995,5.664548410819127,4.961657837606394,5.417913783628207,6.065225228667259,5.8162986280826425,576599.6634615385,5,4,6,4,6,6,8,1.0,-2,0,0,1,-1,-2,0
1510,5.832427787638846,5.203391840060552,5.723744202227819,4.851151260591688,5.593204218716848,6.1652031271230605,5.812338134362584,630982.5238095238,7,E01001535,4,6,4,7,7,9,5.6630023725671705,5.2195890791275925,5.68645728335661,5.046069347780515,5.421918893172071,6.12373186404409,5.826778205391628,804984.9673202614,6,5,6,6,6,7,8,1.0,-1,1,0,2,-1,0,-1
1511,5.991488499813769,5.141826803425708,5.710922756348269,4.713545519185353,5.631571493953107,6.180144821304872,5.686772605980257,666286.734939759,8,E01001536,3,6,1,8,7,7,5.838778260707855,5.193519378662109,5.722694351196289,4.792717444419861,5.5176162123680115,6.120888488769531,5.6129407787323,844065.132,8,4,7,1,8,7,5,1.0,0,1,1,0,0,0,-2
1512,5.727974538590498,5.348261126287424,5.598266484631095,4.8593705748296845,5.496271242761308,6.052094787549061,5.471129048402142,670810.3057324841,6,E01001537,6,4,4,5,5,4,5.425701042880183,5.295280370653046,5.430779427475071,4.963416329822185,5.303095307409393,5.828409953887419,5.585219905243157,850004.453416149,3,6,2,5,3,2,5,1.0,-3,0,-2,1,-2,-3,1
1513,5.584199523333437,5.407606657987796,5.677429025217613,4.958165998044222,5.4948507643634485,6.121274816323512,5.572342142555284,671373.695652174,4,E01001538,7,6,6,5,7,5,5.412764830887317,5.355241603404283,5.634462109208107,5.0198539108037945,5.391287000477314,6.073644304275513,5.668826424330473,850348.5,3,7,5,6,5,7,6,1.0,-1,0,-1,0,0,0,1
1514,5.521662175000369,5.41070912041507,5.71530952165415,4.9045428194842495,5.491952097022926,6.080398212422382,5.3764357304835055,671126.1483516484,3,E01001539,7,6,5,5,6,2,5.377363542825478,5.340389737766751,5.657987148063618,4.998334326796769,5.413387348638714,6.080323772535798,5.658258646232647,850016.4364640884,2,7,6,5,5,7,6,1.0,-1,0,0,0,0,1,4
1515,5.71187022272146,5.251913643483096,5.655768048088506,4.8838949998219805,5.5220298182289556,6.064410749471413,5.556329235340814,671580.7987421383,6,E01001540,4,5,5,6,6,5,5.560468284480543,5.203264115804649,5.669909699853644,4.954685577427048,5.436643512134093,5.958535093859018,5.582325999277184,850572.6987951808,5,4,6,4,6,4,5,1.0,-1,0,1,-1,0,-2,0
1516,5.687475370888663,5.097883073410185,5.795275640959787,4.717927978770567,5.510252596128105,6.236971959029094,5.527464354392325,671762.3168316832,5,E01001541,2,7,1,5,8,5,5.598852419385723,5.109139713586545,5.75347713395661,4.860392655812058,5.383164034170263,6.157844288676393,5.705325298449573,850787.6960784313,5,3,7,2,5,8,7,1.0,0,1,0,1,0,0,2
1517,5.517042053156886,5.252277499231799,5.695034872252366,4.98067501660051,5.447117864674535,6.027292279539437,5.402630581526921,669647.9655172414,3,E01001542,4,6,6,4,5,2,5.3530143555378755,5.349207005244773,5.628925622709645,5.075391749407621,5.265331018691095,5.979419081003074,5.537379189625683,848354.966442953,2,7,5,7,2,5,4,1.0,-1,3,-1,1,-2,0,2
1518,5.72497930801172,5.363130240989246,5.786412902873197,4.907116561484852,5.536906386450898,6.157835457822402,5.567202738720736,669826.4460431655,6,E01001543,6,7,5,6,7,5,5.368541618508678,5.355340173167567,5.826330288763969,5.01263060492854,5.415056095969293,6.0578608032195795,5.6118805370023175,848560.5322580645,2,7,8,6,5,6,5,1.0,-4,1,1,1,-1,-1,0
1519,5.733713952700297,5.304192097981771,5.747040126588609,4.870110985967848,5.573350805706448,6.172917448679606,5.6907704083124795,663087.8,6,E01001544,5,7,4,7,7,7,5.600118991643062,5.3023456263439845,5.739812978859112,4.916877262582083,5.436796406307957,6.13189496707507,5.768747036549155,840381.2660944206,5,6,7,4,6,8,8,1.0,-1,1,0,0,-1,1,1
1520,5.481830101387174,5.590484231126075,5.484842613631604,4.957303745294708,5.476964785382639,5.997296916113959,5.4406291394451864,654765.3267973856,3,E01001545,9,3,6,4,5,3,5.228576719760895,5.547591098617105,5.350046525282019,5.174758613109589,5.342521325279685,6.003723165568183,5.566191514800576,829847.2058823529,1,9,1,8,4,5,4,1.0,-2,0,-2,2,0,0,1
1521,5.238306977709786,5.485359949166657,5.5356623149309,5.18836318762576,5.30961880722984,5.8401423555905705,5.101182058209279,651508.4180327869,0,E01001546,8,3,9,1,2,0,5.106023858070373,5.420100185394287,5.518413499832153,5.247837514877319,5.189370969772339,5.751770734786987,5.292916006088257,825898.912,0,8,3,9,1,1,0,1.0,0,0,0,0,0,-1,0
1522,5.457091713071469,5.388407856974769,5.602879332537627,4.935970165621695,5.379417514681217,5.9745890614974435,5.471939673375844,652100.0100502513,3,E01001547,7,4,6,2,4,4,5.323963701725006,5.250400765697555,5.611314103154853,5.058159282892057,5.256657376737878,5.9513684003659995,5.54453584404275,826663.301980198,2,5,5,6,2,4,4,1.0,-1,-2,1,0,0,0,0
1523,5.3790263770012885,5.467927011031678,5.43611394759663,5.0625202429361185,5.329216780609259,5.887295921421583,5.25606163387192,654738.3519553073,2,E01001548,8,2,8,1,3,1,5.143096203804016,5.455768593379429,5.386570788111006,5.271029945782253,5.09509475844247,5.881865610395159,5.420681940487453,829899.8685714286,0,8,1,9,0,3,2,1.0,-2,0,-1,1,-1,0,1
1524,5.349277477699305,5.41877713886845,5.404679066971769,5.048670215016467,5.3420769585848635,5.8858077456197835,5.246090415246323,653733.5960912053,1,E01001549,7,1,7,2,3,1,5.3113124465310815,5.4019739864677785,5.480656083845934,5.134125819269395,5.289562299551553,5.861406199979466,5.330666532579636,828386.5761589404,2,8,2,8,2,2,1,1.0,1,1,1,1,0,-1,0
1525,5.2626418551460645,5.458395769557015,5.352548727442007,5.038130621831925,5.312095280162624,5.779850096780746,5.207362826144109,654877.655737705,1,E01001550,8,1,7,1,1,0,5.105457842772734,5.476200047114217,5.367432156353132,5.1864529366188865,5.080714432905752,5.8200800452672,5.3878140542524084,829940.7304964539,0,9,1,8,0,2,1,1.0,-1,1,0,1,-1,1,1
1526,5.234479723504671,5.670255889529588,5.154397970252384,5.1802069109616395,5.116313054487367,5.593252825077017,5.193363014801975,653427.3702422145,0,E01001551,9,0,9,0,0,0,5.16915303961984,5.5682391290006965,5.202482521945033,5.231729968662919,5.0637171737078965,5.680391076104394,5.363032784133122,828212.5896551724,0,9,0,9,0,0,1,1.0,0,0,0,0,0,0,1
1527,5.217707257414069,5.5986335993836365,5.260917604737016,5.110725086134391,5.180415902526594,5.615510016551857,5.261525293788173,650909.2231759657,0,E01001552,9,0,8,0,0,1,5.094918131828308,5.542443588435412,5.208635597115019,5.321369346394482,5.053810977840803,5.682254658752228,5.363384994377653,825124.4621513945,0,9,0,9,0,0,1,1.0,0,0,0,1,0,0,0
1528,5.378037170599435,5.420930809647072,5.505403697035695,5.020740804781441,5.324547474620906,5.903742469904077,5.374282773214442,458180.3893129771,2,E01001553,7,3,7,1,3,2,5.257435771066751,5.234213155597003,5.540152615575648,5.078972655445782,5.2075401473401195,5.891926731636275,5.454825520515442,591996.8358208955,1,5,3,7,1,3,2,1.0,-1,-2,0,0,0,0,0
1529,5.422686293091573,5.3678065823837064,5.508233721827118,5.006006538028449,5.415881469216146,5.859004504244092,5.416785663282368,540697.9718309859,2,E01001554,6,3,7,3,2,3,5.392014875803908,5.196052734165976,5.571520596334379,5.034591678070695,5.234064017256645,5.8839316792684055,5.4437609274093415,686827.9726027397,3,4,4,6,1,3,2,1.0,1,-2,1,-1,-2,1,-1
1530,5.285162191424105,5.253928780555725,5.5906129413180885,5.054201451440652,5.259259451594618,5.892363940676053,5.2258552039663,559800.6875,1,E01001555,4,4,7,0,3,0,5.2139369286596775,5.103423663415015,5.621735688298941,5.030124822631478,5.092133739031851,5.839754745364189,5.37094678170979,707885.484375,1,3,5,6,0,2,1,1.0,0,-1,1,-1,0,-1,1
1531,5.588391460784494,5.239601868472687,5.515257564309525,4.95869185499949,5.428466885057214,6.008419580655556,5.448043584007106,611852.1232876712,4,E01001556,4,3,6,3,5,3,5.400312098880742,5.062154617885615,5.582106966300299,5.0660802261941384,5.348763033047619,5.986658640355872,5.540593391296848,777425.0201342282,3,2,4,7,4,5,4,1.0,-1,-2,1,1,1,0,1
1532,5.090417637969509,5.455091345189798,5.53335499281835,5.12540003145584,5.258181392544448,5.855414703638867,5.2602601581149635,490625.7474747475,0,E01001557,8,3,8,0,2,1,5.0743896726702085,5.2869353743850205,5.525980515558212,5.182060112718676,4.992034556435757,5.718067755464648,5.212729907426678,517181.7868852459,0,6,3,8,0,0,0,1.0,0,-2,0,0,0,-2,-1
1533,5.172932225304681,5.33397477945766,5.402313447481877,5.122097456777418,5.205691963434219,5.695558261226964,5.109818363511884,654487.9864864865,0,E01001558,6,1,8,0,0,0,5.115507709352594,5.16092912774337,5.476845034979339,5.143945117642109,5.077683118949259,5.644009830360126,5.233871858819087,842384.3759398496,0,4,2,8,0,0,0,1.0,0,-2,1,0,0,0,0
1534,4.867008768971487,5.740989951799034,4.97455230619171,5.407186172435917,4.95207159308069,5.4224098071166305,4.9386419982168634,563528.3153347733,0,E01001559,9,0,9,0,0,0,4.94696037724333,5.633512576121205,4.9860928913332385,5.406977735375459,4.870053525240916,5.4297692865695595,4.9346661810605035,551465.0905660377,0,9,0,9,0,0,0,1.0,0,0,0,0,0,0,0
1535,5.364453451409524,5.4045640599003155,5.3804944220168816,5.112629712615883,5.331179039254373,5.870528352853343,5.307044623306443,631954.729281768,2,E01001560,7,1,8,1,2,1,5.22154808111031,5.3443287757521905,5.393873393202627,5.151802760262729,5.1849566311809605,5.787848065685293,5.416729503503725,800745.843575419,1,7,1,8,1,1,2,1.0,-1,0,0,0,0,-1,1
1536,5.319373540761994,5.635402288378739,5.179275865961865,5.080596220202562,5.303205766328952,5.768711558202418,5.158954803536578,665145.5609756098,1,E01001562,9,0,8,1,1,0,5.311878830194473,5.394674664735794,5.420134319365024,5.040788175165654,5.266511805355549,5.760179153084755,5.3901191219687465,842778.6625,2,8,1,6,2,1,2,1.0,1,-1,1,-2,1,0,2
1537,5.873850994422788,5.004245659366983,5.795761311640505,4.762308224302823,5.546105187447345,6.279730837853228,5.80673796720192,663174.1147540984,7,E01001563,1,7,2,6,9,8,5.762794301529561,5.042410204233217,5.838934358486459,5.024924764948443,5.412780631672252,6.044294235134913,5.770387066297294,841369.4958677687,7,2,8,6,5,6,8,1.0,0,1,1,4,-1,-3,0
1538,6.219642914024887,5.084587804071463,5.8427884525554195,4.524368933052014,5.692259436200379,6.467698151898232,6.00945145764928,662543.0828025477,9,E01001564,2,8,0,9,9,9,5.978318049989897,5.089706355127795,5.711622057289913,4.512043698080655,5.535454075911949,6.478447420843716,6.290349631473936,840962.8965517242,9,3,6,0,8,9,9,1.0,0,1,-2,0,-1,0,0
1539,6.0312225222587585,5.093979316949844,5.922360390424728,4.746940120061239,5.648494406541189,6.36595470905304,5.93100528717041,667692.7333333333,8,E01001565,2,8,2,8,9,9,5.811061815491745,5.056478988911424,5.746096834540367,4.801846706441471,5.5142059688057214,6.335176540272577,5.899002380669117,845818.1339285715,8,2,7,1,8,9,9,1.0,0,0,-1,-1,0,0,0
1540,6.305999090912145,4.889942128723915,6.0754074591015454,4.557551737225384,5.7187771578447535,6.614912842391828,6.086149773466477,667919.9266055046,9,E01001566,0,9,0,9,9,9,6.048173810984637,4.892913698076128,5.972473589149681,4.714569579373609,5.620528210390796,6.415336926778157,6.058365140949284,846182.2702702703,9,0,9,0,9,9,9,1.0,0,0,0,0,0,0,0
1541,5.940378909525664,5.269191745182742,5.697863472544628,4.7699456020541815,5.625643565602925,6.222148522086766,5.592832635926164,665209.2065217391,8,E01001567,5,6,2,8,8,6,5.712182263158402,5.27591794391848,5.61693342001933,4.950941596391066,5.50978812631571,6.156796772524996,5.702819146075338,845149.358490566,7,6,5,4,8,8,7,1.0,-1,1,-1,2,0,0,1
1542,6.105600140675777,5.247977747636683,5.7784817950064395,4.606978636829793,5.765403773604321,6.307211499254243,5.865922740026682,667412.2058823529,9,E01001568,4,7,0,9,9,9,5.875190905332565,5.348870366811752,5.6673105478286745,4.786454301476478,5.577325376272202,6.272298965454102,5.824974962472916,845574.925,8,7,6,1,9,9,8,1.0,-1,3,-1,1,0,0,-1
1543,5.810287921548747,5.216689258456516,5.763608135479531,4.734276741814556,5.58048488081788,6.125657568732612,5.65656214766651,662682.6067146283,7,E01001569,4,7,2,7,7,7,5.58546161308563,5.101839792814186,5.753582851492244,4.894853305473602,5.435071149318338,5.954533251069432,5.656906625349745,840971.6330935252,5,3,7,3,6,4,6,1.0,-2,-1,0,1,-1,-3,-1
1544,5.615585462560931,5.355070002449369,5.535307032969391,4.915559937653033,5.458514235552075,5.9896773782748625,5.5308493717202865,661766.5097087378,4,E01001570,6,3,5,4,4,5,5.803239027659099,5.249676429977019,5.6522806870440645,4.88948913787802,5.4801718319455786,6.06317937374115,5.656963643928369,838256.71875,8,5,5,3,7,6,6,1.0,4,-1,2,-2,3,2,1
1545,5.55166378774141,5.2056966863180465,5.603341614990904,4.889538477387345,5.406848105422237,6.03234587008493,5.418544573742047,365339.51754385966,4,E01001571,4,4,5,3,5,3,5.547360582704897,5.224098632070754,5.676124439416109,4.995027248947709,5.416631579399109,5.929546177828754,5.467958496235035,468110.57037037035,5,5,6,5,5,4,3,1.0,1,1,2,0,2,-1,0
1546,5.647456309713166,5.233919704371485,5.719782072100146,4.8227338807336215,5.453525997030324,6.143877065592799,5.495180597798577,366878.87586206896,5,E01001572,4,6,3,4,7,4,5.731217704522304,5.0289294345256605,5.766964010703258,4.948224739386485,5.4890059645359335,6.083152818374145,5.574949778807469,469806.50641025644,7,2,7,4,7,7,5,1.0,2,-2,1,1,3,0,1
1547,5.58978799210877,5.131133616471491,5.7231226848954915,4.886842522300592,5.50280076315423,6.169454688785457,5.544799574282991,369710.0168067227,4,E01001573,2,6,5,5,7,5,5.552442764199299,5.097501102737758,5.769251157926477,4.975633641947871,5.438821862054907,6.079165025379346,5.593256235122681,473490.6,5,3,7,5,6,7,5,1.0,1,1,1,0,1,0,0
1548,5.899551972746849,5.420395384347716,5.314741721333459,4.769471302975056,5.592027404627134,5.813334375619888,5.406416369732036,369875.9069767442,8,E01001574,7,1,2,7,2,3,5.911983152770477,5.399962741395702,5.401702421838823,4.802127463662106,5.566713895486749,5.869210802342581,5.479062418898811,473656.839673913,8,8,1,1,9,3,3,1.0,0,1,0,-1,2,1,0
1549,5.246620645188981,5.623185291411771,5.214708990352169,5.177207195834749,5.195068857472414,5.653413843956723,5.089331212317108,361566.10191082803,1,E01001575,9,0,9,0,0,0,5.1816989501733435,5.563207789241331,5.212651300804778,5.261204399987665,5.173982356855382,5.741529696898935,5.284740789398473,463275.9162303665,0,9,0,9,0,1,0,1.0,-1,0,0,0,0,1,0
1550,5.4160745974743,5.563340184664486,5.222982790735033,5.127809458910817,5.3526299035910405,5.759376539124383,5.17739065187146,361833.86363636365,2,E01001576,9,0,8,2,1,0,5.4968194882824735,5.509736364180187,5.323016552430279,5.097079762310352,5.3479092469755205,5.875872149782361,5.337045223083136,463381.0283018868,4,9,0,7,4,3,1,1.0,2,0,0,-1,2,2,1
1551,5.302168510484357,5.660830589050942,5.289831706818114,5.174403523722439,5.3060798763383366,5.745409147113773,5.231089452479748,362404.12765957444,1,E01001577,9,0,9,1,1,1,5.208175979554653,5.483144338760111,5.3212690444456205,5.118808810909589,5.179220494296816,5.784310527973705,5.216345277925332,464325.90972222225,1,9,0,7,1,1,0,1.0,0,0,0,-2,0,0,-1
1552,5.33306334563664,5.500159978866577,5.3933837018694195,5.016509838785444,5.270695696558271,5.82187822341919,5.209595504488264,363304.38285714283,1,E01001578,8,1,7,1,2,0,5.3022724395845,5.521333407774204,5.412447389742224,5.228162060132841,5.257421253948677,5.8226577537815745,5.264632081985473,465591.39512195124,2,9,1,9,2,2,0,1.0,1,1,0,2,1,0,0
1553,5.365948901257732,5.544718722728166,5.281802123920484,5.094408156519586,5.366546634923328,5.756538296965036,5.1587273078885945,362631.8409090909,2,E01001579,9,0,8,2,1,0,5.407469585621157,5.514936244687554,5.345098671300451,5.183122752765038,5.398710447316729,5.797267406346411,5.319328285462364,464339.03910614527,3,9,1,8,5,1,1,1.0,1,0,1,0,3,0,1
1554,6.009280841842837,5.295179029707967,5.497192173351643,4.771776291522903,5.586436067515539,5.979424122374067,5.4094326587823724,263940.63562753034,8,E01001580,5,3,2,7,4,3,5.971078066668883,5.301000383165148,5.571206684956334,4.828452567504757,5.5156891419563765,6.078145448072457,5.587406226636942,339988.1069958848,9,6,4,2,8,7,5,1.0,1,1,1,0,1,3,2
1555,5.745562827012625,5.260256039090903,5.526552149330277,4.874924315027444,5.363681617271469,5.922731760036514,5.539939506944403,265664.0120481928,6,E01001581,4,3,4,2,3,5,5.678105798634616,5.2774602958862795,5.499558813431683,4.983470128819267,5.26528793669002,5.875070777806369,5.5308727076984345,341891.26737967914,6,6,3,5,2,3,4,1.0,0,2,0,1,0,0,-1
1556,5.701520335917571,5.456416508981159,5.3781870591397185,4.923801454962517,5.408901846530486,5.924052665428239,5.425931620354555,264961.556122449,5,E01001582,8,1,5,3,3,3,5.632667638795793,5.455317023623684,5.34419991937988,4.9533005808500965,5.362724032102679,5.895932939555078,5.501345583676223,341089.74439461884,6,8,1,4,4,3,3,1.0,1,0,0,-1,1,0,0
1557,5.900076197481703,5.359732549080904,5.466738699496477,4.827961717528859,5.490808837030126,5.884902988357106,5.505676262680141,264426.6264367816,8,E01001583,6,2,3,5,3,4,5.708277968109631,5.329766640897657,5.376203388464256,4.963177961729914,5.311121010389484,5.881432492224897,5.575998155797114,340341.3278688525,7,7,1,5,3,3,5,1.0,-1,1,-1,2,-2,0,1
1558,5.788396099635533,5.306570679800851,5.644171462740217,4.704261193956648,5.6465791361672535,5.959721558434623,5.536327811649867,267516.1142857143,6,E01001584,5,5,1,8,4,5,5.990966839897902,5.347715849266913,5.503584666359694,4.640556856205589,5.70631964762408,5.987928272189951,5.567104567262463,343247.2932330827,9,7,3,0,9,5,4,1.0,3,2,-2,-1,1,1,-1
1559,6.161857887550637,4.976107212349221,5.886590879051774,4.564806330645526,5.669087523001211,6.27324103779263,5.836260682565195,267548.2888888889,9,E01001585,1,8,0,8,8,9,5.9365552201563,5.028318770888712,5.7760392743714,4.771645499735462,5.541813318421241,6.176228500547863,5.795580280070403,344086.10204081633,9,2,7,1,8,8,8,1.0,0,1,-1,1,0,0,-1
1560,6.103239335912339,5.19123626600766,5.71462042111877,4.658992048696423,5.601939832065122,6.1504462390926715,5.6205334959300695,266175.6737588653,9,E01001586,3,6,1,7,7,6,5.957578014243733,5.181408455877593,5.711143773613554,4.763738936547077,5.530573857553078,6.094457825024922,5.709573743921338,342936.0378787879,9,4,6,1,8,7,7,1.0,0,1,0,0,1,0,1
1561,5.964408468080047,5.192383705369578,5.717892473976084,4.782423341034243,5.570908568849499,6.109431250783421,5.735011608808633,275676.10067114094,8,E01001587,3,6,2,7,6,8,5.819466180734701,5.14998662888587,5.66772027282448,4.785231257652069,5.449595518045492,6.079855141939817,5.685432274024803,354154.92307692306,8,4,6,1,6,7,7,1.0,0,1,0,-1,-1,1,-1
1562,5.817394188317386,5.395881547711112,5.532480475035581,4.803639609163458,5.560620326887477,5.911363843354311,5.499535677107898,484155.17727272725,7,E01001588,7,3,3,6,3,4,5.695476859935875,5.332725298762833,5.463794690856606,4.97696932242152,5.426453800672114,5.851892228801875,5.418044270875628,629353.7253218885,6,7,2,5,6,2,2,1.0,-1,0,-1,2,0,-1,-2
1563,5.669874404157911,5.2867468525837,5.611133233293311,4.880168801778323,5.551346850085568,5.938083357625193,5.420745389802115,264771.8896103896,5,E01001589,5,5,4,6,3,3,5.466552201567627,5.135705295859314,5.524547504215706,4.964886314258343,5.330515069205586,5.81029377477925,5.362975741305003,340733.60365853657,4,3,3,5,3,2,1,1.0,-1,-2,-2,1,-3,-1,-2
1564,5.9748115062713625,5.050655951283195,6.00152678381313,4.666293895244598,5.619600108536807,6.2378591429103505,5.699629224430431,266238.5363636364,8,E01001590,1,9,1,8,8,7,5.776889600486399,4.965931374335957,5.877090465242618,4.763948470632607,5.509967703685582,6.189744376690588,5.737438337825169,342687.5140186916,7,1,8,1,8,8,7,1.0,-1,0,-1,0,0,0,0
1565,5.844444016752572,5.152608728408813,5.658235193943155,4.710484834375053,5.5769670108269,6.076055023587983,5.564851351442008,265904.6620689655,7,E01001591,3,5,1,7,6,5,5.669296267048624,5.183439460376765,5.664701197771418,4.9153457856018274,5.433839595557859,5.998798419965193,5.513323499852379,342252.5033557047,6,4,6,4,6,5,3,1.0,-1,1,1,3,-1,-1,-2
1566,5.6259058681252885,5.3011842680304015,5.59145403643177,4.942048308784014,5.31683671556107,6.0217055678367615,5.577853519622594,266563.9520547945,5,E01001592,5,4,6,1,5,5,5.5482124137251,5.167867547587345,5.593138279099214,4.961455062816017,5.286891444733269,5.974947828995554,5.622509092876785,343077.5460526316,5,4,4,4,2,5,5,1.0,0,-1,0,-2,1,0,0
1567,5.591021489214014,5.216545794481113,5.596110114344844,4.960834826952145,5.341571335439329,5.96367304413407,5.567657080697424,266389.27160493826,4,E01001593,4,4,6,2,4,5,5.54497947243901,5.201832420640177,5.687680894678289,4.989255254918879,5.310489149836751,6.005890634152796,5.583359366887576,342829.3181818182,5,4,6,5,3,5,5,1.0,1,0,2,-1,1,1,0
1568,5.4518531666648,5.373271581626708,5.468582140822565,5.008890105832007,5.430273038725699,5.827688188322129,5.378952675288724,265659.77419354836,3,E01001594,6,2,7,3,2,2,5.3889578803768,5.265545685116837,5.555971541055819,4.985827935420401,5.301443899550089,5.838220257100051,5.405872559159752,341911.0975609756,3,6,4,5,3,2,2,1.0,0,0,2,-2,0,0,0
1569,5.638732984979102,5.309349249652091,5.583773094288846,4.910367068458111,5.459864734335149,6.010943883277,5.557567049848273,274240.07446808513,5,E01001595,5,4,5,4,5,5,5.66589850370138,5.2419698421209135,5.63378445209901,4.848531486797918,5.377940927546448,5.992414705592431,5.570821686756392,354843.87116564414,6,5,5,2,4,5,5,1.0,1,0,1,-3,0,0,0
1570,5.601295929636274,5.34029978275299,5.603043139321463,4.841559478214809,5.538738008226667,6.164274738856724,5.638406523295811,345219.90857142856,4,E01001596,6,4,4,6,7,6,5.709792837654192,5.194842975778678,5.704048187462325,4.853792342943015,5.558905361853924,6.22365028464917,5.741718914090972,443328.3762886598,7,4,6,2,8,9,7,1.0,3,-2,2,-2,2,2,1
1571,5.759203048313365,5.319129358049971,5.499876479217909,4.90060721101804,5.532704673201789,6.073939823996428,5.6190011247790235,354163.48416289594,6,E01001597,5,3,5,6,6,6,5.832664278713432,5.30249000078923,5.580723316819818,4.886765654022629,5.50766853598861,6.111624871288334,5.832834325395189,454243.6756756757,8,6,4,3,8,7,8,1.0,2,1,1,-2,2,1,2
1572,5.674205365807119,5.3009224606282785,5.600128860184641,4.879420876502991,5.53452920552456,6.134054619856555,5.646592601381167,355636.9646464646,5,E01001598,5,4,4,6,7,6,5.829350715279579,5.240162894129753,5.691533646583557,4.892999691963196,5.6149475646018985,6.210732533931732,5.81683071732521,455545.7,8,5,6,3,9,8,8,1.0,3,0,2,-1,3,1,2
1573,5.772124925095016,5.3294717617549345,5.563389598581306,4.801738679656349,5.577918280209743,6.0967603392620795,5.5649793706988895,356257.4066390041,6,E01001599,6,4,3,7,6,5,5.798106327774079,5.287089177263462,5.620855791781976,4.848163122084083,5.558134868377593,6.1510779673491065,5.6925305573920895,456240.5731707317,8,6,5,2,8,8,7,1.0,2,0,1,-1,1,2,2
1574,5.4968130155043164,5.239264954220165,5.633875431952538,4.954885546263162,5.4566876338673875,6.039012583819303,5.588780016094059,353560.0974025974,3,E01001600,4,5,6,4,5,6,5.504457501717556,5.235295489246463,5.669428161632868,4.955762943367899,5.3797444428926635,6.037437405851152,5.616759468007971,453936.14814814815,4,5,6,4,4,6,5,1.0,1,1,1,-2,0,1,-1
1575,5.574721352620558,5.305921583690426,5.65396907586943,4.978433917869221,5.529574526981874,6.1833202283490785,5.62672523747791,334148.3352272727,4,E01001601,5,5,6,6,8,6,5.647698300132334,5.2129077585668515,5.680987784119903,4.893399500456012,5.532794497703594,6.2258929672136984,5.787552303955203,425894.0,6,5,6,3,8,9,8,1.0,2,0,1,-3,2,1,2
1576,5.796177936735607,5.394574212460291,5.526369871979668,4.776058976990836,5.583495379061926,6.201080503917876,5.654439923309145,356314.72857142857,7,E01001602,7,3,2,7,8,7,5.810607169613694,5.386878461548776,5.5675654142966,4.774256103998654,5.583062821136409,6.161400954960745,5.7570341959660185,456332.2554112554,8,8,4,1,9,8,8,1.0,1,1,1,-1,2,0,1
1577,5.676560184143109,5.43023869245412,5.506229119593871,4.827796522465498,5.595241852978754,6.093957360230345,5.6051991165683255,356820.7541899441,5,E01001603,7,3,3,7,6,6,5.841023927039289,5.31608547428821,5.625661984403083,4.8022100405490145,5.643564191270382,6.160984134420436,5.660790094035737,456905.09574468085,8,6,5,1,9,8,6,1.0,3,-1,2,-2,2,2,0
1578,5.7838354759746125,5.173829888635211,5.781133592128754,4.890058414803611,5.553854202561908,6.112894260221058,5.620386575990253,577934.4,6,E01001604,3,7,5,6,7,6,5.5453645307465464,5.19016569280355,5.580307495122575,4.956211095475881,5.3308687277432885,6.009644465931391,5.702492611556403,735831.7344632768,5,4,4,4,3,5,7,1.0,-1,1,-3,-1,-3,-2,1
1579,5.653829466262365,5.3291726477069945,5.479588742669859,4.890744804247329,5.462142509412548,5.965821163839401,5.471817413965861,515436.03652968036,5,E01001605,6,2,5,4,4,4,5.449094730668364,5.407568066521028,5.39118701588791,4.986658414908215,5.294927527419234,5.915130667981848,5.598725760405043,656475.778761062,3,8,1,5,2,3,5,1.0,-2,2,-1,0,-2,-1,1
1580,5.778020672764338,5.158315144532116,5.828701876579447,4.8113432868998105,5.579915295255945,6.179972794884486,5.682630097612422,578897.5531914893,6,E01001606,3,8,3,7,7,7,5.581210231408477,5.236693553626537,5.714022923260927,4.938846598379314,5.370633358135819,6.155452935025096,5.812170213088393,737105.5546875,5,5,6,4,4,8,8,1.0,-1,2,-2,1,-3,1,1
1581,5.724374230347532,5.2935707003044685,5.699001767781859,4.877724082776288,5.489692656687518,6.219466810119885,5.584994431980495,578719.0614525139,6,E01001607,5,6,4,5,8,6,5.437588025737742,5.314161725550391,5.636560337503529,4.936658028117772,5.30509772913416,6.1082031300614,5.682931487786703,736892.7374301676,3,6,5,4,3,7,7,1.0,-3,1,-1,0,-2,-1,1
1582,6.067278480975427,5.241409824273297,5.762539290936194,4.829870503639507,5.59313234269062,6.298922385010764,5.7701025828022825,566066.0420560747,9,E01001608,4,7,3,7,9,8,5.904643581634344,5.221593013475108,5.6670594875202625,4.794989451696706,5.454165024535601,6.264178699116374,5.870622449142989,719804.1441860466,8,5,6,1,6,9,9,1.0,-1,1,-1,-2,-1,0,1
1583,5.641762919085366,5.258745846294222,5.579267374674479,4.950958388192313,5.448066560427348,6.006322933378674,5.558037919657571,557716.8428571429,5,E01001609,4,4,6,4,5,5,5.622719539236699,5.258835932248318,5.560974757595839,4.903142334109518,5.370766372162832,5.985694232030152,5.689074735296258,711746.185520362,6,5,4,3,4,5,7,1.0,1,1,0,-3,0,0,2
1584,5.777368296774066,5.266972026654652,5.771774381399155,4.743009421290184,5.614214799842056,6.253867901101405,5.578826341702014,581095.0663265307,6,E01001610,5,7,2,8,8,5,5.623007733845016,5.112692615939576,5.748620651300671,4.838110137911676,5.410587117509935,6.236784987079287,5.805668778789854,739889.1893203884,6,3,7,2,5,9,8,1.0,0,-2,0,0,-3,1,3
1585,5.612869378808257,5.312857298881976,5.687737334858287,4.861590573539981,5.540677332258844,6.190765747776279,5.57414471870893,578951.6428571428,4,E01001611,5,6,4,6,8,5,5.457049098590876,5.261005772040194,5.635586351356251,4.972977792656661,5.342890589029197,6.173988278280168,5.622571537158633,737217.22147651,3,5,5,5,4,8,5,1.0,-1,0,-1,1,-2,0,0
1586,5.7499663536365215,5.40779548241542,5.551117162215404,4.875189154576033,5.535059999196958,6.017268919333434,5.427908084331414,578772.8717948718,6,E01001613,7,4,4,6,5,3,5.639118491278754,5.357465102407668,5.560401919153001,4.958059395684137,5.391765789455838,6.000216311348809,5.462031659020318,736796.6977777778,6,7,4,4,5,5,3,1.0,0,0,0,0,-1,0,0
1587,5.758312848664946,5.486427945942529,5.3549499996637895,4.893444377486989,5.433672831220142,5.903464695828109,5.450097970706595,390963.0423728814,6,E01001614,8,1,5,3,3,3,5.80787314952806,5.406959602999133,5.424532466433769,4.8489822734233945,5.455383032698964,5.9946143774099125,5.617018486178199,510658.0558139535,8,8,1,2,6,5,5,1.0,2,0,0,-3,3,2,2
1588,5.949052714249667,5.270246781847057,5.547298810061286,4.744913245825207,5.628030331695781,6.044969166902935,5.5385628894847985,523607.17279411765,8,E01001615,5,4,2,8,5,5,5.707964740618311,5.227324810092297,5.5074005560441455,4.894508150691537,5.453025005481861,5.909170843535401,5.49687554218151,672268.4915824916,7,5,3,3,6,3,3,1.0,-1,0,-1,1,-2,-2,-2
1589,5.659587661879403,5.271171387944903,5.573777894973755,4.874823401996068,5.496732223374503,6.090682588304792,5.567607992717198,393895.21714285715,5,E01001617,5,4,4,5,6,5,5.773837142446068,5.164406402727192,5.652704004491313,4.847388935223054,5.525475729717297,6.2081439548663875,5.716655959574024,506570.26404494385,7,4,5,2,8,8,7,1.0,2,-1,1,-2,3,2,2
1590,5.611046660370028,5.371146828390015,5.525505593585484,4.919967145484111,5.49133439536022,6.014909537915651,5.491434243124754,331410.10152284265,4,E01001618,6,3,5,5,5,4,5.5540624351212475,5.391743987669677,5.4786638031790265,4.901696511161275,5.365394800256341,6.0090277958741956,5.526669403691312,424454.3852813853,5,8,2,3,4,5,4,1.0,1,2,-1,-2,-1,0,0
1591,5.485743596064334,5.307418965345977,5.6381909641998496,4.957319728586058,5.435672205804989,6.051446279942595,5.4090441568008325,303561.61589403974,3,E01001619,5,5,6,3,5,3,5.428251939160483,5.268037081616265,5.611177899156298,5.042007138899394,5.357747529234205,5.973806978975023,5.494112573351178,389225.6214285714,3,6,5,6,4,5,3,1.0,0,1,0,0,1,0,0
1592,5.537263542542726,5.48243548137285,5.361737871066833,5.052271785674157,5.448824506301384,5.9207962782352,5.341394345481675,411964.38095238095,4,E01001620,8,1,7,4,3,2,5.455266192490357,5.4540116984771325,5.357567682536929,5.09638668876548,5.3532825984288515,5.864294976126159,5.451929187670546,522962.62445414846,3,8,1,7,4,2,2,1.0,-1,0,0,0,0,-1,0
1593,5.593854555336561,5.502231335310342,5.394438967177395,5.065592582324683,5.378661057916105,5.850288535043391,5.372467885918332,571943.4470046083,4,E01001621,8,1,8,2,2,2,5.50586305979656,5.455710993219384,5.335686168863099,5.089841182990994,5.2491707534533445,5.829994393036505,5.4772422933792315,728445.4304932735,4,8,1,7,2,2,3,1.0,0,0,0,-1,0,0,1
1594,5.539940136915062,5.453296156654581,5.4005946060370285,4.974716710068329,5.477447092184547,5.972883764066194,5.453899972620066,262813.865497076,4,E01001623,8,1,6,4,4,3,5.511151889224111,5.404020823078391,5.517084347613064,4.974300265312195,5.320851640936769,6.03559602410705,5.690079701535495,338518.72222222225,4,8,3,5,3,6,7,1.0,0,0,2,-1,-1,2,4
1595,5.534287762641907,5.480844247341156,5.47533352655523,4.9418016938602225,5.424753083201016,6.041398220903734,5.411625759741839,539330.194117647,4,E01001624,8,2,6,3,5,3,5.452452979010085,5.42619059526402,5.4589293229839075,4.988620007167691,5.264897619252619,6.102232912312383,5.613829879009205,690998.3913043478,3,8,2,5,2,7,5,1.0,-1,0,0,-1,-1,2,2
1596,5.448190466654255,5.583621739427706,5.28122717850053,5.177776649537214,5.325677462464548,5.784087640572325,5.273761729627734,440302.275862069,3,E01001625,9,0,9,1,1,1,5.362010743103776,5.523479176970089,5.3176860023947325,5.186010097054874,5.241848270098369,5.846278106932546,5.476059889325908,559831.631372549,2,9,0,8,1,2,3,1.0,-1,0,0,-1,0,1,2
1597,5.285852677774745,5.5339563895534996,5.303648381043744,5.060209042189137,5.290091981950974,5.730468204479344,5.129501552771258,440419.12582781457,1,E01001629,9,0,8,1,1,0,5.374686602363012,5.389952839765334,5.34799851869282,5.123293208896666,5.237056393372385,5.801747603524,5.391824894381645,561163.8721804512,2,8,1,8,1,1,2,1.0,1,-1,1,0,0,0,2
1598,5.127367397149404,5.5149263853118535,5.213231207832457,5.2463874570907105,5.150228436031039,5.63847206414692,5.102894317536127,363953.31746031746,0,E01001631,8,0,9,0,0,0,5.165879808203147,5.481084555605032,5.259780290353037,5.28551341843431,5.103474228051457,5.651581162083758,5.316454219992143,465657.9197080292,0,9,0,9,0,0,1,1.0,0,1,0,0,0,0,1
1599,5.457450143496195,5.173010092973709,5.7286061724027,4.925917335351309,5.355527098973592,5.9850438892841336,5.4398517062266665,370547.76666666666,3,E01001632,3,6,5,2,4,3,5.499380196982283,5.046287091766915,5.7754100105626796,4.821454964032987,5.28216757619284,5.989748549655201,5.719660937301511,474145.2845528455,4,2,7,2,2,5,7,1.0,1,-1,1,-3,0,1,4
1600,5.411225702451623,5.309889534245366,5.500003708445507,5.026906052361364,5.357283387495124,5.7939687448999155,5.2077291387578715,508650.0,2,E01001633,5,3,7,2,1,0,5.389758985667002,5.248155214956829,5.56711885474977,5.025646161465418,5.294371548153105,5.823864692733402,5.381150214445023,631418.7857142857,3,5,4,6,2,2,1,1.0,1,0,1,-1,0,1,1
1601,5.042045911153157,5.570268463520777,5.303173217035475,5.218005173263096,5.2278004132566,5.606876435733977,5.042953413157236,389756.4761904762,0,E01001634,9,0,9,0,0,0,5.195408507305033,5.46951403687982,5.340493920971365,5.2157672503415276,5.222188108107623,5.652836214093601,5.3659144306884095,493379.0588235294,1,9,1,9,1,0,1,1.0,1,0,1,0,1,0,1
1602,5.763144513110181,5.300437136963531,5.554026503662963,4.858660732115899,5.56611225738392,6.023680566907762,5.446922974152998,371584.24475524476,6,E01001635,5,4,4,7,5,3,5.653263949296054,5.1088315756881935,5.584123118835337,4.863175094127655,5.452353140887092,5.959897369146347,5.51264181294862,475869.86029411765,6,3,4,2,6,4,3,1.0,0,-2,0,-2,-1,-1,0
1603,5.606595112295712,5.070737035134259,5.846490296195535,4.794764716484967,5.510980066131143,6.121803006003884,5.59778917537016,371472.24705882353,4,E01001636,2,8,3,5,7,6,5.704994874530368,4.929944190714094,5.784092961417304,4.7458623939090305,5.391754240459866,6.0936428255505035,5.652810408009423,475737.4555555555,7,1,7,1,5,7,6,1.0,3,-1,-1,-2,0,0,0
1604,5.76263909981801,5.132293596634498,5.675285009237436,4.724788685945364,5.520441625668452,6.12359968148745,5.614572457166818,397986.24615384615,6,E01001637,3,6,1,6,7,6,5.8656266229493275,5.138926852600915,5.718896928855351,4.696644814525332,5.531712021146502,6.15684483732496,5.67633016364915,514134.8214285714,8,3,7,0,8,8,6,1.0,2,0,1,-1,2,1,0
1605,5.1579584063905655,5.589607132805718,5.321709454661668,5.251763990431121,5.275142089285032,5.609590595418757,5.170909898449676,282206.61616161617,0,E01001638,9,1,9,1,0,0,5.304882610073457,5.343822851777077,5.427940031656852,5.0499414434799785,5.254598394036293,5.698525664898066,5.327024264977529,362998.5576923077,2,7,2,6,2,0,1,1.0,2,-2,1,-3,1,0,1
1606,5.146374587700746,5.315321806435273,5.477976181796778,5.18764837100127,5.347638312901292,5.628261641921284,5.240002726840082,280641.26168224297,0,E01001640,5,2,9,2,0,1,5.1073252515359355,5.105567408691753,5.621989551457491,5.109184015880931,5.349368518049067,5.710899277166887,5.415753468600187,360820.3181818182,0,3,5,7,4,0,2,1.0,0,-2,3,-2,2,0,1
1607,5.512039895140968,5.131599775047802,5.6935207562675645,4.901190748381302,5.421222941844224,5.832026437900993,5.436378541992221,280540.63318777294,3,E01001641,2,6,5,3,2,3,5.50728203294464,4.993915273297217,5.639320248832351,4.943489443321932,5.3962488212893085,5.827905252781881,5.510068019414278,360833.8202764977,4,1,5,4,5,2,3,1.0,1,-1,-1,-1,2,0,0
1608,5.811785246069367,5.393117499512595,5.293948846357363,4.868645107155448,5.5262170863581135,5.828513482669452,5.366191145267573,274289.8018018018,7,E01001642,7,0,4,6,2,2,5.850555189536966,5.420578354597092,5.261424482905347,4.885164598278378,5.434624797105789,5.829616701862086,5.372766799771267,352892.76739130437,8,8,0,3,6,2,1,1.0,1,1,0,-1,0,0,-1
1609,5.413961095222528,5.20149242532426,5.659726536792258,4.947804616845173,5.442985280700352,5.853197984073473,5.388079168140024,281797.50724637683,2,E01001644,3,5,6,4,2,2,5.436741680616424,5.039122826996303,5.6896351263636635,4.924703398630733,5.400260786215465,5.865741031510489,5.559123600522677,361393.71428571426,3,2,6,4,5,2,4,1.0,1,-1,1,-2,1,0,2
1610,5.6225796742098675,5.416703681434904,5.550855762617928,4.916688504389354,5.58739914383207,6.103509564910616,5.512417444161007,264961.8857142857,5,E01001645,7,4,5,7,6,4,5.615265595032865,5.413193814706482,5.50953047067527,4.940617056500992,5.428551324261915,5.989047898542161,5.447201033566622,341094.0939597315,5,8,3,4,6,5,2,1.0,0,1,-1,-1,-1,-1,-2
1611,5.49148779012719,5.463898110551899,5.406348119787618,5.046369233098971,5.360424231509773,5.848906507297438,5.355210001776818,578711.1156462585,3,E01001646,8,1,7,2,2,2,5.553971589281318,5.407763594991706,5.410369894477759,4.974104289928179,5.377983749582526,5.87023511093654,5.5418641272555575,732759.6123595505,5,8,1,5,4,3,4,1.0,2,0,0,-2,2,1,2
1612,5.765760062956343,5.38474012706794,5.5185784019675905,4.865042274489122,5.591227720765507,6.020630332769132,5.517442239850175,264939.76470588235,6,E01001647,7,3,4,7,5,4,5.649698433776696,5.359629473338525,5.475933305298288,4.983749215801557,5.390694921215375,5.964023644725482,5.521103536710143,341069.2083333333,6,7,2,5,5,4,4,1.0,0,0,-1,1,-2,-1,0
1613,5.687269226477964,5.468760896773234,5.430742642305193,4.824567265754198,5.673802892657092,5.992248912797357,5.525292704575254,555675.9635036497,5,E01001648,8,2,3,9,4,4,5.678777959942818,5.386763927340508,5.418797121942044,4.88442989513278,5.477406457811594,5.99854678362608,5.599350932240486,709920.79375,6,8,1,3,7,5,5,1.0,1,0,-1,0,-2,1,1
1614,5.681242642506875,5.388927153550862,5.5079816039142715,4.837107182851906,5.533794532056715,6.063600418997592,5.490893068209372,376779.28415300546,5,E01001649,7,3,4,6,6,4,5.514293532493787,5.483091947971246,5.430760795642168,5.008354935279259,5.431414434848688,6.064043966929118,5.465977062323154,477594.06666666665,4,9,2,5,6,6,3,1.0,-1,2,-1,1,0,0,-1
1615,5.577344606857042,5.343529845411713,5.655018108922082,4.9659546903661775,5.420402122510446,6.0595565599364205,5.582148444813651,277043.7297297297,4,E01001650,6,5,6,3,6,5,5.505996768906613,5.299190214816356,5.667793069109821,4.94316318051127,5.350012635224617,6.0134850476412165,5.510280320308352,350746.2281879195,4,6,6,4,4,5,3,1.0,0,0,1,-2,1,-1,-2
1616,5.841198689287359,5.318750651677449,5.54733038815585,4.8143008643930605,5.5744118531545,6.111804996837269,5.615385715889208,438667.5696969697,7,E01001651,5,4,3,7,7,6,5.686675895344127,5.272868560299729,5.540334075869936,4.9912070729515765,5.476803255803658,6.057752038493301,5.586936585108439,548088.2727272727,6,6,3,5,7,6,5,1.0,-1,1,-1,2,0,-1,-1
1617,5.550553025824301,5.3032341612858716,5.540553089607967,4.9470878585001055,5.401527004965236,5.862212777137756,5.549549706866232,264420.7752808989,4,E01001652,5,3,6,3,2,5,5.529242940680691,5.25122472596547,5.557555662891852,5.006797821433456,5.29147774895663,5.899312141711119,5.628928663869384,340365.5925925926,4,5,4,5,2,3,6,1.0,0,0,1,-1,-1,1,1
1618,5.857621499470302,5.389567080944303,5.441010760882544,4.781499297845931,5.472044087591625,6.0789320506746805,5.476261084988003,281341.3253968254,7,E01001653,7,2,2,4,6,4,5.761718393357332,5.4165859793828535,5.3760148493711615,4.965698465828068,5.38844939302807,6.024049264340361,5.540878954012532,365137.7355371901,7,8,1,5,5,6,4,1.0,0,1,-1,3,1,0,0
1619,5.746887816799631,5.426283824358055,5.330674015360771,4.918190794883015,5.544558779798823,5.9592138160046915,5.47877067970715,263070.07913669065,6,E01001654,7,1,5,6,4,4,5.655943222399111,5.372246432304382,5.325332034075702,4.936767822724802,5.384622691295765,5.897825060950385,5.5233548120216085,338745.0444444445,6,7,1,4,5,3,4,1.0,0,0,0,-1,-1,-1,0
1620,5.631165673161111,5.510321039205406,5.326808318060044,4.957837455453928,5.431499042706183,5.906716638141209,5.3399010631773205,393981.4035087719,5,E01001655,8,1,6,3,3,2,5.554252891791494,5.410174857942682,5.330707933400807,4.981952609513935,5.330053485067267,5.936806918445386,5.502562249334235,512726.92631578946,5,8,1,5,3,4,3,1.0,0,0,0,-1,0,1,1
1621,6.167162716388702,5.3927954733371735,5.39483255147934,4.884272664785385,5.947475403547287,5.786065012216568,5.435419827699661,266139.75,9,E01001656,7,1,5,9,1,3,6.02469382403087,5.38576768951182,5.529613455380399,4.616809995627842,5.68109122083231,5.999150631617915,5.635491383587656,345962.52760736196,9,8,3,0,9,5,6,1.0,0,1,2,-5,0,4,3
1622,5.8035862212595735,5.215343655451484,5.6322255678798845,4.756872235432915,5.64093556481859,5.98077754870705,5.498314676077469,269296.04347826086,7,E01001657,4,5,2,8,4,4,5.948275137104486,5.169500658386632,5.629165460404597,4.725387097973573,5.624295579759698,6.078458743660073,5.606792488380482,346722.17763157893,9,4,5,0,9,7,5,1.0,2,0,0,-2,1,3,1
1623,5.8694294368364535,5.413893588340085,5.528746705028892,4.863111482799383,5.644682240090976,6.021543747812345,5.5816720783381175,266818.1215469613,7,E01001658,7,3,4,8,5,5,5.727559454922606,5.428377450980577,5.5100379882774915,4.92075099674939,5.395572483833201,6.040290511887649,5.543421586158828,342918.4482758621,7,8,3,4,5,6,4,1.0,0,1,0,0,-3,1,-1
1624,5.597424807371916,5.478801541227512,5.520422916563731,4.9593311693302535,5.438084410611914,5.931244197976652,5.517277367531308,263735.962962963,4,E01001659,8,3,6,4,3,4,5.597722197030958,5.454652518457711,5.458789139562309,5.026653848553156,5.309951535898362,5.971510723303845,5.63546790161404,339432.29383886256,5,8,2,6,3,5,6,1.0,1,0,-1,0,-1,2,2
1625,5.674694397040373,5.447321778923802,5.403291766460125,4.902649369465529,5.489670261123477,6.005427848657913,5.583985591075829,263177.60355029587,5,E01001660,8,1,5,5,5,6,5.661274407828986,5.339672827853837,5.418521859126384,4.919119594483402,5.382921147612886,6.050869069285899,5.651792349096117,338948.4245810056,6,7,1,4,5,6,6,1.0,1,-1,0,-1,0,1,0
1626,5.732891446122756,5.443548972216936,5.3957807547771015,4.890761124973114,5.554225126138101,5.966087611821981,5.503146097064018,348157.4663461539,6,E01001661,7,1,5,6,4,4,5.682506217365772,5.421197409650921,5.349013517915675,5.020713746547699,5.423915428925405,5.949489208449305,5.5936711863078905,446359.4778761062,6,8,1,6,6,4,5,1.0,0,1,0,1,0,0,1
1627,5.270813381671905,5.27915033382528,5.49496509958716,5.082185846216539,5.2894944373299095,5.760012469572179,5.258465620349435,273194.93529411766,1,E01001662,5,3,8,1,1,1,5.2276111508383964,5.159904418257892,5.561282231117868,5.090329156309215,5.2167527173376325,5.788507784683692,5.359707180013511,352130.6852791878,1,4,4,7,1,1,1,1.0,0,-1,1,-1,0,0,0
1628,5.35554629723231,5.0878525193532305,5.6225027068456015,4.970256627400716,5.445338009198506,5.764135936101278,5.302534628709157,280070.2866666667,2,E01001664,2,5,6,4,1,1,5.358665777328319,5.150969852182202,5.566485159379199,5.041968261388908,5.362376267748668,5.698929306259729,5.350461117307046,360012.1879699248,2,4,4,6,4,0,1,1.0,0,2,-1,0,0,-1,0
1629,5.361901636012116,5.325409081944248,5.545710292475962,5.041512341527214,5.23953654473288,5.869841433407967,5.273475518003542,267485.47953216376,2,E01001665,6,4,7,0,2,1,5.360811871320463,5.2681648477079905,5.528335938598904,5.144243663942754,5.191990092926219,5.850554648994795,5.372533022449707,344223.70050761424,2,6,3,8,1,2,1,1.0,0,0,-1,1,1,0,0
1630,5.127440898890656,5.524639581712548,5.258423103226556,5.2317911357695355,5.173556821357801,5.6399153856839535,5.0988253170741356,277048.95652173914,0,E01001666,8,0,9,0,0,0,5.020601391792297,5.470110984948965,5.242159500947365,5.265227910188528,5.041629807765667,5.6178145784598135,5.25113629423655,356648.6423076923,0,9,0,9,0,0,0,1.0,0,1,0,0,0,0,0
1631,4.935342527309299,5.888566409393114,4.862367050133373,5.468697444716496,4.942138007893814,5.3449554457916815,4.881725833568029,426625.71913161466,0,E01001667,9,0,9,0,0,0,4.983236964957687,5.739758436531396,4.974204372420547,5.457757604167604,4.904442507702635,5.5141646418214,5.150913029947002,537481.1994917408,0,9,0,9,0,0,0,1.0,0,0,0,0,0,0,0
1632,5.235332870122158,5.289441141817305,5.4724785751766625,5.105429171311735,5.290641238593092,5.648089104830617,5.188143332197209,279437.0202020202,0,E01001668,5,2,8,1,0,0,5.238628181993687,5.256350994659459,5.456046966363758,5.083980274090569,5.247538635807652,5.659664219974922,5.272457601287948,359306.60368663596,1,5,2,7,2,0,0,1.0,1,0,0,-1,1,0,0
1633,5.584594455779408,5.320339774653922,5.485987323981065,4.815780980554641,5.4476111852205715,5.923696260107049,5.492583763545455,371755.25791855203,4,E01001669,6,3,3,4,3,4,5.712222006856178,5.274673047357676,5.547706410349631,4.816894981812458,5.473376123759211,5.96913264138358,5.583376825099089,476073.106122449,7,6,3,2,7,5,5,1.0,3,0,0,-1,3,2,1
1634,5.714793477025065,5.356328392362261,5.446949336912248,4.788066329655948,5.452792333556222,5.962507277935535,5.395417805318232,372016.2027972028,6,E01001671,6,2,3,4,4,2,5.563576622651174,5.299384023898687,5.508154349449353,4.885697842408449,5.392440350391926,5.864252328872681,5.304103687023505,476388.0705128205,5,6,3,3,5,2,1,1.0,-1,0,1,0,1,-2,-1
1635,5.2096232708656425,5.323872070420872,5.477190086335847,5.047216694463383,5.333976928934907,5.757077573826819,5.22310732440515,363042.7878787879,0,E01001672,6,2,7,2,1,0,5.182647716509153,5.250358667275677,5.482555964221693,5.070362607093706,5.108540311251601,5.7259914801545335,5.277132540532987,464732.69863013696,0,5,2,7,0,1,0,1.0,0,-1,0,0,-2,0,0
1636,5.180581199902075,5.249293413427141,5.517676145942123,5.055280934881281,5.318733710933615,5.713628462067357,5.14732970352526,364365.75925925927,0,E01001673,4,3,7,1,0,0,5.268274149409047,5.146735052267711,5.527491631331267,5.101454987570092,5.212194813622369,5.767199982095648,5.3650673517474425,466376.5833333333,1,4,3,7,1,1,1,1.0,1,0,0,0,0,1,1
1637,5.589721090357068,5.271386918047784,5.656490280594625,4.931854295058989,5.4994649282643495,6.030861565764521,5.4072900573972245,365400.42957746476,4,E01001674,5,5,5,5,5,3,5.588569641113281,5.159151314861244,5.7369628879759045,4.918776304357582,5.492396528522174,6.003897140423457,5.449557085004118,468162.4861111111,5,4,7,4,7,5,2,1.0,1,-1,2,-1,2,0,-1
1638,5.3091352157343445,5.184026909809487,5.56162071461771,5.001079228189257,5.275174754117828,5.83860765407288,5.359914186733221,368673.90196078434,1,E01001675,3,4,7,1,2,2,5.295654892081946,5.186077100290379,5.646318413841892,5.009692711729399,5.22079178564985,5.847350454666246,5.390848687836821,471801.6267605634,1,4,5,6,1,2,2,1.0,0,1,1,-1,0,0,0
1639,5.617849561146327,5.178169346991039,5.628763781275068,4.901490470341273,5.451082377206712,5.978938273021153,5.4810528653008594,370791.28571428574,5,E01001676,3,5,5,4,4,4,5.581162297248841,5.113523369789124,5.710260568618774,4.943531538009643,5.420104645729065,5.968111625671387,5.579025215148926,474943.872,5,3,6,4,6,4,5,1.0,0,0,1,-1,2,0,1
1640,5.61293774280908,5.274486472771603,5.561853267111868,4.870737617870547,5.425288327834891,5.8858469462244765,5.278980238632586,370650.3459119497,4,E01001677,5,4,4,3,3,1,5.58125282698367,5.209622371627624,5.531828710113663,4.933449999395624,5.412767537387021,5.807397680110242,5.377289482628006,474619.1746987952,5,5,3,4,5,2,1,1.0,1,0,-1,0,2,-1,0
1641,5.502989826294092,5.264106700817744,5.641004058030935,4.89596861295211,5.446323877725845,6.10998595219392,5.569430208359009,372961.01923076925,3,E01001678,5,5,5,4,7,5,5.35545840095251,5.212394036543675,5.6808637120784855,5.023264575463075,5.403066128492355,5.99779118788548,5.422491610050201,477600.57692307694,2,5,6,6,5,5,2,1.0,-1,0,1,1,1,-2,-3
1642,5.678112052954161,5.266479238180014,5.632164421448341,4.9106124245203455,5.526173010239234,6.151579748667204,5.593696296215057,580670.9307692308,5,E01001679,5,5,5,6,7,6,5.682654174681633,5.123805412169426,5.667286171451692,4.855298301481431,5.470349975555174,6.106635965839509,5.626295202778231,739248.8516129032,6,3,6,2,7,7,6,1.0,1,-2,1,-3,1,0,0
1643,6.250872473696093,5.1619046508491815,5.724571684222201,4.616169590970655,5.716739838257497,6.272496163587033,5.818761674872724,565711.1601731601,9,E01001680,3,6,0,9,8,9,6.183739767094289,5.115671682948909,5.735288435762579,4.6898132163631026,5.7560692178316355,6.240061560938181,5.796713213290065,723066.3429752066,9,3,7,0,9,9,8,1.0,0,0,1,0,0,1,-1
1644,5.84100949530508,5.258537429220536,5.628272596527548,4.697434071232291,5.603776425707574,6.158856695773554,5.600987966154136,479768.10784313723,7,E01001681,4,5,1,7,7,6,5.743104189634323,5.076087009161711,5.7671080728371935,4.707597487916549,5.4718432153264684,6.055838001271089,5.4985521249473095,628673.8645833334,7,2,7,0,7,6,3,1.0,0,-2,2,-1,0,-1,-3
1645,5.907942465094269,5.440615839156949,5.3984485234393444,4.7497060074180855,5.531800345319216,5.931745140278926,5.566385019020956,579267.7090163934,8,E01001682,7,1,2,6,3,5,5.777445043836321,5.362888176902001,5.39046795528476,4.866872986825574,5.403304146117523,5.925594443032722,5.5448921778622795,735632.2226890756,7,7,1,3,5,4,4,1.0,-1,0,0,1,-1,1,-1
1646,5.850907684255529,5.097951720379017,5.849740872559724,4.7249161428875395,5.563673854757238,6.166377314814815,5.6103571529741645,372042.3333333333,7,E01001683,2,8,1,7,7,6,5.77786117147755,5.082172144103694,5.8373193789172815,4.785923667050697,5.453336027022955,6.135919190741874,5.624248813132982,476406.0135135135,7,2,8,1,6,8,6,1.0,0,0,0,0,-1,1,0
1647,5.763389256578931,5.402801597612144,5.41533112667016,4.747254988850926,5.469886934968847,5.975044439530231,5.459985998960642,387590.7100591716,6,E01001684,7,2,2,4,4,3,5.623975840177429,5.3587441129630875,5.526875205254287,5.012854845336314,5.396340253647794,5.9377345020851395,5.479440689086914,498222.3202247191,6,7,3,6,5,4,3,1.0,0,0,1,4,1,0,0
1648,5.49571175616363,5.3522530465290465,5.490873998609082,4.879349954169372,5.359533162980244,5.9917111992836,5.373906545597931,372546.9137931034,3,E01001685,6,3,4,2,4,2,5.506444548772386,5.184566910601845,5.555176784184353,5.014355290034586,5.317338374035417,5.922305130761517,5.337655566940623,477054.12396694213,4,4,4,6,3,4,1,1.0,1,-2,1,2,1,0,-1
1649,5.76090593771501,5.220632734523478,5.651585757933081,4.793918046084317,5.518613219662548,6.033023323675598,5.561790827548865,579282.1986531987,6,E01001686,4,5,3,6,5,5,5.728726361421931,5.171712786559291,5.680952406569615,4.797082208146985,5.52140935715413,6.027989075487892,5.568017876388242,737200.4496644295,7,4,6,1,8,6,4,1.0,1,0,1,-2,2,1,-1
1650,5.462792858693272,5.6035546137823316,5.1357836966266,5.1181588082516924,5.274483745696985,5.678830167693549,5.146193721283104,362310.6255924171,3,E01001687,9,0,8,1,0,0,5.53030328729034,5.571825927199281,5.123799846722529,5.134642524956578,5.210427549629729,5.713996090500603,5.25034803448759,463951.1266968326,4,9,0,8,1,0,0,1.0,1,0,0,0,0,0,0
1651,5.539127205893145,5.543172059927956,5.279001275361595,5.029300352779486,5.376175381874634,5.886085285978802,5.378266612351951,313726.9279661017,4,E01001688,9,0,7,2,3,2,5.645284969806671,5.440201140880585,5.370328956604004,4.908819184303284,5.368335946559906,5.987245538711548,5.54653556060791,402704.484,6,8,1,3,4,5,4,1.0,2,-1,1,-4,2,2,2
1652,5.468197374508299,5.590614478135931,5.277329091368051,5.02674632031342,5.383123585890079,5.792187857216802,5.361389316361526,362930.5517241379,3,E01001690,9,0,7,2,1,2,5.539505992478471,5.4188634099029915,5.402633275442977,4.867980928924995,5.423335064717425,5.905134123515308,5.438261203649567,464622.39837398374,5,8,1,3,6,3,2,1.0,2,-1,1,-4,4,2,0
1653,5.19884499678245,5.398811074403616,5.449538405124958,5.064766578949415,5.260827261667985,5.611758053302765,4.956401730959232,360236.0,0,E01001692,7,2,8,0,0,0,5.3570584964752195,5.2952537131309505,5.510215816497802,5.077730023860932,5.249508502483368,5.782198963165283,5.218846344947815,461494.22,2,6,3,7,2,1,0,1.0,2,-1,1,-1,2,1,0
1654,5.285240708395492,5.6367001450339025,5.036239813464556,5.172613018242887,5.178049795387327,5.553933410681496,5.087982649951018,360792.0232558139,1,E01001693,9,0,9,0,0,0,5.4025759852789585,5.5834777495440315,5.180933516789106,5.152481340115367,5.212536578084908,5.715801812464894,5.281266605152803,462472.5751633987,3,9,0,8,1,0,0,1.0,2,0,0,-1,1,0,0
1655,5.477067797051536,5.584344209565057,5.260977527168062,5.001816381348504,5.370391855637233,5.753567359182569,5.261998161342409,361123.6666666667,3,E01001694,9,0,7,2,1,1,5.566364222384514,5.465278940631988,5.325364544036541,4.977785731249667,5.3234536362455245,5.881452166019602,5.399376054393485,462503.30319148937,5,9,1,5,3,3,2,1.0,2,0,1,-2,1,2,1
1656,5.0840310051634505,5.54440366899645,5.354957725550677,5.1660313654590295,5.195021017177685,5.607365969065073,5.147470905974105,575139.3783783783,0,E01001695,9,1,9,0,0,0,5.1246468501932485,5.384046239011428,5.40768689548268,5.21666150373571,5.1534952696631935,5.655439215547898,5.268204897992751,732463.4235294118,0,8,1,9,0,0,0,1.0,0,-1,0,0,0,0,0
1657,5.261543667834738,5.3296583963477095,5.421954109357751,5.136794661438984,5.30290543411089,5.6758230271546735,5.18124417014744,576265.7304347826,1,E01001696,6,2,9,1,0,0,5.150874802895955,5.22449505840029,5.365399213348116,5.158806726762227,5.283443771089826,5.650879451206753,5.350737496784755,733918.9214285715,0,5,1,8,2,0,1,1.0,-1,-1,-1,-1,1,0,1
1658,5.279782019279621,5.3976930777231855,5.453408484105711,5.041925715075599,5.267972767353058,5.7086673467247575,5.195196896791458,576154.3888888889,1,E01001697,7,2,7,1,0,0,5.17872150398436,5.292096745400202,5.521403619221279,5.087900310470944,5.229707291012718,5.702712229319981,5.238734128361656,733681.8,0,6,3,7,1,0,0,1.0,-1,-1,1,0,0,0,0
1659,5.52569015723903,5.259903564685729,5.603103989508094,4.970961498051155,5.374207011083278,5.851150294629539,5.475187449920468,576394.6585365854,3,E01001698,4,4,6,2,2,4,5.4401953042821685,5.159760911413964,5.6173913656397065,4.959535631727665,5.411657802602078,5.830286705747564,5.407229748178036,734017.9787234042,3,4,5,4,5,2,2,1.0,0,0,1,-2,3,0,-2
1660,5.7616076732979336,5.519363696072378,5.297434580163891,4.915037599956097,5.494202083876344,5.7938628577861655,5.266295790672302,576811.8503401361,6,E01001699,8,0,5,5,1,1,5.861738891784961,5.419385206240874,5.316312784415025,4.9437690147986775,5.456885932500546,5.884247990754934,5.418932135288532,734534.1461538462,8,8,0,4,7,3,2,1.0,2,0,0,-1,2,2,1
1661,5.240635499954224,5.279001216888428,5.5348229637146,5.053485801696778,5.3151141872406,5.777446304321289,5.218934651374817,575514.28,1,E01001700,5,3,7,1,1,0,5.270079897462035,5.116931094540109,5.604248278432613,5.061886245398212,5.289861642199455,5.764431046067382,5.264041573881245,732917.5539568345,1,3,5,7,2,1,0,1.0,0,-2,2,0,1,0,0
1662,5.785099595151049,5.549646197843696,5.22438761347333,4.921243810363816,5.475721253450156,5.788197680809578,5.244790135183595,579561.7537993921,6,E01001701,9,0,5,4,1,1,5.768530824925842,5.490681486522279,5.231309570190383,4.885614930856518,5.458040628127936,5.846128866439912,5.426072775227268,737832.2073170731,7,9,0,3,7,2,2,1.0,1,0,0,-2,3,1,1
1663,4.984535839408636,5.447823124006391,5.356697641313076,5.083593951538205,5.177450219169259,5.493479270488024,5.002403335645795,577140.203125,0,E01001702,8,1,8,0,0,0,5.1818171558958115,5.450310734185305,5.405275821685791,5.078038172288374,5.197389004808484,5.565029444116535,5.204113512328177,734960.2121212122,0,8,1,7,1,0,0,1.0,0,0,0,-1,1,0,0
1664,5.237091434001923,5.076514727728707,5.65943364075252,4.994630788053785,5.302394185747419,5.762654628072466,5.252178631510053,575840.7857142857,0,E01001703,2,5,6,1,1,1,5.205371070153935,5.146008695523763,5.464950588560596,5.061299940974442,5.244632752900271,5.711667087889209,5.212550310744453,733258.4639175257,1,4,2,7,1,0,0,1.0,1,2,-3,1,0,-1,-1
1665,5.62283893970594,5.115542184816648,5.805571912086173,4.835835867548642,5.529873330299169,6.080583822237302,5.565724035648451,490349.65753424657,5,E01001704,2,7,4,6,6,5,5.6709543931974125,5.024444985879611,5.74753908751762,4.8123748384109915,5.551918562960951,6.048128768189312,5.556576437329593,620273.198630137,6,2,7,2,8,6,4,1.0,1,0,0,-2,2,0,-1
1666,5.374286205340654,5.363823112259563,5.468490060578045,5.023554433105338,5.335505840105888,5.689469076629377,5.276893260132553,577174.4444444445,2,E01001705,6,2,7,2,0,1,5.385720320969574,5.323162055212604,5.479169920456311,4.965127832633405,5.307705372818245,5.756936068377219,5.3752969611774795,734932.173553719,3,7,2,5,3,1,1,1.0,1,1,0,-2,1,1,0
1667,5.25005429281908,5.426640952334685,5.508742560358608,5.035127916756799,5.345666815252865,5.793202635119943,5.198265394743751,577690.7205882353,1,E01001706,7,3,7,2,1,0,5.352498232428707,5.250976146157108,5.440440722365878,5.089358226576848,5.279740797939585,5.590782377257276,5.178628225824726,735602.0746268657,2,5,2,7,2,0,0,1.0,1,-2,-1,0,0,-1,0
1668,5.801621399427715,5.118733052621808,5.7869992737184495,4.817748296679112,5.535024203752217,6.126980802469086,5.556933815019173,577728.447368421,7,E01001708,2,7,3,6,7,5,5.712982772779064,5.163537344010938,5.696565424694734,4.912595531519721,5.363683795728603,5.900212985126912,5.511866746830339,735689.1260504202,7,4,6,3,4,3,3,1.0,0,2,-1,0,-2,-4,-2
1669,5.152725283056498,5.564903140440583,5.153043389692902,5.237022029981017,5.234271170198918,5.5425736252218485,4.993628931790591,370281.403125,0,E01001709,9,0,9,0,0,0,5.1059683596958285,5.5211081452991655,5.122053235121395,5.226865466198196,5.099057507903679,5.535028076366238,5.122474183530911,472819.76902173914,0,9,0,9,0,0,0,1.0,0,0,0,0,0,0,0
1670,5.455356344944093,5.407963060751194,5.46383286394724,4.989631613580192,5.386430856658191,5.790190208248976,5.304027291332803,577448.9146341464,3,E01001710,7,2,6,2,1,1,5.440860627742296,5.251149006104201,5.533245116137387,5.057149536154244,5.339664035968566,5.7426547682687135,5.379430757479721,735255.1123595505,3,5,3,6,3,1,1,1.0,0,-2,1,0,1,0,0
1671,5.2373424190835856,5.574457708093309,5.222645228671045,5.255693842455284,5.193836427226509,5.598664878569927,5.13922565622428,577739.0412371134,0,E01001711,9,0,9,0,0,0,5.179512687932665,5.453421584913664,5.211812918431291,5.177233932174254,5.195530862451713,5.720188764768226,5.2964824549505645,735660.4392523364,0,8,0,8,1,1,0,1.0,0,-1,0,-1,1,1,0
1672,5.428262843430497,5.457684757145307,5.5351574748527,4.9899977218103775,5.402397149391756,5.886383806476156,5.419066489197825,577116.5801526718,2,E01001712,8,3,6,3,3,3,5.4685889335646145,5.334898646327033,5.554894355760104,4.963967685250268,5.446978104287299,5.952102554017219,5.577018863049107,734919.1014492754,4,7,4,5,6,4,5,1.0,2,-1,1,-1,3,1,2
1673,5.2649253347645635,5.490678507348766,5.374222419832064,5.140127915403117,5.319979921631191,5.637302940306456,5.216337303752485,577779.2282608695,1,E01001713,8,1,9,1,0,0,5.19702354158674,5.366577845528012,5.263179017248608,5.224095255987985,5.217367055302574,5.614426235925584,5.283136447270711,735673.7904761905,1,7,0,9,1,0,0,1.0,0,-1,-1,0,0,0,0
1674,5.409544842583792,5.324292881148202,5.463663890248253,5.151960565930321,5.451502864322965,5.8016426298353405,5.4364542336690995,109944.66666666667,2,E01001714,6,2,9,4,1,3,5.493983018888186,5.111931639174893,5.555486456988609,5.032753732106457,5.311793786205658,5.912652508853233,5.568878959303033,139729.98630136985,4,3,4,6,3,3,4,1.0,2,-3,2,-3,-1,2,1
1675,5.699714762061389,5.074548452647765,5.9184453309471925,4.778826151321184,5.554770113816902,6.100058231780778,5.701131763742931,110115.44776119402,5,E01001715,2,8,2,6,6,7,5.87284902009097,4.84291517012047,5.955977840857073,4.831978445703333,5.389064826748588,6.105713920159773,5.694703710801674,139940.4696969697,8,0,9,2,5,7,7,1.0,3,-2,1,0,-1,1,0
1676,5.229079216718674,5.424259376525879,5.268609258532524,5.131692892313003,5.425095808506012,5.766456571221352,5.383910100162029,110481.4375,0,E01001716,7,0,8,3,1,2,5.299314622695629,5.297873825598986,5.388257373601962,5.3035783767700195,5.316831749219161,5.760860822139642,5.385798703401517,140373.1794871795,1,6,1,9,3,1,1,1.0,1,-1,1,1,0,0,-1
1677,5.4988699806741925,5.349046382559351,5.32143016033862,5.083063639790179,5.486082706106714,5.838519472673715,5.4115906235683395,110925.90361445783,3,E01001717,6,1,8,5,2,3,5.43174324237125,5.33535226633851,5.347254608718442,5.136148573647083,5.382165546148595,5.848158712118444,5.427701291903643,140863.85915492958,3,7,1,8,5,2,2,1.0,0,1,0,0,0,0,-1
1678,5.652737014221422,4.886340600071532,5.995476900929153,4.918564570070517,5.491567954872593,6.060220540171922,5.6530407354085135,110992.48484848485,5,E01001718,0,9,5,5,6,7,5.272955563138513,4.881262788001229,5.8475169504390045,4.954396119889091,5.377496456398683,5.851927487289204,5.566012606901281,141026.0294117647,1,0,8,4,4,2,4,1.0,-4,0,-1,-1,-1,-4,-3
1679,5.521725199439309,5.302113207903775,5.7147348577326,5.025312462720004,5.4072002324191,5.879744046384638,5.476506844433871,111179.70909090909,3,E01001719,5,6,7,3,3,4,5.207555013160183,5.201597352550454,5.54818391473326,5.218631112412231,5.313783439871383,5.7656787584905755,5.522860535203594,141243.7123287671,1,4,3,9,3,1,4,1.0,-2,-1,-3,2,0,-2,0
1680,5.699053612122169,5.00621138719412,5.896390694838304,4.827180686363807,5.4600684074255135,6.003007004811214,5.64455866263463,111522.7076923077,5,E01001720,1,8,3,4,5,6,5.708866537481114,4.94275128495866,5.965609626493592,4.908875316813372,5.372772372287253,6.094949843226999,5.644206523895264,141613.30434782608,7,1,9,3,4,7,6,1.0,2,0,1,0,0,2,0
1681,5.645045743899399,5.041729807853699,5.741163162702925,4.893470880690585,5.444326623102253,5.975866952638947,5.6011022235570325,503204.4382022472,5,E01001722,1,7,5,4,4,6,5.564625616996519,4.974318132605604,5.707644275439683,5.075871038180526,5.409584576083768,5.963914612288116,5.506914129821203,643308.6021505377,5,1,6,7,5,4,3,1.0,0,0,-1,2,1,0,-3
1682,6.1722819177727954,4.90052519660247,6.137352359922309,4.535709727751581,5.665409952402115,6.384516772470977,5.804701936872382,417091.7631578947,9,E01001723,0,9,0,8,9,8,5.956295923488896,4.833946915661416,6.038649465979599,4.820809168059651,5.605801454404506,6.154987771336625,5.70618518387399,526750.4268292683,9,0,9,2,9,8,7,1.0,0,0,0,2,1,-1,-1
1683,5.43696344453235,5.017773011396097,5.785487996977429,4.908978699251663,5.367258741412052,5.862201919389325,5.407372743584389,431924.4767441861,2,E01001724,1,7,5,2,2,3,5.378218766414758,4.956325724871472,5.793124545704234,4.967518051465352,5.354416534154102,5.882408597252586,5.499984016322126,541589.7272727273,2,1,8,5,4,3,3,1.0,0,0,1,0,2,1,0
1684,6.0513026173909505,4.9573822116851805,5.963504228591919,4.603800166447957,5.665677639643351,6.246581211090088,5.735101868311564,390059.52,9,E01001725,1,9,0,8,8,8,5.7801743670354915,4.863819267176375,5.918942321704913,4.846108305303356,5.489333668841591,6.131405519533761,5.640982614287847,499342.91139240505,7,0,9,2,7,8,6,1.0,-2,-1,0,2,-1,0,-2
1685,5.763713673405025,5.148429033548935,5.8815127507500025,4.744198905385059,5.571822389312413,6.081724939138993,5.67720244500948,390215.1304347826,6,E01001726,3,8,2,7,6,7,5.566908887175263,4.965422354760717,5.837856026946521,4.829396111066224,5.374872313171137,5.982901194056526,5.588904060301234,493568.9344262295,5,1,8,2,4,5,5,1.0,-1,-2,0,0,-3,-1,-2
1686,6.13767752086415,4.724121504671434,6.151464756797342,4.436973937819986,5.758067206775441,6.351887130737305,5.905832536080304,389803.81176470587,9,E01001727,0,9,0,9,9,9,6.107875045839247,4.719685803402911,6.047013990171663,4.628533596520896,5.641207516848386,6.30670701278435,5.826204801653768,499014.5824175824,9,0,9,0,9,9,8,1.0,0,0,0,0,0,0,-1
1687,5.853978643814723,5.096526129378213,5.841353214449352,4.7317320456107455,5.615050786071354,6.118644643161032,5.643586188554764,389612.1111111111,7,E01001728,2,8,2,8,7,6,5.6265565903981525,5.140082441965739,5.8016322072347,4.933608957926432,5.463213971455892,5.980216455459595,5.567175529797872,498805.36,6,3,8,4,7,5,4,1.0,-1,1,0,2,-1,-2,-2
1688,5.114923449663015,5.269477237875645,5.524967555816357,5.09436369400758,5.252615532049766,5.62760018156125,5.182920930477289,635020.5673076923,0,E01001729,5,3,8,0,0,0,5.161075532993424,5.220717726466812,5.566803101067231,5.084403116012288,5.257238630936524,5.6767945133637046,5.31723191804975,805809.1588785046,0,5,4,7,2,0,1,1.0,0,0,1,-1,2,0,1
1689,5.142881733326872,5.26407794124824,5.493805240993657,5.115930593703404,5.314848288031649,5.678255485109061,5.189338824965737,642370.6694214876,0,E01001730,5,3,8,1,0,0,5.065546334721148,5.239774432964623,5.427314341068268,5.216339549981058,5.268182834610343,5.624245944432914,5.229286772198975,814645.328125,0,5,2,9,2,0,0,1.0,0,0,-1,1,1,0,0
1690,5.318181443858791,5.19934668250986,5.6010092964043485,5.071338205724149,5.39573734998703,5.787145847404325,5.359474617887187,642631.4527027027,1,E01001731,3,4,8,3,1,2,5.154710351152623,5.130195845103433,5.535870525008398,5.076079176672807,5.244884656676164,5.749824545907636,5.340742145869749,814921.1205673759,0,3,3,7,1,1,1,1.0,-1,0,-1,-1,-2,0,-1
1691,5.3031189811640775,5.177655865406168,5.652729659244932,5.031161832398381,5.4099931716918945,5.800061990474832,5.394924813303454,643093.1896551724,1,E01001732,3,5,7,3,1,2,5.251490263475312,5.228205242090755,5.4628946880499525,5.241792422201899,5.233963714705573,5.642441335651609,5.35704446501202,815462.6111111111,1,5,2,9,1,0,1,1.0,0,2,-3,2,-2,-1,-1
1692,5.629175488541766,5.031230986602908,5.79439340374334,4.884536656906934,5.503876274194175,6.017052894685326,5.552197655042012,614124.3658536585,5,E01001733,1,7,5,5,5,5,5.442798896789551,4.989798720359802,5.794926564216614,4.833036546707153,5.330133098602295,5.9536983680725095,5.462457453727722,779496.584,3,1,8,2,3,4,3,1.0,-2,0,1,-3,-2,-1,-2
1693,5.581112553754191,5.015900631589214,5.773397667201485,4.871929242854982,5.490548391041793,5.951723315584378,5.5711398716047995,603009.157480315,4,E01001734,1,7,4,5,4,5,5.497037906646728,5.003428590774536,5.747141300201416,4.963381704330445,5.3904936285018925,5.905615242958069,5.432289867401123,768084.856,4,1,7,5,5,3,2,1.0,0,0,0,1,0,-1,-3
1694,5.386530970952597,5.253918337534709,5.541634427495749,5.007890968437654,5.375399876789874,5.7873937279345045,5.34534838975194,638091.7590361446,2,E01001735,4,3,7,2,1,2,5.30599379670489,5.211681965943221,5.527461437078623,5.015555793112451,5.349725663006961,5.7497306027255215,5.297349814530257,808558.9230769231,2,5,3,6,4,1,0,1.0,0,1,0,-1,2,0,-2
1695,5.512857153091901,5.052517352280794,5.840667777591282,4.809727175736133,5.484894034303265,5.95766947593218,5.415579867951664,110312.03703703704,3,E01001736,1,8,3,5,4,3,5.441960580646992,4.856317380070687,5.7818363904953,4.906090664863586,5.451669764518738,5.905276897549629,5.523891024291515,140212.25,3,0,7,3,6,3,4,1.0,0,-1,-1,0,1,-1,1
1696,5.8993115736090616,4.9002965170404185,6.0254193492557695,4.744241286015165,5.58543972865395,6.193654616673787,5.765487746915955,112984.92753623189,7,E01001737,0,9,2,7,8,8,5.917749039637736,4.949346012029892,6.088020132138179,4.703257120572603,5.59839653968811,6.346989802825145,5.876537760098775,143323.1923076923,8,1,9,0,9,9,9,1.0,1,1,0,-2,2,1,1
1697,5.666784617208665,4.972803631136494,5.974306306531353,4.847218150733619,5.552377238068529,6.096182636035386,5.537898158514372,113116.09677419355,5,E01001738,1,9,4,6,6,5,5.718167170882225,4.815115347504616,5.959675754110019,4.7807341031730175,5.4872864708304405,6.015485289196174,5.671236044416825,143484.04166666666,7,0,9,1,7,5,6,1.0,2,-1,0,-3,1,-1,1
1698,5.647546317179998,5.018418220678965,5.879389460881551,4.814861548940341,5.512004013856252,6.027663131554921,5.581679887572924,112699.45833333333,5,E01001739,1,8,3,5,5,5,5.597565827831145,4.91302413709702,5.903071798624531,4.9139145478125545,5.4412814801739104,5.975959222162923,5.563463223557318,142977.51612903227,5,1,9,3,6,5,4,1.0,0,0,1,0,1,0,-1
1699,5.413627309931649,5.376490533351898,5.504697892400953,4.995390036039883,5.460443880822924,5.800822294420666,5.324238797028859,105527.97222222222,2,E01001740,6,3,6,4,1,1,5.291601347596678,5.2439120893609035,5.611420739186953,5.113641830339824,5.3399814612244905,5.738729143795902,5.29801946796783,134203.08219178082,1,5,5,7,3,1,0,1.0,-1,-1,2,1,-1,0,-1
1700,5.764416561498271,4.865432570507,5.971254683160162,4.725526750861825,5.456419455540645,6.192810185543903,5.687843248441622,109412.83116883117,6,E01001741,0,9,2,4,8,7,5.663001220850718,4.7126418976556685,5.944600488458361,4.71513375214168,5.38654042993273,6.085401736554646,5.770629166137605,139517.90476190476,6,0,9,0,5,7,8,1.0,0,0,0,-2,1,-1,1
1701,5.622179843130565,5.119734055655343,5.620109746569679,4.888793814749945,5.480781886691139,5.911248756590344,5.516983084451585,112325.79047619048,5,E01001742,2,5,5,5,3,4,5.680994298723009,5.0475224609728215,5.6900385353300305,4.832061403327518,5.4281602810930325,5.952858578275751,5.570553465021981,142561.7685185185,6,2,6,2,6,4,5,1.0,1,0,1,-3,1,1,1
1702,5.57720731322964,5.185903772711754,5.69415095448494,4.982840035110712,5.447539846102397,5.9360601132114725,5.437356013804674,647307.6770833334,4,E01001744,3,6,6,4,3,3,5.387580851377067,5.158510579901226,5.63227774127055,5.075515965283928,5.31001599057246,5.955128045405372,5.474811117527849,820380.0423728813,3,4,5,7,3,4,3,1.0,-1,1,-1,1,-1,1,0
1703,5.456964374898554,5.103523871400854,5.672999274599683,4.960397458338475,5.458250003856617,5.798064810889108,5.366067100357223,639911.4175824176,3,E01001745,2,6,6,4,1,2,5.306483134184734,5.1111957944265685,5.636257981309797,5.082188076311999,5.326536100689728,5.723983737501768,5.350855329249165,812121.3762376237,2,3,5,7,3,1,1,1.0,-1,1,-1,1,-1,0,-1
1704,5.7101303314169245,5.170456603169441,5.6590475887060165,4.894206402202447,5.5223179012537,5.9119726568460464,5.525383991499742,643303.1875,6,E01001746,3,5,5,6,3,5,5.623534795641899,5.055650851130485,5.702797150611877,4.868956536054611,5.405903720855713,5.959483349323273,5.5200324803590775,816797.775,6,2,6,3,5,4,4,1.0,0,-1,1,-2,-1,1,-1
1705,5.438760092383937,5.067509742159593,5.697670445107577,5.027831539773104,5.339249805400246,5.830824018570414,5.4329489040793035,341894.00877192983,2,E01001747,2,6,7,2,2,3,5.296800620659538,4.963537974979566,5.777808369760928,5.010627302916154,5.341716595318006,5.838154794858849,5.443007651619289,431214.3391304348,1,1,7,6,4,2,2,1.0,-1,-1,1,-1,2,0,-1
1706,5.456909393871223,5.079195876697917,5.66554806127653,4.986697810691791,5.362448675946875,5.831661591163049,5.456810873288375,645994.0549450549,3,E01001748,2,5,6,2,2,3,5.4555284191418245,4.949724452343979,5.74988094368422,4.970876063225586,5.3427573070360745,5.868001607112113,5.540968717178169,819060.87283237,3,1,7,5,4,3,4,1.0,0,-1,2,-1,2,1,1
1707,5.881857310218373,4.999352633267984,5.914357574506738,4.696952140194246,5.5974531173706055,6.130390537196193,5.805691253179791,644831.4367816092,7,E01001749,1,8,1,7,7,8,5.686436856730601,4.966828308748395,5.846275069740381,4.859149544426565,5.442863977357243,6.0615992921122,5.6509464188907925,817603.8202247191,6,1,8,2,6,6,6,1.0,-1,0,0,1,-1,-1,-2
1708,5.433736765706861,5.247573779509948,5.646406261770575,5.053743245365383,5.400975114590413,5.803780291531537,5.406546609895724,105347.52252252253,2,E01001750,4,5,7,3,1,3,5.4346477117454794,5.08944862244422,5.660907223559263,5.036942917003966,5.322358532955772,5.874617011923539,5.546423576380077,140164.83333333334,3,3,6,6,3,3,4,1.0,1,-1,1,-1,0,2,1
1709,5.825975513819492,5.130505853530132,5.896795075951201,4.78162909637798,5.570528729395433,6.173714157306787,5.67356020934654,107204.96212121213,7,E01001751,2,8,2,7,7,7,5.662265592727108,5.041217873925748,5.8093891903974,4.9210204188374504,5.4447993541109385,6.0303369414979135,5.50939640186835,136580.72463768115,6,2,8,4,6,6,3,1.0,-1,0,0,2,-1,-1,-4
1710,5.226695865124196,5.398003112088452,5.4508306314279364,5.05666235116151,5.418183471705462,5.6941082584965335,5.33438600291003,106178.41441441441,0,E01001752,7,2,7,3,0,1,5.261261726840067,5.247118293228796,5.488393755282386,5.179593245861894,5.288264204890041,5.714500475738008,5.368250855955027,135196.35593220338,1,5,2,8,2,0,1,1.0,1,-2,0,1,-1,0,0
1711,5.217583383832659,5.257064293537821,5.445471384695598,5.1831593832799365,5.376153307301657,5.68155653987612,5.304228273885591,105749.76785714286,0,E01001753,4,2,9,2,0,1,5.020998136813824,5.244389706391555,5.558224109502939,5.234302003567035,5.1149162219120905,5.596312288137582,5.3206563344368565,134734.75384615385,0,5,4,9,0,0,1,1.0,0,1,2,0,-2,0,0
1712,5.075491923552293,5.260652186014713,5.554202733895718,5.168751044151111,5.313420529548939,5.636151772279006,5.169019344525459,105501.1282051282,0,E01001754,4,4,9,1,0,0,5.131933091842022,5.172186218586164,5.593330751989305,5.167852651212633,5.264029177193789,5.642561436928425,5.325475899214597,134294.1443298969,0,4,4,8,2,0,1,1.0,0,0,0,-1,1,0,1
1713,5.397905015631726,5.103019664162083,5.67504431385743,5.022948072144859,5.389232679417259,5.7853068427035685,5.349858202432332,105416.05263157895,2,E01001755,2,6,7,3,1,2,5.327830595128677,5.100989224863987,5.634098857056861,5.026366002419415,5.38948747807858,5.785165817129846,5.473819282709384,134255.20588235295,2,3,5,6,5,1,3,1.0,0,1,-1,-1,2,0,1
1714,5.296464973648122,5.144257061433472,5.640458331012086,4.943575143014025,5.391061622024383,5.8450797564231305,5.440047239297188,136888.24832214764,1,E01001756,3,5,6,3,2,3,5.32060303852476,5.044470489436183,5.7063050796245705,5.049897967535874,5.347349507233192,5.8168577013344605,5.291830758390756,216774.43448275863,2,2,6,6,4,2,0,1.0,1,-1,1,0,1,0,-3
1715,5.847324125468731,4.967176735401154,5.8199663907289505,4.68697826936841,5.574160173535347,6.085534103214741,5.6749923303723335,596107.59375,7,E01001757,1,7,1,7,6,7,5.60597930405591,4.90487434412982,5.774300291731551,4.780629563975978,5.5641191972268595,6.030976385683627,5.611687866417137,757644.1621621621,5,1,7,1,8,6,5,1.0,-2,0,0,0,1,0,-2
1716,5.315907266560723,5.249905883564669,5.49246143172769,5.11339534591226,5.365826609555413,5.677694180432488,5.24453243227566,617209.4705882353,1,E01001758,4,3,8,2,0,1,5.34236476562991,5.157063569172775,5.562540472143947,5.077313957828106,5.351926539203908,5.7147984363064905,5.274534901770035,782346.2574257426,2,4,4,7,4,0,0,1.0,1,0,1,-1,2,0,-1
1717,5.5886636164880565,5.123687344212686,5.688583422732609,4.999800041157712,5.412829474736285,5.874064295522628,5.5932510757959015,636660.6344086021,4,E01001759,2,6,7,3,2,6,5.367465064983175,5.043485847386447,5.676377549315944,5.05340608563086,5.3107026393967445,5.789858884281582,5.411502662331167,807484.505050505,2,2,6,6,3,1,2,1.0,-2,0,0,-1,0,-1,-4
1718,5.371010942537277,5.0824011847621104,5.79361704920159,4.931078248336667,5.417498968663763,5.859259517466436,5.397893044792238,641830.4180327869,2,E01001760,2,7,5,3,2,2,5.385174931598311,4.929089739543049,5.829328855546582,4.9771837016113665,5.351017528221387,5.833432646358714,5.547868763699251,813946.9495798319,3,1,8,5,4,2,4,1.0,1,-1,1,0,1,0,2
1719,5.7587177010550015,5.012754763382069,5.804510607235674,4.815678618956303,5.633376190627831,6.003155597742053,5.625364241392716,641690.7391304348,6,E01001761,1,7,3,8,5,6,5.575248220028022,5.0564915002920685,5.736566259310796,4.89199111247674,5.4102873129722395,5.85218837016668,5.5674276397778435,814564.5128205129,5,2,7,3,5,2,4,1.0,-1,1,0,0,-3,-3,-2
1720,5.493913029587787,4.938994819185008,5.8177377255066585,4.9049590639446095,5.483535052382428,5.945616406979768,5.57279142089512,642743.5391304347,3,E01001762,0,7,5,5,4,5,5.427027259711866,5.0106375206399845,5.75015182627572,4.951063851515452,5.350953553561811,5.82904111676746,5.550246237604706,815083.7777777778,3,2,7,4,4,2,4,1.0,0,2,0,-1,-1,-2,-1
1721,5.664071348580447,5.027701391415163,5.818652548573234,4.840189787474546,5.531383150003173,6.000336609103463,5.636151097037575,643009.9204545454,5,E01001763,1,7,4,6,5,6,5.542161759403017,5.079202708270815,5.858761972851223,4.856667563319206,5.403997469279501,5.996179597245322,5.693660962912771,815323.9861111111,5,2,8,2,5,5,7,1.0,0,1,1,-2,-1,0,1
1722,5.386503642483762,5.312985377562674,5.683480902722008,4.963971981249357,5.393912069421066,5.864158994273136,5.328971616845382,639537.7052631578,2,E01001764,5,6,6,3,2,1,5.354378556937315,5.174298827567797,5.63558901695723,5.08438997456197,5.276474398173643,5.807573974802253,5.390952408983466,810143.5730337079,2,4,5,7,2,2,2,1.0,0,-1,-1,1,-1,0,1
1723,5.248168979372297,5.420500897935459,5.408693185874394,5.177172439438956,5.31795534491539,5.680727801152638,5.165386261684554,622999.8392857143,1,E01001765,7,1,9,1,0,0,5.194295318126678,5.289068847894669,5.381086177825928,5.236553304195404,5.313044127225876,5.647824487686157,5.189004739522934,793633.19,1,6,1,9,3,0,0,1.0,0,-1,0,0,2,0,0
1724,5.665357114663765,5.050040599125535,5.763144738638579,4.84859965808356,5.474660981946917,6.009078990167646,5.611779049261292,596368.4626865672,5,E01001767,1,7,4,4,5,6,5.541551974511916,4.962073156910558,5.762826261981841,5.0138599795679895,5.414798261657838,5.998990008907933,5.487307325486214,757290.3387096775,5,1,7,6,5,5,3,1.0,0,0,0,2,1,0,-3
1725,5.8952036056112735,4.949316620826721,5.961684090025882,4.687898997296679,5.575862306229611,6.219863414764404,5.86089902735771,613722.9787234042,7,E01001768,1,9,1,7,8,9,5.842995323160643,4.966907830648525,6.011931806482295,4.8873138645643825,5.511929809406239,6.179177384222707,5.702211353086656,783534.8924731183,8,1,9,3,8,8,7,1.0,1,0,0,2,1,0,-2
1726,5.92399514062064,5.018080729075841,5.84570250919887,4.738799881253923,5.60674369267055,6.1937600599016465,5.745434494018554,642265.9257142857,8,E01001769,1,8,2,7,8,8,5.845648090491134,5.046500239479408,5.855457632729177,4.820140239897738,5.483280171169324,6.084930465462502,5.575008453947775,814553.0674157303,8,2,8,2,7,7,5,1.0,0,1,0,0,0,-1,-3
1727,5.474465852783572,5.210503021555562,5.701258269048506,4.855409234762192,5.360956734226596,5.912660660282258,5.529635235186546,595389.4758064516,3,E01001770,4,6,4,2,3,5,5.614259482494423,5.144401167120252,5.737131416797638,5.042886532843113,5.409137986600399,5.9608041154486795,5.6156087304864615,756795.1428571428,5,3,7,6,5,4,5,1.0,2,-1,1,2,3,1,0
1728,5.354731713022504,5.345965266227722,5.561972626617977,5.093428777796881,5.48960446034159,5.8197058566979,5.43727316388062,647379.2321428572,2,E01001772,6,4,8,5,2,3,5.3127356232076455,5.099125644435054,5.649996681489807,5.134201466173366,5.385892992434294,5.939913711686065,5.497763749481975,820832.2028985508,2,3,5,8,5,4,3,1.0,0,-3,1,0,0,2,0
1729,5.057601508584995,5.33501480852516,5.417289844994406,5.289592054283735,5.232172969475533,5.577469213494977,5.096960331629781,515874.87378640776,0,E01001773,6,2,9,0,0,0,5.067843095879805,5.172564697265625,5.4779215335845945,5.255588539023148,5.252196116196481,5.641407864972165,5.219835777031748,727002.6210526315,0,4,2,9,2,0,0,1.0,0,-2,0,0,2,0,0
1730,5.32965938500532,5.141752494601753,5.537338951441247,5.0256164787322515,5.414110181838509,5.750562512029813,5.364472859487758,647140.5275590551,1,E01001774,3,3,7,3,1,2,5.314282075682683,5.0882970815274255,5.570913576368076,5.062629656115575,5.427668155129276,5.740360902316534,5.3470681594378915,820524.7388059702,2,3,4,7,6,1,1,1.0,1,0,1,0,3,0,-1
1731,5.378678091698223,5.215558840168847,5.574451141887241,4.946221949325667,5.439452494184176,5.775492240985234,5.5141878790325585,642781.0694444445,2,E01001775,4,4,6,4,1,4,5.369209761571402,5.113829316514911,5.639748253003515,4.908960957719822,5.539611630969578,5.849851625134247,5.369640161292722,814901.8787878788,2,3,5,3,8,2,1,1.0,0,-1,1,-3,4,1,-3
1732,5.274860386495237,5.294831874929828,5.518652649573338,5.171628601757097,5.295135705559342,5.658288334622795,5.195075163134822,540643.2592592592,1,E01001776,5,3,9,1,0,0,5.141762769099364,5.0478978390546185,5.5054483733226345,5.155750232873504,5.236407068586841,5.581622593181649,5.350670274999953,700940.8762886598,0,2,3,8,1,0,1,1.0,-1,-3,0,-1,0,0,1
1733,5.154392383457009,5.193137067595338,5.606934092403237,5.116408665195789,5.328826830278035,5.61912288930681,5.268138025321212,342823.7843137255,0,E01001777,3,4,8,1,0,1,5.070117978006602,5.047903684526682,5.602192927896977,5.166601421684026,5.312855896353722,5.63380391523242,5.338581473380327,447621.30625,0,2,4,8,3,0,1,1.0,0,-1,0,0,2,0,0
1734,5.149774684128186,5.236384855094531,5.575046099669544,5.069579283396403,5.334787443174538,5.642532111905146,5.315031084608524,107358.0425531915,0,E01001779,4,4,8,2,0,1,5.274166174184263,5.0624471957387485,5.621469842063056,5.088835251097586,5.337096623345917,5.672009075389189,5.40160654494965,136627.16339869282,1,2,5,7,3,0,2,1.0,1,-2,1,-1,1,0,1
1735,5.245932614361799,5.087508849155756,5.673434855025492,4.984521077003008,5.42610380826173,5.726696005573979,5.397785775455428,106067.1975308642,1,E01001780,2,6,6,3,1,2,5.341084045298556,4.917750853173276,5.66909699237093,4.935650403195239,5.428130662187617,5.776669086293971,5.443296223244769,135078.97872340426,2,1,6,4,6,1,2,1.0,1,-1,0,-2,3,0,0
1736,5.615027464353121,5.208724906811347,5.599105147215036,4.967023358895228,5.615405935507554,5.920158899747408,5.508403263030908,106182.28205128205,4,E01001781,4,4,6,8,3,4,5.777137709760118,5.155763800116791,5.674829124034136,4.8076586969967545,5.570410358494725,5.987622398069536,5.589783827463786,135184.7471264368,7,4,6,1,9,5,5,1.0,3,0,2,-5,1,2,1
1737,5.126024555900822,5.286524479803831,5.444647557061652,5.152578672637111,5.290899704331937,5.638859283664952,5.270931522483411,107179.10869565218,0,E01001782,5,2,9,1,0,1,5.120171880468409,5.150135084669641,5.439502718600821,5.12119625603899,5.165891326488333,5.699557550410007,5.290804189570407,136341.43617021278,0,4,2,8,0,0,0,1.0,0,-1,0,-1,-1,0,-1
1738,5.218283633391063,5.368000004026625,5.667905864892183,5.086286814124496,5.35450886576264,5.743909235353823,5.398853595610018,106661.94444444444,0,E01001783,6,5,8,2,1,2,5.3263448968766225,5.120375690006075,5.5994433826870385,5.108386181649708,5.292742411295573,5.857237891545371,5.510161394164676,135776.50793650793,2,3,4,7,2,2,3,1.0,2,-3,-1,-1,0,1,1
1739,5.0359434366226195,5.171829814177293,5.586952998087956,5.151600808363694,5.202476327235882,5.572149540827825,5.201655061428363,105557.73846153847,0,E01001784,3,4,9,0,0,0,5.020724004593449,5.232384374176246,5.6096450867860215,5.162252742311229,5.270239652066991,5.604685551878335,5.1915966704271845,134433.07246376813,0,5,5,8,2,0,0,1.0,0,2,1,-1,2,0,0
1740,5.779766181180643,5.0164371423943095,5.879272236380467,4.813636901766755,5.525033529414687,6.230221448942673,5.630360442538594,603727.0581395349,6,E01001785,1,8,3,6,8,6,5.655570595160775,5.021319251993428,5.8529190265614055,4.862833804410437,5.340452146271001,6.080796915551891,5.707072215235752,769680.9782608695,6,2,8,2,3,7,7,1.0,0,1,0,-1,-3,-1,1
1741,5.3632730183930235,5.3775447802297,5.460565264882712,5.094134682211383,5.289540673124379,5.720636602105765,5.214847251259047,572998.301724138,2,E01001786,6,2,8,1,1,0,5.461626837470314,5.3791922168298205,5.424098336696625,5.067650646513159,5.220753141966733,5.766315588084134,5.374997447837483,729562.7727272727,4,8,1,7,1,1,1,1.0,2,2,-1,-1,0,0,1
1742,5.073791579862611,5.468798812511748,5.3189576853693055,5.266509392620188,5.201624911443322,5.592531805544828,5.101437623521923,595311.9203539822,0,E01001787,8,1,9,0,0,0,5.053624539435664,5.462303077118306,5.31902240046972,5.298469280894799,5.175022484380988,5.54162850711919,5.121550786344311,756745.3164556962,0,9,0,9,0,0,0,1.0,0,1,-1,0,0,0,0
1743,5.188804862862926,5.392770763170922,5.410137996835224,5.160932144876254,5.254928827285767,5.68428462238635,5.219010100526325,594832.593220339,0,E01001788,7,1,9,0,0,0,4.952637070959264,5.319810646953004,5.415092952323683,5.333220940647704,5.240464625936566,5.6550192688450664,5.217668038426024,756069.9545454546,0,6,1,9,1,0,0,1.0,0,-1,0,0,1,0,0
1744,5.475372242927551,5.194416828950247,5.783068116505941,4.968905988004472,5.415023059315152,5.934555024570889,5.410170140531328,595660.9777777778,3,E01001789,3,7,6,3,3,3,5.392594652600808,5.0404419167207015,5.705620432844256,5.116385902508651,5.324327693127169,5.900807602570788,5.39829696877168,757103.6138613861,3,2,6,7,3,3,2,1.0,0,-1,-1,1,0,0,-1
1745,5.511091748150912,5.167514389211481,5.822316031022505,4.994778234308416,5.434945431622592,5.8695969841697,5.451885682886297,590246.4,3,E01001790,3,8,6,3,2,3,5.308204050574984,5.061479344964027,5.654400054897581,5.063136962907655,5.293862625956535,5.797085872718266,5.344254257423537,750943.9821428572,2,2,5,7,2,1,1,1.0,-1,-1,-3,1,-1,-1,-2
1746,5.589087275010121,5.210302318198772,5.730822807625879,5.003782978540735,5.399034978468207,6.005432638940932,5.445641943171054,595050.582278481,4,E01001791,4,6,7,3,5,3,5.252030320363502,5.080303626517727,5.565749850991654,5.110025041723905,5.249686249314922,5.898794066416074,5.460223080360726,756023.5342465753,1,2,4,7,2,3,3,1.0,-3,-2,-2,0,-1,-2,0
1747,5.933952170326596,5.11185367220924,5.735387313933599,4.718818205878848,5.5136951094581965,6.157573382059733,5.688339713641575,595006.0761904762,8,E01001792,2,6,1,5,7,7,5.690978449525185,5.209058207215615,5.641865412008415,4.914369903721855,5.4194040529936265,6.034790738115033,5.551165624729638,756405.1165048544,6,5,5,4,6,6,4,1.0,-2,3,-1,3,1,-1,-3
1748,6.047851100432134,5.034820689564258,5.8533445100868695,4.639024739771818,5.657760839546676,6.201655879484869,5.774267256787393,595289.3097345133,9,E01001793,1,8,0,8,8,8,5.825307960151344,4.877918756136331,5.811450963379235,4.72645660625991,5.567605772326069,6.129937784646147,5.602855161953998,756727.3333333334,8,0,8,0,9,7,5,1.0,-1,-1,0,0,1,-1,-3
1749,5.921185203452609,4.9594749799415245,5.946951389312744,4.724836101282889,5.52423550833517,6.199305943588712,5.803528714535841,595471.4701492537,8,E01001794,1,9,1,6,8,8,5.77238957948618,4.9347443555618495,5.906191732499983,4.803671477557896,5.504980544110278,6.139564097344459,5.696836459886778,756898.7342657342,7,1,9,1,8,8,7,1.0,-1,0,0,0,2,0,-1
1750,5.605617205301921,5.009955598984235,5.983916968475153,4.7620828254723255,5.405111616040453,6.13829959763421,5.684428721298406,595904.086419753,4,E01001795,1,9,2,3,7,7,5.545012524958407,4.853253522615754,5.913536832573708,4.832104449861505,5.424335147557634,6.0666818993814875,5.6907518365409935,757429.415730337,5,0,9,2,6,6,7,1.0,1,-1,0,0,3,-1,0
1751,5.565109960325471,4.9301385552018555,5.961598726419302,4.745576363343459,5.513800356414292,5.992456368037632,5.536386099490491,595961.5494505494,4,E01001796,0,9,2,5,4,5,5.49608984690034,4.840652535470684,5.964789219116897,4.922532867849543,5.411662291944697,5.934219861298464,5.510131886835849,757495.8426966292,4,0,9,4,5,4,3,1.0,0,0,0,2,0,0,-2
1752,5.633129041303288,5.077161814678799,5.833146723833951,4.750678445805203,5.507374938238751,6.083286246115511,5.593051999807358,557499.6704545454,5,E01001798,2,8,2,5,6,6,5.54388475563468,4.996921832968549,5.87667662922929,4.945460326787902,5.342752231330406,5.988069176673889,5.518239886295505,696537.7804878049,5,1,8,4,4,5,4,1.0,0,-1,0,2,-1,-1,-2
1753,5.9556911672864645,5.094739579728672,5.884023474795478,4.6912767972264975,5.574202162878854,6.234124622174671,5.7769443435328345,112069.96428571429,8,E01001799,2,8,1,7,8,8,5.867117075596825,5.006947695198706,5.817195391250869,4.823957990791838,5.456832974644031,6.211128529855761,5.84601832648455,142588.81355932204,8,2,8,2,7,8,9,1.0,0,0,0,1,0,0,1
1754,5.410655681477037,5.237256343974623,5.736551273700803,4.84682144675144,5.347294685452483,5.837576888328375,5.615860362385595,344069.06976744183,2,E01001800,4,6,4,2,2,6,5.431060240818904,5.118164866398542,5.553234127851633,5.023771781187791,5.246019161664522,5.799161831537883,5.520088235537211,424890.9487179487,3,3,4,6,2,1,4,1.0,1,-1,-2,2,0,-1,-2
1755,5.983518877450158,5.108287607922273,5.722463511368808,4.843286477467593,5.59182202465394,6.103490271989037,5.618092805147171,110550.11764705883,8,E01001801,2,6,4,7,6,6,5.800411646483375,5.047778291780441,5.68446189458253,4.867745641802178,5.511209425379018,6.146106696519696,5.648594928569481,140482.2131147541,8,2,6,3,8,8,6,1.0,0,0,0,-1,1,2,0
1756,6.035538994603687,5.053819629881117,5.886326226923201,4.8219132158491345,5.666129214896096,6.208857907189263,5.871602836582396,107463.98611111111,8,E01001802,1,8,3,8,8,9,5.65077691078186,5.002308602631092,5.910909503698349,4.842318995296955,5.367887578904629,6.119433733820915,5.866590721905231,137151.475,6,1,9,2,4,7,9,1.0,-2,0,1,-1,-4,-1,0
1757,6.037702135035866,5.08996815806941,5.843714197058427,4.802798561045998,5.625822200273213,6.196003600170738,5.829005959159449,110686.04210526316,8,E01001803,2,8,3,8,8,9,5.755007050370657,5.055873773431265,5.817628434909287,4.942651305147397,5.413891935861239,6.187491793786326,5.800471962139171,140596.37634408602,7,2,8,4,5,8,8,1.0,-1,0,0,1,-3,0,-1
1758,6.145653691556719,5.149019651942783,5.885956996017033,4.737127885222435,5.768754497170448,6.3476346201366844,5.978936354319255,109858.58333333333,9,E01001804,3,8,2,9,9,9,5.809871910512447,5.070362371206284,5.86813152730465,4.812950211763382,5.4847028106451035,6.201217058300972,5.788746894896031,139644.9,8,2,8,2,7,8,8,1.0,-1,-1,0,0,-2,-1,-1
1759,5.742060765624046,4.873142879456282,6.020804721862078,4.71470938064158,5.520890720188618,6.271434176713228,5.713399356231093,171980.75,6,E01001805,0,9,1,6,8,7,5.623205785881983,4.956097824932778,5.907713364248407,4.8931722134759985,5.340528827824005,6.146864489333271,5.686049915339849,238532.95890410958,6,1,9,3,3,8,7,1.0,0,1,0,2,-3,0,0
1760,5.716296599461482,5.118118826325957,5.665705830900819,4.900824403429365,5.55494250701024,5.969023856249723,5.518233520167691,111100.1048951049,6,E01001806,2,5,5,6,4,4,5.630194055954082,5.002821647080799,5.668903798864992,4.956577419434618,5.425933917096797,5.9818813896819245,5.528309495657083,141151.9597315436,6,1,6,4,6,5,4,1.0,0,-1,1,-1,0,1,0
1761,5.958215925428602,5.126296755708294,5.859079007749204,4.6138384136152855,5.6445819404390125,6.23470444738129,5.753949449386126,106978.29629629629,8,E01001807,2,8,0,8,8,8,5.852753758430481,4.880850305611437,5.849938144738024,4.787823697382754,5.483882123773748,6.125608400865034,5.780599489808083,136147.79545454544,8,0,8,1,7,7,8,1.0,0,-2,0,1,-1,-1,0
1762,5.593198408951631,4.989053387899657,5.93054056382394,4.829676156645423,5.390589726937784,6.013731251965772,5.779016684841466,333672.91891891893,4,E01001808,1,9,3,3,5,8,5.407222991519504,5.072497622172038,5.77106226461905,4.987568502072935,5.284983125439396,5.903153357682405,5.603742394623933,429066.43703703705,3,2,7,5,2,3,5,1.0,-1,1,-2,2,-1,-2,-3
1763,6.000051644444466,5.020985811948776,5.812810888886451,4.702472081780433,5.608571609854698,6.142017892003059,5.614534462988376,143802.925,8,E01001809,1,7,1,7,7,6,5.691806257688082,4.9164262294769285,5.901310803340031,4.803129858237046,5.282756429452163,6.017442094362699,5.593080232693599,155572.86153846153,6,1,9,1,2,5,5,1.0,-2,0,2,0,-5,-2,-1
1764,5.479659702818273,5.3664981854164,5.485306695356208,5.061699570235559,5.417948219735743,5.968658548290446,5.533843272823399,108977.49152542373,3,E01001811,6,3,8,3,4,5,5.369627066687042,5.223985017514696,5.409052381328508,5.136092997064777,5.14541734901129,5.862393608280256,5.5527833466436345,138589.19607843139,2,5,1,8,0,2,4,1.0,-1,-1,-2,0,-3,-2,-1
1765,6.104257307430305,4.951596234104421,5.927762284137235,4.641826729963322,5.662020772990614,6.303176674512353,5.810211736376923,107731.32673267326,9,E01001812,1,9,0,8,9,8,5.653730624533714,5.045157857397769,5.7616369813046555,4.826472174614034,5.294464423301372,6.131271461223034,5.863241517797429,137525.60638297873,6,2,7,2,2,8,9,1.0,-3,1,-2,2,-6,-1,1
1766,5.76555432785641,5.1669434905052185,5.673099013892087,4.844745496457273,5.581513025543907,5.958321473815224,5.548982473936948,109596.79545454546,6,E01001813,3,6,4,7,4,5,5.6517906845832355,5.181861739985797,5.642609472177466,4.906472595370546,5.394609716473793,5.973621611692468,5.63708190528714,139308.16326530612,6,4,5,3,5,5,6,1.0,0,1,-1,-1,-2,1,1
1767,5.377980540960263,5.140374363997044,5.7336295415193606,4.97036694869017,5.31450877739833,5.902534079857362,5.5319635944488725,390475.1153846154,2,E01001814,3,6,6,1,3,5,5.19907788262851,5.097497248995131,5.6197860655577285,5.070216144340626,5.111656292625096,5.718936875246573,5.503798291303109,499896.7971014493,1,3,5,7,0,0,3,1.0,-1,0,-1,1,-1,-3,-2
1768,5.662633227450507,5.284257830608459,5.63353306055069,4.913708712373461,5.464373318921952,6.008436430068243,5.544159078881854,644822.4880952381,5,E01001815,5,5,5,4,5,5,5.508983179217293,5.14109621445338,5.604949863184066,5.045780231555303,5.346619604598908,5.929167449474335,5.516568859418233,817606.8095238095,4,3,5,6,4,4,4,1.0,-1,-2,0,1,0,-1,-1
1769,5.772652459538673,5.224087022552806,5.786063566680782,4.9251726501244155,5.572248143598068,6.093540871438901,5.632134805040911,643747.9256198347,6,E01001816,4,7,5,7,6,6,5.508557991150322,5.141621408112552,5.7385884162482865,5.010919048151838,5.414177032785678,6.032940420535726,5.504264414857287,816165.5229357798,4,3,7,6,5,6,3,1.0,-2,-1,0,1,-2,0,-3
1770,5.909165405390556,5.067274097810712,5.8434386650721235,4.731813250926503,5.673150811279029,6.153488711306923,5.828075102546759,647106.5877192982,8,E01001819,2,8,2,9,7,9,5.83177459471434,5.020339841981536,5.7751191009595555,4.8918116231566495,5.516765636147805,6.130831905939047,5.718938483775241,820351.8058252428,8,2,7,3,8,8,7,1.0,0,0,-1,1,-1,1,-2
1771,5.4429715245962145,5.318680065870285,5.4822542637586595,4.923784139752388,5.454894563555717,5.923688277602196,5.425673463940621,646579.9875,2,E01001820,5,2,5,4,3,3,5.473180543130903,5.238838884367872,5.682352275990728,5.036961840159857,5.411079780379338,5.952636063988529,5.559567526205262,819844.7164179104,4,5,6,6,5,4,4,1.0,2,0,4,1,1,1,1
1772,5.386087440309071,5.237858834720793,5.599883832628765,4.879765512451293,5.40048146815527,5.873370564173138,5.384592446069869,645944.5396825396,2,E01001821,4,4,4,3,2,2,5.33381378023248,5.254168372405203,5.528675505989476,5.074917657333508,5.323285056833635,5.768478928950795,5.344529597382796,819651.9298245613,2,5,3,7,3,1,1,1.0,0,1,-1,3,0,-1,-1
1773,5.753414301023091,5.079391913871243,5.835526094044725,4.722716932427393,5.623939279007585,6.17095549139258,5.649436341573114,394997.9726027397,6,E01001822,2,8,1,8,7,7,5.606888908735463,5.003232287688994,5.805757217004266,4.958106524507764,5.428354568884406,5.992192157557313,5.545371554267239,498531.6901408451,5,1,8,4,6,5,4,1.0,-1,-1,0,3,-2,-2,-3
1774,5.787860776484012,5.151631960272789,5.837413477897644,4.7524976372718815,5.5337621659040455,6.0924586147069935,5.341654026508332,389422.5375,6,E01001823,3,8,2,6,6,2,5.431588940082058,5.015237652486371,5.850635493955305,4.9244255692728105,5.377958461161582,6.024428263787301,5.374306888349595,498467.8064516129,3,2,8,4,4,6,1,1.0,-3,-1,0,2,-2,0,-1
1775,6.151691907644272,5.102392731110255,5.847286359469096,4.641550960143407,5.742478723327319,6.159636316696803,5.784377892812093,389618.73333333334,9,E01001824,2,8,0,9,7,8,5.954603693900852,5.063582564712664,5.717738026872687,4.715431468202434,5.536668252507481,6.045528418427214,5.635804294446193,498733.6422018349,9,2,7,0,8,6,6,1.0,0,0,-1,0,-1,-1,-2
1776,5.9942079643870505,5.068396797013837,5.9208164492318796,4.739388759746108,5.6705108381981075,6.285890354666599,5.624414565951326,390137.81395348837,8,E01001825,2,8,2,8,9,6,5.619405048649486,5.091709049736581,5.847327034647872,4.97462082199934,5.462555030497109,6.12112073200505,5.658255806783351,499469.0487804878,6,3,8,5,7,7,6,1.0,-2,1,0,3,-1,-2,0
1777,5.9132332511437244,5.18451500703127,5.846862679872757,4.715237172750326,5.631668185576414,6.130977364686819,5.662362596927545,390087.71794871794,8,E01001826,3,8,1,8,7,7,5.4565621249816,5.23842750156627,5.623087456647087,5.007534625950981,5.362597368745243,5.906034334968118,5.411760361054364,499371.1411764706,3,5,5,5,4,3,2,1.0,-5,2,-3,4,-4,-4,-5
1778,5.992052233949,5.0780031559418655,5.816644366906614,4.672120775495257,5.656017901946087,6.133028081485203,5.700411670062007,389338.60204081633,8,E01001827,2,7,1,8,7,7,5.592761022349198,5.00859734788537,5.731146181623141,4.992895318816106,5.395834248512983,6.005242491761844,5.597546791036923,498487.8541666667,5,2,7,5,5,5,5,1.0,-3,0,0,4,-3,-2,-2
1779,5.553140000218437,5.233671676544916,5.510543638751621,4.907321065664291,5.432174984897886,5.847912081650326,5.481516267572131,391738.61904761905,4,E01001828,4,3,5,3,2,4,5.2496560782921025,5.252253647257642,5.515789072688033,5.1825250459880365,5.2796143002626374,5.734582511390128,5.3539548051066514,501572.6951219512,1,5,3,8,2,1,1,1.0,-3,1,0,3,-1,-1,-3
1780,5.710954185080739,4.875260435374437,5.988369000696503,4.625387303597104,5.5779152507275604,6.189076957449449,5.5924867096200455,209912.61946902654,6,E01001829,0,9,0,7,8,6,5.804214429437068,4.734598152470171,5.984848018278155,4.652341422281768,5.422279051521368,6.225743831249705,5.717188726391709,247399.23684210525,8,0,9,0,6,9,7,1.0,2,0,0,0,-1,1,1
1781,5.389873874684175,5.004904539634784,5.855246377487977,4.883280264834563,5.443299523244302,5.861502210299174,5.424230609089136,324500.5833333333,2,E01001830,1,8,5,4,2,3,5.377636317813068,4.901006614396332,5.824097304169191,4.9507836737763995,5.396922253687447,5.81800705795988,5.382109670464052,422629.68807339447,2,0,8,4,5,2,1,1.0,0,-1,0,-1,1,0,-2
1782,5.52584871756179,5.025108195841312,5.7841120553868155,4.8764133762036055,5.471335300377437,5.882329412869045,5.484105813716139,612018.25,3,E01001831,1,7,4,4,3,4,5.428497719764709,4.9697970877523,5.730781393465788,4.911387436286263,5.361311039717301,5.850720451189124,5.475206921411597,783166.4434782609,3,1,7,3,4,2,3,1.0,0,0,0,-1,0,-1,-1
1783,5.747249547172995,4.9660043167132955,6.035870739057953,4.744721653414707,5.5358078947254254,6.1506597364650055,5.693805824307835,645873.6568627451,6,E01001832,1,9,2,6,7,7,5.612955619891484,4.946170009948589,5.961800266195227,4.960681345727709,5.455161116741322,6.055707304565995,5.593939921370259,818930.4907407408,5,1,9,4,6,6,5,1.0,-1,0,0,2,0,-1,-2
1784,5.666982088238001,4.924052422245343,5.928503240148227,4.849560366322597,5.453859120607376,6.104082976778348,5.58696839461724,645910.0677083334,5,E01001833,0,9,4,4,6,6,5.547278158126339,4.976193603648935,5.825836354686368,4.953305223936676,5.397949982714909,5.95992923039262,5.4877923022034345,818979.9784946237,5,1,8,4,5,4,3,1.0,0,1,-1,0,1,-2,-3
1785,5.550430796363137,4.9978154433238045,5.8011144260307415,4.962475398918251,5.478516533777311,5.9457114362097405,5.447143062368616,357568.5714285714,4,E01001834,1,7,6,5,4,3,5.414223509175437,4.950373997007097,5.772274088859558,4.982592427730561,5.380705295290266,5.905643449510847,5.450715177399772,534796.5571428571,3,1,7,5,5,3,2,1.0,-1,0,0,-1,0,-1,-1
1786,6.05616987485152,4.849318539179288,5.9602277003801785,4.700488323431749,5.572274442819449,6.401837572684655,5.815809436944815,104740.10769230769,9,E01001835,0,9,1,7,9,9,5.959565298897879,4.802928818975176,6.135512125492096,4.764544589178903,5.537588778563908,6.387329745292663,5.801882973739079,133404.24285714285,9,0,9,1,8,9,8,1.0,0,0,0,0,1,0,-1
1787,5.67491854404236,5.080293358622731,5.787339277200766,4.822684307198425,5.480110075090315,5.9791107611222705,5.5641862470786885,644742.4405594405,5,E01001836,2,7,3,5,4,5,5.521034663373774,5.125737050085357,5.723712675499193,4.990607057195721,5.418227871259053,5.894636505300348,5.452702230395693,817474.1757575758,4,3,7,5,6,3,2,1.0,-1,1,0,2,1,-1,-3
1788,5.889190063476563,5.139006451368332,5.791953375339508,4.744406195878983,5.600097885131836,6.119389057159424,5.819396829605102,644810.71,7,E01001837,3,7,2,7,7,9,5.744349883334471,5.099414578758844,5.760613325798865,4.893147495713564,5.515420088673582,6.017851841331709,5.61457615559644,817522.1287128713,7,3,7,3,8,5,5,1.0,0,0,0,1,1,-2,-4
1789,5.4717826159988965,5.2023245096206665,5.632599129909423,5.0028624432842905,5.485285052439061,5.9332068373517295,5.46359775415281,643029.8048780488,3,E01001838,3,5,7,5,3,3,5.2235228284712765,5.2300469516426,5.572917023012715,5.073969097547634,5.358479005034252,5.793919304365753,5.401453742416956,815384.8387096775,1,5,4,7,4,1,2,1.0,-2,2,-1,0,-1,-2,-1
1790,5.4179230221995605,5.069118133297673,5.7793496096575705,4.986567974090576,5.451748544787184,5.834872201636985,5.3851352017602805,643747.3827160494,2,E01001839,2,7,6,4,2,2,5.273022275292472,5.015059589000231,5.700304296579254,5.005653152305089,5.402015742291225,5.779443505105008,5.356536452689867,816303.7415730337,1,2,6,5,5,1,1,1.0,-1,0,-1,-1,1,-1,-1
1791,5.570170430962099,5.143858776180022,5.65406709198558,5.018666732201883,5.362079807377737,5.917526968028567,5.578141155592892,643950.5412844036,4,E01001840,3,5,7,2,3,5,5.3868737254823955,5.101037758872622,5.676393279575167,5.0485774573825655,5.3707505146662395,5.851162469954717,5.447972906203497,816541.1333333333,3,3,6,6,4,2,2,1.0,-1,0,1,-1,2,-1,-3
1792,5.953601873837984,5.2011519097364864,5.763720836776954,4.7436507653731566,5.6731269141802425,6.066511135834914,5.615415978890199,644419.25,8,E01001841,3,7,2,8,6,6,5.747063509055546,5.050605781224309,5.851461291313171,4.878773387597532,5.550315849635066,6.0906093363859215,5.706966726147399,817020.2142857143,7,2,8,3,8,7,7,1.0,-1,-1,1,1,0,1,1
1793,5.680352421774381,5.0990664734356645,5.755891499312027,4.757777770360311,5.528143620145494,6.08393709210382,5.709064430084782,644253.768115942,5,E01001842,2,7,2,6,6,7,5.632970308646177,5.059126667487315,5.7520352112941255,4.8089691049013386,5.551522105168074,6.049763590861589,5.797090200277475,816890.7564102564,6,2,7,2,8,6,8,1.0,1,0,0,0,2,0,1
1794,5.717699368235091,5.158739845517656,5.807433843612671,4.9033823231576195,5.359477212731267,6.198539707022653,5.757960039125362,644109.2112676057,6,E01001843,3,7,5,2,8,8,5.443870572300701,5.104330906620273,5.729340364406635,5.112317625578347,5.330608637301953,6.037863118307931,5.626387880994128,816709.9090909091,3,3,7,7,3,6,6,1.0,-3,0,0,2,1,-2,-2
1795,5.840478418578564,5.015377012776657,5.978487259905103,4.723189660361116,5.591586842503347,6.231098483985578,5.739411080387277,643153.7957746478,7,E01001844,1,9,1,7,8,8,5.722329694520003,4.979917054656167,5.829639124420454,4.793770117579766,5.492431076817542,5.999332787855616,5.637092749277751,815566.9245283019,7,1,8,1,7,5,6,1.0,0,0,-1,0,0,-3,-2
1796,5.982664150350234,5.189820380771861,5.759637835446526,4.783062749750474,5.738603157155654,6.127786891600665,5.680094446855433,643490.5764705882,8,E01001845,3,7,2,9,7,7,5.900016874074936,5.045100506056439,5.733787471597845,4.851445643739267,5.5559706010601735,6.000413111665032,5.574104265733198,815954.5795454546,8,2,7,2,8,5,5,1.0,0,-1,0,0,-1,-2,-2
1797,5.356329798227242,5.656906813029715,5.073988431056026,5.246992529145342,5.093028913844716,5.595749872004091,5.1607532680270225,600366.9841897233,2,E01001846,9,0,9,0,0,0,5.322457394190748,5.683104240461545,5.035680189384486,5.304023730086021,5.044592960046069,5.628860182101183,5.106274133074795,760357.9405940594,2,9,0,9,0,0,0,1.0,0,0,0,0,0,0,0
1798,5.148741690080557,5.27218378479801,5.5180008624916645,5.07474981670949,5.256815682596235,5.736413831141458,5.365976984821149,640513.8507462686,0,E01001847,5,3,8,0,1,2,5.217826475415911,5.050312677451543,5.63148136479514,5.159959968498775,5.260380731310163,5.726303805623735,5.380541433606829,811448.8857142857,1,2,5,8,2,1,1,1.0,1,-3,2,0,2,0,-1
1799,5.494588685707307,5.270200879640982,5.435772401346287,5.0278090171411005,5.33238428243449,5.740763454370096,5.352281367275077,642699.4154929577,3,E01001848,5,2,7,1,1,2,5.357772679052255,5.266097838561283,5.5154902349153065,5.0862220155501126,5.307328172918066,5.762960925443994,5.349325009987216,815019.3105802048,2,6,3,7,3,1,1,1.0,-1,1,1,0,2,0,-1
1800,5.157108776139707,5.514487128375697,5.140600832949257,5.33001740492696,5.12938645576841,5.491274774285172,5.102829024564251,635073.4275618375,0,E01001849,8,0,9,0,0,0,5.208688996599976,5.438361379521838,5.168392204321348,5.244203353774618,5.130106749971943,5.592292765541189,5.184165958822126,787985.7573964497,1,8,0,9,0,0,0,1.0,1,0,0,0,0,0,0
1801,5.410521999001503,5.286834686994553,5.731406833444323,5.002646456871714,5.393787656511579,5.898011867489133,5.375349770699229,643128.3214285715,2,E01001850,5,6,7,3,3,2,5.300482053261299,5.378210717981512,5.510049891162228,5.06845494524225,5.349637407761116,5.754551673864389,5.263433931709884,815505.7922077922,2,7,3,7,4,1,0,1.0,0,2,-3,0,1,-2,-2
1802,5.653545248265169,4.884052836165136,5.993516527876562,4.745095574125951,5.5748774056531945,6.086692501087578,5.732460065763824,141117.306122449,5,E01001851,0,9,2,7,6,8,5.628998466900417,4.909436190412158,5.955577827635265,4.846725878261385,5.47980249779565,6.040343687647865,5.727011047658467,178484.90476190476,6,1,9,2,7,6,7,1.0,1,1,0,0,0,0,-1
1803,5.872992935314985,4.801873638596334,6.145532544230072,4.771923568886771,5.617850021577217,6.130349478251498,5.916132814447645,140423.47887323942,7,E01001852,0,9,2,8,7,9,5.736273916991982,4.725961209954442,6.122538527926883,4.742843144648784,5.567918600262822,6.050202769202155,5.877454606262413,177641.24324324325,7,0,9,1,9,6,9,1.0,0,0,0,-1,1,-1,0
1804,5.973235586942253,4.773843971349425,6.286807791661408,4.519771731505959,5.693698474916361,6.452114384053117,5.955654609001289,140990.40677966102,8,E01001853,0,9,0,9,9,9,6.065604108030146,4.785008928992531,6.351635772531683,4.6062845533544365,5.695880920236761,6.300964316454801,5.816560940309004,178071.9818181818,9,0,9,0,9,9,8,1.0,1,0,0,0,0,0,-1
1805,5.807118172645569,4.810113530158997,6.047599960962931,4.7172125641504925,5.54755961894989,6.220188783009847,5.767873395284017,140466.49333333335,7,E01001854,0,9,1,6,8,8,5.782707827431815,4.849290743895939,6.049343749455043,4.679360170023782,5.578701363291059,6.102843206269401,5.736177502359663,177746.65714285715,7,0,9,0,9,7,7,1.0,0,0,0,-1,3,-1,-1
1806,5.770304467367089,4.909116038377734,6.059476375579834,4.807970278504966,5.562201893847922,6.165296326512876,5.817158576371013,142026.13043478262,6,E01001855,0,9,3,7,7,9,5.47214534216457,4.806190066867405,6.076671865251329,4.814623637331857,5.4831737942165795,6.009883056084315,5.716544795367453,179655.375,4,0,9,2,7,5,7,1.0,-2,0,0,-1,0,-2,-2
1807,5.884134463573757,4.727706898199885,6.0954426840731974,4.746016125929983,5.595533076085542,6.1637159460469295,5.756339095140758,143801.23684210525,7,E01001856,0,9,2,7,7,8,5.745860889776429,4.850656039679229,6.088061564004243,4.650546853222064,5.5439910888671875,6.086781498211534,5.735739672361915,181737.776119403,7,0,9,0,8,7,7,1.0,0,0,0,-2,1,0,-1
1808,5.222466404320763,5.05242826508694,5.714061971570625,5.000728734204026,5.292968044515516,5.719737990957792,5.43600145910607,140235.37704918033,0,E01001857,1,6,7,1,1,3,5.279425777398147,5.115224587452876,5.752100223070615,5.004274476658214,5.3943969599612345,5.743722751543119,5.541516917092459,177441.7922077922,1,3,7,5,5,1,4,1.0,1,2,1,-2,4,0,1
1809,5.663457699278568,4.973587181973965,5.778783100716611,4.793458156129147,5.470681914623747,6.05939120688337,5.653814755855723,254408.95744680852,5,E01001858,1,7,3,4,6,7,5.651293653508891,4.973329220129096,5.903912552025007,4.969611171794974,5.500891899285109,6.039262281811756,5.746833713158317,327580.902173913,6,1,9,5,7,6,8,1.0,1,0,2,2,3,0,1
1810,5.954087091528851,5.061823257501574,5.9554514297540635,4.682672448780226,5.687648576238881,6.315692155257516,5.8312337363975635,215115.0579710145,8,E01001859,2,9,1,9,9,9,5.909320645472583,5.019490937976276,5.912938692990472,4.680514025337556,5.604305393555585,6.317574970862445,5.880743503570557,274019.76470588235,8,2,9,0,9,9,9,1.0,0,0,0,-1,0,0,0
1811,5.403176269798635,4.938732360010949,5.797331275226914,4.886098479556146,5.445916170271758,5.9053912385601866,5.494396668728267,253080.69158878503,2,E01001860,0,7,5,4,3,4,5.377201209374524,4.88279136605219,5.844165570145353,4.915913141101872,5.410678811029556,6.000183639176395,5.560267414521734,325889.7247706422,2,0,8,4,5,5,4,1.0,0,0,1,-1,1,2,0
1812,5.752107034868269,5.001275964637301,5.833487695722438,4.723148353064238,5.574473249378489,6.250279341171037,5.7204637118239905,255274.67164179104,6,E01001861,1,8,1,7,8,7,5.702707522055682,5.055269355283064,5.845436303054585,4.783369427218156,5.465744106208577,6.082630409913905,5.665502614834729,328734.5294117647,7,2,8,1,7,7,6,1.0,1,1,0,0,0,-1,-1
1813,5.76730361287023,4.916402721069228,5.867221929657627,4.781701625232965,5.585135678170433,6.10009366693631,5.700715713098016,254262.32394366196,6,E01001862,0,8,2,7,6,7,5.823277574938697,4.890691523616378,5.985834543769424,4.803290871349541,5.603800155021049,6.183826285439569,5.742925547264718,327427.7837837838,8,0,9,1,9,8,7,1.0,2,0,1,-1,2,2,0
1814,5.914276871085167,4.871022629737854,6.063688036799431,4.712278901040554,5.5749917954206465,6.2773462921381,5.758880411088467,254186.875,8,E01001863,0,9,1,7,9,8,5.7881720346563,4.925874282332027,5.9635445538689105,4.761984916294322,5.542901656206916,6.156888353123384,5.805229296403772,327349.24705882353,7,1,9,1,8,8,8,1.0,-1,1,0,0,1,-1,0
1815,6.01187060991923,4.822703952789307,5.996856775283813,4.714687439600627,5.562389831542969,6.356564607620239,5.816432456970215,254191.09333333332,8,E01001864,0,9,1,7,9,9,5.887738160184912,4.855003801552025,6.095344814094338,4.853068131047326,5.523779582332921,6.290667775514963,5.846712964612085,327340.7972972973,8,0,9,2,8,9,9,1.0,0,0,0,1,1,0,0
1816,5.856345765358578,5.0142462570055395,5.824910208187272,4.699315275766153,5.551169263578094,6.257694577748796,5.546460660158005,241194.94690265486,7,E01001865,1,8,1,6,8,5,5.609182006489914,4.894449750934027,5.876903130944851,4.7692246932899005,5.448231764599285,6.164535003425801,5.633191274330679,310717.33628318587,5,0,8,1,6,8,6,1.0,-2,-1,0,0,0,0,1
1817,5.634425799051921,4.832759002402977,5.883840725156996,4.821753335882116,5.561005251495926,5.91823411517673,5.603574214158235,144777.66666666666,5,E01001866,0,8,3,6,3,6,5.601238974689567,4.823778382182992,5.921675878719692,4.89060088665816,5.5628411674151454,5.923301959559865,5.710002271798405,183111.7518248175,5,0,9,3,8,4,7,1.0,0,0,1,0,2,1,1
1818,5.525134653814377,5.048457855178464,5.648001497791659,4.906896366227057,5.464079187762353,5.890160056852525,5.602232650403054,146254.29032258064,3,E01001867,1,5,5,4,3,6,5.5455319425638985,5.057193913880517,5.7300258471685295,4.945788692025578,5.419544921201818,5.962737269261304,5.729654310380711,184774.0294117647,5,2,7,4,6,4,7,1.0,2,1,2,-1,2,1,1
1819,5.74801287651062,4.910050814492362,5.946985489981515,4.8208538464137485,5.5739672660827635,6.00579878943307,5.725523860113961,144524.11428571428,6,E01001868,0,9,3,7,5,8,5.759243078720876,4.7651329437891645,5.96095966681456,4.789603814100608,5.613728614953848,6.067734932288145,5.888679583867391,182711.58974358975,7,0,9,1,9,6,9,1.0,1,0,0,-2,2,1,1
1820,6.125426045891379,4.9347993597692374,6.045318387803578,4.575887250251511,5.746730233536286,6.154353960841691,5.796557303188609,145911.2380952381,9,E01001869,0,9,0,9,7,8,5.952085135838924,4.9136277330227385,5.999714160576845,4.628624859528664,5.686774152975816,6.170962044825921,5.764473568170499,184378.66025641025,9,1,9,0,9,8,8,1.0,0,1,0,0,0,1,0
1821,5.771427019075914,4.8293103656985545,5.9842590527101,4.8044333498586305,5.5171485367146404,5.954142537983981,5.68628770925782,144860.72727272726,6,E01001870,0,9,3,5,4,7,5.521431448652938,4.975089731731931,5.844970736632476,4.891222953796387,5.4248324046263825,5.958532382346489,5.648240958033381,183337.75675675675,4,1,8,3,6,4,6,1.0,-2,1,-1,0,1,0,-1
1822,5.907049033504266,4.872134155952013,6.086639021451656,4.683714654583198,5.647279349657206,6.2117379651619835,5.795090452982829,145346.125,8,E01001871,0,9,1,8,8,8,5.834113818123227,4.9176696232387,6.001209093275524,4.77194333417075,5.566001869383312,6.096582162947882,5.85299535592397,183802.47619047618,8,1,9,1,9,7,9,1.0,0,1,0,0,1,-1,1
1823,6.052077003379367,4.759089026878129,6.247545188932277,4.722518730519423,5.731680855822208,6.226452745608429,5.95427590697559,145981.223880597,9,E01001872,0,9,1,9,8,9,5.910197809560975,4.655760934103781,6.135264813010372,4.663535507757272,5.681154364970193,6.170554203773612,5.963601222678797,184459.20895522388,8,0,9,0,9,8,9,1.0,-1,0,0,-1,0,0,0
1824,5.583209875751944,4.871200570288827,5.88580246182049,4.787422392298193,5.575080762891209,6.011500288458431,5.608173184535083,143422.5294117647,4,E01001873,0,8,3,7,5,6,5.4705314142363415,4.833631488255092,5.873677858284542,4.8420048151697435,5.467884494577135,5.977297680718558,5.730862409727914,181410.32857142857,4,0,8,2,7,5,7,1.0,0,0,0,-1,0,0,1
1825,5.272963470965624,5.513083194196224,5.197304547950625,5.178808920457959,5.174360105395317,5.566031973436475,5.191478268429637,144437.74375,1,E01001874,8,0,9,0,0,0,5.313104323907332,5.4351060409050485,5.319865547836601,5.1556143420083185,5.175466619528733,5.67228519204375,5.368041967726373,184155.187012987,2,8,0,8,0,0,1,1.0,1,0,0,-1,0,0,1
1826,5.485906000586524,5.244814092698305,5.571249128251836,4.954527384129124,5.329831875752712,5.9869895922964895,5.550582865873973,253689.76811594202,3,E01001875,4,4,6,1,4,5,5.583896876165741,5.092827421269919,5.670587254982245,4.854161696214425,5.4122600422093745,6.120932847261429,5.706089765617722,326792.8881578947,5,3,6,2,5,7,7,1.0,2,-1,2,-4,4,3,2
1827,5.501723679433386,5.356570516724184,5.474542364298579,5.081948094339256,5.358130511031093,5.834841899124973,5.451623799571072,249698.2891566265,3,E01001876,6,2,8,2,2,3,5.453656473110631,5.2555070242930935,5.481241376744103,5.100344314403141,5.270694467824759,5.755962379814423,5.408907680167365,321364.92783505155,3,5,2,7,2,1,2,1.0,0,-1,0,-1,0,-1,-1
1828,4.931956444693878,5.43923032178288,5.206757185733424,5.3413941032063645,5.1412330338385255,5.503788950168981,5.068426495632239,247881.07522123895,0,E01001877,7,0,9,0,0,0,4.9559102129053185,5.471638925428744,5.150310375513854,5.406534647941589,5.049464101261563,5.474212182009661,5.125054700727816,319438.5,0,9,0,9,0,0,0,1.0,0,2,0,0,0,0,0
1829,5.799816529388013,5.225510034872138,5.720679997102074,4.784459303254667,5.514457920323247,6.142292092675748,5.6251049378643865,253059.80434782608,7,E01001878,4,6,3,5,7,6,5.760253099294809,5.059236166241405,5.753591534855602,4.864698072056194,5.5626103694622335,6.2246812621315755,5.790492345998575,325946.25274725276,7,2,7,2,8,9,8,1.0,0,-2,1,-1,3,2,2
1830,5.405538698037465,5.016713048730578,5.815152622404552,4.9934070862474895,5.360084854421162,5.9761441718964345,5.431939336515608,82215.84523809524,2,E01001879,1,7,6,2,4,3,5.370514824682353,4.99239288300884,5.676405682855723,5.044928789138794,5.301537934614688,5.818418215732185,5.429993701224425,105366.94897959183,2,1,6,6,3,2,2,1.0,0,0,-1,0,1,-2,-1
1831,5.329071328557771,5.005673544160251,5.7162873333898085,4.9716938281881395,5.405629170352015,5.777664011922376,5.404776392311885,82283.4827586207,1,E01001880,1,6,6,3,1,2,5.506989432232721,4.951986372470856,5.741054215601513,4.831685760191509,5.4051394164562225,5.9074665520872385,5.538927384785244,105406.42857142857,4,1,7,2,5,3,4,1.0,3,0,1,-4,2,2,2
1832,5.583031396253394,4.8220023233956155,5.870630758617996,4.862023525281784,5.460666188406288,5.987747836550441,5.529597133671472,82155.71559633028,4,E01001881,0,8,4,4,4,5,5.561087295283442,4.757781349057737,5.982726949194204,4.790265751921612,5.473480071192203,5.962726294476053,5.563695190263831,105256.72173913043,5,0,9,1,7,4,4,1.0,1,0,1,-3,3,0,-1
1833,5.751986612756569,4.884403475795883,6.056965121303696,4.845347772161644,5.47606787336878,6.203114541180162,5.72454952188285,82449.14457831325,6,E01001882,0,9,4,4,8,8,5.780048881636725,4.815183956093258,5.989400177531772,4.851310063732995,5.478505049811469,6.214296831025018,5.835222481356727,105614.62222222223,7,0,9,2,7,8,8,1.0,1,0,0,-2,3,0,0
1834,5.476223875429029,4.837205159329923,5.860792754966522,4.919980986096035,5.438678948678703,5.867714910863716,5.574189225089884,81867.46728971963,3,E01001883,0,8,5,4,2,5,5.4351825298519305,4.9691368767974575,5.89098016493911,4.952726791758056,5.353990944153672,5.908241947856518,5.603560983587842,104929.77981651376,3,1,8,4,4,3,5,1.0,0,1,0,-1,0,1,0
1835,5.459429689307711,4.788556328460352,5.981435032033208,4.889336358255415,5.421366759200595,5.924635880029023,5.606416841051471,81808.73134328358,3,E01001884,0,9,5,3,3,6,5.3590491828711135,4.914796603762585,5.74632428780846,5.01182737816935,5.3694659056870835,5.813529105290122,5.501512282568475,104857.46739130435,2,1,7,6,4,2,3,1.0,-1,1,-2,1,1,-1,-3
1836,5.17126316343035,5.299171440941947,5.540073878424508,5.066223151343209,5.291215535572597,5.657748607226781,5.21254655293056,81882.31428571428,0,E01001885,5,3,8,1,0,0,5.219398801976984,5.225255146171108,5.4877167181535205,5.205871112418897,5.153645423325625,5.6007139682769775,5.253316705877131,104962.72727272728,1,5,2,9,0,0,0,1.0,1,0,-1,1,-1,0,0
1837,5.4523940715161,5.2088849033628195,5.731949984372317,4.917843115198743,5.465923448185344,5.920397779443761,5.358134092865409,83407.0989010989,3,E01001886,4,6,5,4,3,2,5.466844655046559,5.0556636795853125,5.719985954689257,4.940511991279294,5.444378479562625,5.880551339399935,5.3965952853963834,106864.79797979798,4,2,7,4,6,3,2,1.0,1,-2,1,-1,2,0,0
1838,5.577881464059802,5.149049955865611,5.677698232125545,4.896380465963612,5.473046980042389,5.93782531351283,5.434468863666922,83601.8115942029,4,E01001887,3,6,5,4,3,3,5.503596843235076,5.111040997126746,5.613231424301389,4.836062798424373,5.485537941493686,5.87819843065171,5.563065841084435,107097.25396825396,4,3,5,2,7,3,4,1.0,0,0,-1,-3,3,0,1
1839,6.016309533800397,4.774861514568329,6.071722663178736,4.523709394493881,5.612522563155816,6.351371473195601,5.863810140259412,83883.27551020408,8,E01001888,0,9,0,8,9,9,5.981442018917629,4.656435334114802,6.115624645778111,4.607690773691449,5.587608223869687,6.387104824611119,5.798708740870158,107486.24761904762,9,0,9,0,9,9,8,1.0,1,0,0,0,1,0,-1
1840,5.621025763836103,5.078993231979842,5.859048639376139,4.84457844311429,5.467094721253385,6.078826491365728,5.540223861478038,126978.8350515464,5,E01001889,2,8,4,4,6,5,5.727293739415178,5.07351254814803,5.863803145861385,4.772448784173137,5.383173392276571,6.067714826025144,5.650586388327858,160614.8383838384,7,2,8,1,5,6,6,1.0,2,0,0,-3,1,0,1
1841,5.57580780213879,4.978195007129382,5.877593673685546,4.898496529107453,5.453054434509688,5.995199970019761,5.486583252106944,94055.01075268818,4,E01001890,1,8,5,4,4,4,5.655409423289476,4.906606074836519,5.872890108161503,4.796566137561092,5.521902362505595,6.077689837526392,5.553724900439933,120320.67592592593,6,1,8,1,8,7,4,1.0,2,0,0,-4,4,3,0
1842,5.770681016095034,4.916534219588433,5.9501716398692635,4.700434044524506,5.50553487981116,6.1064557012144505,5.67799891041709,89063.56643356643,6,E01001891,0,9,1,5,6,7,5.716218843283476,4.787871704278169,5.957414279160676,4.680742662924307,5.351461159741437,6.126310532181352,5.715701112040767,114858.98518518519,7,0,9,0,4,7,7,1.0,1,0,0,-1,-1,1,0
1843,5.465835838406174,5.089337596186885,5.864671071370442,4.888070960839589,5.505145329016226,5.96641398800744,5.560842984252506,90091.68518518518,3,E01001892,2,8,5,5,4,5,5.637575379124394,4.963096472952101,5.942921704716152,4.782830119132996,5.546101777641861,6.120589764029892,5.713947753111522,115125.0925925926,6,1,9,1,8,7,7,1.0,3,-1,1,-4,3,3,2
1844,5.326426553420531,5.280732066203386,5.479968382762029,5.094095723751264,5.29537577353991,5.749004345673781,5.38864202835621,145756.92307692306,1,E01001893,5,2,8,1,1,2,5.514891090458387,4.993240524644721,5.662292072217759,5.025117738606179,5.439170987638708,5.881409455652106,5.543885862990601,180912.7808219178,4,1,6,6,6,3,4,1.0,3,-4,4,-2,5,2,2
1845,5.436017070606256,5.171596252994173,5.623873207979141,4.930769940850082,5.331322780839956,5.808050090340292,5.462292630201692,208368.38853503185,2,E01001894,3,5,5,1,2,3,5.473146650361719,5.092713150178423,5.588189122099314,5.029380364447647,5.369375418432011,5.754889011383057,5.4158257705084285,267260.0062111801,4,3,4,6,4,1,2,1.0,2,0,-1,1,3,-1,-1
1846,5.6185696873553965,4.938196887803632,5.952628867570744,4.710970849491829,5.560205138006876,6.083270813143531,5.665338444155316,232470.67441860464,5,E01001895,0,9,1,6,6,7,5.493051476530976,4.937778672019204,5.927575192608676,4.876517129468394,5.452263329055283,6.131188248540019,5.67060951086191,295405.0,4,1,9,3,6,8,6,1.0,-1,1,0,2,0,2,-1
1847,5.54656423221935,5.034390186334585,5.754951802167025,4.825717610198182,5.419993094035557,5.851401502435857,5.513403330530439,142316.2857142857,4,E01001896,1,7,3,3,2,4,5.478297169818434,5.013175091078115,5.7669823738031605,4.925650582757107,5.4226901850035025,5.871872957362685,5.437449178030325,179820.76744186046,4,2,7,4,6,3,2,1.0,0,1,0,1,3,1,-2
1848,5.983805087350664,4.890550657397225,6.040018163976216,4.579909768842516,5.564658147948129,6.264132885705857,5.692012686105001,175584.97619047618,8,E01001897,0,9,0,7,8,7,5.833247537796314,4.920718068113694,6.007314691176782,4.721601181305372,5.5814730525016785,6.180328839100325,5.744259958083813,217487.75,8,1,9,0,9,8,8,1.0,0,1,0,0,2,0,1
1849,5.429500610064092,4.896486562404906,5.923020045723071,4.916316205234619,5.492071485975712,5.894905242052945,5.5941227560408375,146021.25837320575,2,E01001898,0,8,5,5,3,6,5.424330983918144,4.860782703639127,5.884339077357153,5.0053704772226615,5.428890739768613,5.9115412161738865,5.688131985160223,184545.44052863435,3,0,8,5,6,3,7,1.0,1,0,0,0,1,0,1
1850,5.365489899522007,5.090870860779639,5.75325879956236,5.018586803190779,5.445729656974868,5.719966092912277,5.341962276118816,175631.8811881188,2,E01001899,2,7,7,4,1,2,5.323432755247455,5.1618110153162595,5.590232943820062,5.042280096874059,5.405730063670149,5.681001816954568,5.301175221104488,222781.94392523365,2,4,4,6,5,0,0,1.0,0,2,-3,-1,1,-1,-2
1851,5.353644695546892,5.135660711735014,5.623868678297315,5.075782089952439,5.305289135092781,5.881073550572471,5.481064362185342,146558.6984126984,2,E01001900,3,5,8,1,3,4,5.190402655965752,5.091038660870658,5.617754508223799,5.182338071366151,5.198801466160351,5.828002259963089,5.491109417544471,185218.375,1,3,5,8,1,2,3,1.0,-1,0,0,0,0,-1,-1
1852,5.673592000864865,4.961972949210177,5.836196063609606,4.790716737843631,5.510828393228938,6.117274723695905,5.669307518541143,84210.62921348315,5,E01001901,1,8,3,5,7,7,5.691615447402,4.897704362869263,5.841099988330495,4.750850793990222,5.474062643267891,6.052710755304857,5.775722449476069,107742.55681818182,6,0,8,1,7,6,8,1.0,1,-1,0,-2,2,-1,1
1853,5.600644847398163,4.9581869699621715,5.939725729726976,4.846247776862113,5.536163886388143,6.060786452344669,5.528713536518876,83755.6129032258,4,E01001902,1,9,4,6,6,5,5.544090094773666,4.820357370635738,5.992490571478139,4.815006451762241,5.472876657610354,6.043417604073234,5.633667246155117,107315.26086956522,5,0,9,2,7,6,6,1.0,1,-1,0,-2,1,0,1
1854,5.324228644371033,5.117427598027622,5.632229122461057,4.962160026325899,5.348791750038371,5.8945341928332455,5.354928389483807,83018.12745098039,1,E01001903,2,5,6,2,3,2,5.358342617460825,5.061033721109038,5.659178295181793,5.005496872281565,5.332120253044424,5.857730797193582,5.471291970280768,106340.4854368932,2,2,6,5,3,2,3,1.0,1,0,1,-1,1,-1,1
1855,5.821536267157828,4.855831931133081,5.95644723306788,4.722523287971421,5.5272029815333905,6.29209832389756,5.73669965904538,84207.72277227722,7,E01001904,0,9,1,6,9,8,5.845082360155442,4.746846764695411,6.008319062345168,4.757616611088023,5.48739080803067,6.307484900250154,5.809456452435138,107835.67647058824,8,0,9,1,7,9,8,1.0,1,0,0,0,1,0,0
1856,5.924663849366017,4.7926228657746925,6.048668677990253,4.696913569401472,5.428266630722926,6.4591481166008196,5.88089019824297,85786.1282051282,8,E01001905,0,9,1,3,9,9,5.806942267295642,4.679936387600043,6.089959862904671,4.610503160036528,5.41465053650049,6.39445913143647,5.8968082177333345,109734.67948717948,8,0,9,0,5,9,9,1.0,0,0,0,-1,2,0,0
1857,5.56892518786823,4.864294963724473,5.855717585367315,4.814054448814953,5.46017050743103,6.071486020789427,5.4930052003439735,86192.98529411765,4,E01001906,0,8,3,4,6,4,5.625401535400978,4.861154649807856,5.913012625620915,4.839981924570524,5.427914696473342,6.116045592381404,5.55944924721351,110218.8,6,0,9,2,6,7,4,1.0,2,0,1,-1,2,1,0
1858,6.038289854020784,4.816981382442243,6.191089344747139,4.5658975261630435,5.619173284732934,6.443315386772156,5.801081343130632,86480.9696969697,9,E01001907,0,9,0,8,9,8,5.927249075816228,4.729763625218318,6.262268924713135,4.553439468603868,5.612944287520189,6.446258203799908,5.965634547747099,110505.12307692308,9,0,9,0,9,9,9,1.0,0,0,0,0,1,0,1
1859,5.906751787851727,4.692999907902309,6.248889540869092,4.8006526458831065,5.764249635121179,6.09010895093282,5.9197404100781394,145256.52380952382,8,E01001908,0,9,3,9,6,9,5.925483124596732,4.5045240027563915,6.241819943700518,4.720781293937138,5.733748412132263,6.176536634990147,5.909600750037602,183593.48571428572,9,0,9,0,9,8,9,1.0,1,0,0,-3,0,2,0
1860,5.593982662122274,4.973307669777231,5.757883477456791,4.8028607823185085,5.5500813489107745,6.082265730985661,5.577323251163836,92101.94845360825,4,E01001909,1,7,3,6,6,5,5.678103521812794,4.931389624296233,5.899092133655104,4.757109467373338,5.55123304489047,6.039326129957687,5.682065901368163,115627.97674418605,6,1,9,1,8,6,7,1.0,2,0,2,-2,2,0,2
1861,5.65778295810406,5.010766895000751,5.995205079592191,4.907940827883207,5.482812437644371,5.991068289830134,5.591834680850689,140039.46153846153,5,E01001910,1,9,5,5,4,6,5.7306515271847065,4.756273489732009,5.967937449308542,4.797600797506479,5.5537069100600025,5.989133526728703,5.791734728446373,177198.84615384616,7,0,9,1,8,5,8,1.0,2,-1,0,-4,3,1,2
1862,5.2857105065200285,5.234983498767271,5.53380802122213,5.0319449356046775,5.344871278536522,5.794906996064267,5.353472978381787,131306.30508474575,1,E01001911,4,3,7,2,1,2,5.3603451909690065,5.018152968636874,5.624333624182077,5.015255073021198,5.428308096425287,5.855332871963238,5.4617824040610214,165979.72413793104,2,2,5,6,6,2,3,1.0,1,-2,2,-1,4,1,1
1863,5.1097972995227146,5.2177682525103855,5.539709531154829,5.1430397402379935,5.256612189037284,5.644085707123747,5.2497145687181925,101341.28865979382,0,E01001912,4,3,9,0,0,1,5.207510015699598,5.267153082953559,5.571490282482571,5.107798239919874,5.261451227135129,5.752736812167697,5.3864821712176,130993.65555555555,1,6,4,7,2,1,1,1.0,1,2,1,-2,2,1,0
1864,5.9447588882749045,4.834154683446127,6.0189398319002185,4.772103599139622,5.647524905583215,6.020426424722823,5.704270546398465,91003.30158730158,8,E01001913,0,9,2,8,5,7,5.952925173441569,4.831343595186869,5.843656714757284,4.732828905185063,5.590899479389191,6.054856665929159,5.8687572797139484,116807.0,9,0,8,0,9,6,9,1.0,1,0,-1,-2,1,1,2
1865,5.53715087531449,4.765459419844986,5.884170111123618,4.875489011987463,5.518720338870953,5.897747262731775,5.74972470549794,144986.01298701297,4,E01001914,0,8,4,6,3,8,5.729045234314383,4.679085644957137,6.111527710744779,4.730209505721314,5.4967554072811176,6.038460329787372,5.8605325058714985,183266.60273972602,7,0,9,0,7,6,9,1.0,3,0,1,-4,1,3,1
1866,5.926453096311797,4.9386248671033846,5.909235697872234,4.710582858361538,5.603581930856285,6.144863746451132,5.697843618362954,86818.03144654087,8,E01001915,0,8,1,7,7,7,5.901128981843849,4.832725755052071,6.002683722214892,4.698444657243056,5.575772050488202,6.154709606501409,5.755344629976791,110920.0289017341,8,0,9,0,9,8,8,1.0,0,0,1,-1,2,1,1
1867,6.098351220289866,4.908845961093903,5.945107338825862,4.561942269404729,5.702699766556422,6.39335281252861,5.887927181522051,87718.825,9,E01001916,0,9,0,9,9,9,6.101423125009279,4.868632122203037,5.967570311314351,4.616445305111172,5.691833551939543,6.244471743300155,5.918378095369081,111970.18018018018,9,0,9,0,9,9,9,1.0,0,0,0,0,0,0,0
1868,5.856632984736386,4.97191038201837,6.0080240754520196,4.646349037394804,5.557755484300501,6.173080742359161,5.685577664305182,85160.79411764706,7,E01001917,1,9,0,6,7,7,5.778980141100676,4.825462970180788,5.984620695528776,4.746774963710619,5.556269434915072,6.286113310551298,5.695017241049504,109040.34782608696,7,0,9,1,8,9,7,1.0,0,-1,0,1,2,2,0
1869,6.041074106062966,4.87121338131784,5.969150189695688,4.581150357750641,5.5416458242241,6.33598073597612,5.840435833766542,84925.08045977012,9,E01001918,0,9,0,6,9,9,5.939829901803898,4.857378820829753,5.957275879533985,4.662099901633926,5.612515700014332,6.281350603586511,5.860374133798141,108742.69620253165,9,0,9,0,9,9,9,1.0,0,0,0,0,3,0,0
1870,6.138141514051078,4.870400132519184,6.121795718032534,4.571389740056331,5.677146330918416,6.5340896006858,5.898329820963416,85903.57425742575,9,E01001919,0,9,0,9,9,9,6.029320896181286,4.80872786248851,6.013648609829764,4.625313215785557,5.574874038370247,6.408847476682093,5.854224775591467,109766.66666666667,9,0,9,0,9,9,9,1.0,0,0,0,0,0,0,0
1871,5.084829110183463,5.186314635718895,5.537222105146244,5.138090763660456,5.225369793689803,5.635421201882773,5.2422881805344135,83174.54304635762,0,E01001920,3,3,9,0,0,1,5.397702281845027,4.8677668263172285,5.8142802591981555,4.9096675299364945,5.402670576654631,5.886116327910588,5.639528271453134,106760.52586206897,3,0,8,3,5,3,6,1.0,3,-3,5,-6,5,3,5
1872,5.43457892537117,4.976610886014027,5.86592519024144,4.879715217196423,5.487692699484203,5.939637839794159,5.546826918487963,83531.22826086957,2,E01001921,1,8,4,5,4,5,5.34099035117091,4.928411393749471,5.827055201238515,4.891142649309976,5.435720553203505,5.862442595618112,5.672633898501494,106960.91836734694,2,1,8,3,6,2,6,1.0,0,0,0,-1,1,-2,1
1873,5.8736138248736145,5.004550331209335,5.986016936097409,4.68118155148863,5.557200161225957,6.2354007557125914,5.76251239206162,86326.20858895706,7,E01001922,1,9,1,6,8,8,5.857730463326695,4.930089788264539,6.000508951853557,4.672951475683465,5.485484987856394,6.110202356993434,5.7400973151965315,110320.18072289157,8,1,9,0,7,7,7,1.0,1,0,0,-1,1,-1,-1
1874,5.624072396755219,4.986036708138206,5.736390274221247,4.78850228136236,5.471080349792134,5.997610759735108,5.636249532482841,85518.66363636364,5,E01001923,1,6,3,4,5,6,5.644705270898753,4.959150480812993,5.80424663938325,4.82064708142445,5.431406921353833,6.03064960446851,5.662703244850554,109212.77586206897,6,1,8,2,6,6,6,1.0,1,0,2,-1,2,1,0
1875,6.22713595212892,4.65977911755096,6.2927603278049205,4.434012880158979,5.744341578594474,6.489256759022558,6.064908137155133,86695.38372093023,9,E01001924,0,9,0,9,9,9,6.127769613265992,4.742784296765047,6.233289654114667,4.448200610104729,5.653534325431375,6.402562034831328,6.137328526552985,110791.07058823529,9,0,9,0,9,9,9,1.0,0,0,0,0,0,0,0
1876,6.013631446192963,4.800582304145351,6.073285155826145,4.541367659665117,5.6752334700690374,6.351869544597587,5.943457007408142,87161.32323232324,8,E01001925,0,9,0,9,9,9,5.946772168844174,4.7048546065632095,6.047454124841934,4.6025178941906,5.61513871820564,6.248148202896118,5.896633233779516,111274.4188034188,9,0,9,0,9,9,9,1.0,1,0,0,0,0,0,0
1877,5.755377175552504,4.8135960549116135,6.061920436365264,4.8079798328025,5.499261826276779,6.200186663440296,5.872906727450235,87557.48214285714,6,E01001926,0,9,3,5,8,9,5.692147285739581,4.814136521021525,6.030652576684952,4.716241434216499,5.489802478750547,6.181436065832774,5.844224708278974,111819.5,6,0,9,0,7,8,9,1.0,0,0,0,-3,2,0,0
1878,6.338161701546576,4.902402837473647,6.137457833254247,4.5176107713154385,5.7728209782363775,6.548155608930085,6.055748708266065,183863.44360902256,9,E01001927,0,9,0,9,9,9,6.113219998952911,4.9151262805217835,6.034844743923878,4.685542299991518,5.666994199978085,6.480172029630405,5.98056266814705,233029.3937007874,9,1,9,0,9,9,9,1.0,0,1,0,0,0,0,0
1879,5.763410319716243,5.02373653549259,5.909780599303165,4.795278155197532,5.507859307830617,6.072142942477081,5.7011991840297895,255322.50847457626,6,E01001928,1,8,3,5,6,7,5.663677606851824,5.0004337987592145,5.8123675200247,4.861302997796766,5.458360594126486,6.005141283235242,5.656717270612717,328791.79032258067,6,1,8,2,7,5,6,1.0,0,0,0,-1,2,-1,-1
1880,5.528996231532333,4.99157190794992,5.795259518198447,4.802411458279827,5.46463144179618,6.028946274577981,5.4586864273146825,255743.62376237623,3,E01001929,1,7,3,4,5,3,5.416447907163386,4.91017609834671,5.7934438847658924,4.816181726622999,5.357453175804071,5.991466725081728,5.528338651908071,329347.91228070174,3,1,8,2,4,5,4,1.0,0,0,1,-1,0,0,1
1881,5.824671253339568,5.088867020251146,5.8273669214391,4.731386455137338,5.526756596209398,6.116925004702895,5.7133282663217235,220689.35074626867,7,E01001930,2,8,2,6,7,7,5.8089296061417155,5.107849894720933,5.770939299155926,4.771592986994777,5.525336866543211,6.141956079417262,5.743029353536408,284729.7310344828,8,3,7,1,8,8,7,1.0,1,1,-1,-1,2,1,0
1882,5.998824369711954,5.107586041825717,5.974274127209773,4.596721410751343,5.694811250342697,6.2035286895564345,5.994559569436996,215017.80327868852,8,E01001931,2,9,0,9,8,9,5.957867476675245,4.937877645095189,5.917200598451826,4.712286131249534,5.595597101582421,6.130242003334893,5.811727772156398,277786.25,9,1,9,0,9,7,8,1.0,1,-1,0,0,0,-1,-1
1883,5.534557610750198,5.1236435365345745,5.768024792273839,4.871975403692987,5.414819732308388,5.941809998618232,5.457521295381917,254825.17361111112,4,E01001932,2,7,4,3,4,3,5.465211941455973,5.080508453270484,5.798232879309818,4.96804449558258,5.415132603974178,5.902248449983268,5.530229890757593,329691.6206896552,4,2,8,5,5,3,4,1.0,0,0,1,1,2,-1,1
1884,5.622093470936472,5.092479279772802,5.733765321699056,4.832924069328741,5.421992933885618,6.028426912697879,5.622693951157006,215215.03977272726,5,E01001933,2,6,4,3,5,6,5.573522291400216,5.070215672254562,5.728410676121712,4.879567801275036,5.465602691877972,6.0204597169702705,5.609163265336644,276615.7840909091,5,2,7,3,7,6,5,1.0,0,0,1,-1,4,1,-1
1885,5.638699891803029,5.254590918729593,5.55849101124229,4.947335384704254,5.526989854299105,5.91809096965161,5.499154369909685,89066.53846153847,5,E01001934,4,4,6,6,3,4,5.632674416670432,5.108323505291572,5.610179230570793,4.91873782987778,5.508807343932299,5.926472090757811,5.535291118117479,113490.92307692308,6,3,5,4,8,4,4,1.0,1,-1,1,-2,2,1,0
1886,5.6939674511933935,4.832617156933516,5.914355414952987,4.789484922702496,5.398648112859481,6.2368455128792,5.696812887680836,87303.33846153846,5,E01001935,0,8,3,3,8,7,5.6670550844642555,4.875623693626918,5.908090888784173,4.768267252472009,5.330630349309257,6.260693992121836,5.696281087532472,111521.12359550562,6,0,9,1,3,9,7,1.0,1,0,1,-2,0,1,0
1887,5.845376734185008,4.802582125748153,6.054634427602312,4.583036155827277,5.5538450764343805,6.344176554046901,5.81144420024568,87699.5575221239,7,E01001937,0,9,0,6,9,8,5.803492037455241,4.770096052686373,5.999446219205856,4.724774422248204,5.472514679034551,6.23209985891978,5.780781936645508,111912.95,8,0,9,0,7,9,8,1.0,1,0,0,0,1,0,0
1888,5.152088722096214,5.116403578202935,5.654462865636319,4.948722539068777,5.302038788795471,5.823690574380416,5.443761163120028,88796.79746835443,0,E01001938,2,5,6,1,2,3,5.260878252677428,5.007001884472676,5.668761403132708,4.9866448396291485,5.259202908246945,5.843464829982856,5.492206258651538,113448.66666666667,1,2,6,5,2,2,3,1.0,1,0,1,-1,1,0,0
1889,5.30984444548102,5.15941153273863,5.556777450617622,5.061446722114788,5.364064222223618,5.8626069272265715,5.4243737375035,85825.75294117647,1,E01001939,3,4,8,2,2,3,5.334786641209022,5.082941002819849,5.651771444341411,5.041505275861077,5.354104708718217,5.890367518300596,5.503355006160944,108937.74456521739,2,2,5,6,4,3,3,1.0,1,-1,1,-2,2,1,0
1890,5.558386163711548,5.065508289337158,5.731427593231201,4.886862020492554,5.398990262349447,5.998157742818196,5.576559456189473,210228.58666666667,4,E01001940,2,6,5,3,5,5,5.475093597589537,4.995421886444092,5.892153631809146,4.896762852058854,5.398155412008596,6.0064829504767125,5.696220428444619,275177.0465116279,4,1,8,3,5,5,7,1.0,0,-1,2,-2,2,0,2
1891,5.557427193528863,4.68274381340191,6.011097578592198,4.891440941441443,5.439778261287238,6.060438650910572,5.578571911781065,141431.49462365592,4,E01001941,0,9,5,4,6,5,5.461534355046614,4.776901748945129,6.1298675784524885,4.8437015976545945,5.412312938357299,6.051053892891362,5.651176660690668,180215.3396226415,4,0,9,2,5,6,6,1.0,0,0,0,-3,1,0,1
1892,5.69881153475378,4.892163394652691,6.116585945345692,4.800696054684747,5.530190054903326,6.201910203265161,5.705603539329214,249360.6494845361,5,E01001942,0,9,3,6,8,7,5.655004282978093,4.84292070442271,6.132751166263473,4.7571162776412255,5.487186471992564,6.115940764685657,5.7731096499434145,324396.81308411213,6,0,9,1,7,7,8,1.0,1,0,0,-2,1,-1,1
1893,5.245378393204614,5.185336826269519,5.564066470405201,5.122158371371987,5.2303223531432605,5.740528335296568,5.3463958987483275,139883.54320987655,1,E01001943,3,4,8,0,1,2,5.208048054924259,5.238675729407893,5.542791667309674,5.2125007463740065,5.199907997985939,5.72928197701256,5.388131902589427,176924.74675324676,1,5,3,9,1,1,1,1.0,0,2,-1,1,1,0,-1
1894,5.3306962744943025,5.300960279744247,5.38326882493907,5.244436083168819,5.209542445067702,5.580131736294977,5.308495780517315,139651.7068965517,1,E01001944,5,1,9,0,0,1,5.289540412578177,5.28587835266235,5.526653571331755,5.0821962242430825,5.283931899578013,5.799953634434558,5.433991581835645,176679.40425531915,1,6,3,7,2,1,2,1.0,0,1,2,-2,2,1,1
1895,5.853097244312889,4.91470362951881,5.991255763329957,4.649047944106553,5.531686967925022,6.301704127537577,5.740970136303651,226783.06578947368,7,E01001945,0,9,0,6,9,8,5.864211258135344,4.801417661340613,6.017037270884765,4.6419956213549565,5.5234210648034745,6.263428512372468,5.816624399862792,291323.7763157895,8,0,9,0,8,9,8,1.0,1,0,0,0,2,0,0
1896,5.847478747367859,5.003060439770872,5.923332859169353,4.759711825034835,5.578330906954679,6.178316980600357,5.664386233145541,161639.32954545456,7,E01001946,1,8,2,7,7,7,5.697755551829781,4.966914357598295,5.892196366467426,4.780607153459923,5.5232555866241455,6.032633723671903,5.67522962068774,205968.34020618556,6,1,8,1,8,6,6,1.0,-1,0,0,-1,1,-1,-1
1897,5.463809048587626,5.0210105153647335,5.713457817381078,4.905048933896151,5.406488621776754,5.8726419752294365,5.565654635429382,85476.90909090909,3,E01001947,1,6,5,3,2,5,5.5278080069288915,5.074131209023145,5.72296218969384,4.869428812241067,5.37100119006877,5.9591920375823975,5.640531788066942,109366.87755102041,4,2,7,3,4,4,6,1.0,1,1,1,-2,1,2,1
1898,5.566472327709198,4.8362668762604395,6.050817249218623,4.75894104540348,5.441824555397034,6.089776666959127,5.699001017212868,86207.925,4,E01001948,0,9,2,4,6,7,5.5819296598434445,4.745927473902702,6.036820502082507,4.77331767976284,5.522292851408323,6.007444780071577,5.732784082492192,110204.69166666667,5,0,9,1,8,5,7,1.0,1,0,0,-1,4,-1,0
1899,5.785105102517631,4.739217574676771,6.0923725674661355,4.708515623982033,5.58394602175509,6.140930205248715,5.808327587802759,86123.96629213484,6,E01001949,0,9,1,7,7,8,5.781614810587412,4.798088109636882,6.1540443150393935,4.715742600969522,5.620015104132962,6.1616506116936005,5.9070023772228195,110112.38554216867,7,0,9,0,9,8,9,1.0,1,0,0,-1,2,1,1
1900,5.6557081372050915,4.932438424078085,6.032577561119855,4.798391575530424,5.4731647523783025,6.163333991826591,5.677898684800682,85712.68644067796,5,E01001950,0,9,3,4,7,7,5.69263995885849,4.782680768767992,6.110580408573151,4.805336518088977,5.495859720309576,6.176108415921529,5.738235352436702,109562.81666666667,6,0,9,1,7,8,7,1.0,1,0,0,-2,3,1,0
1901,5.847512066931952,4.714075607345218,6.092656115123204,4.69641311055138,5.593856014524188,6.205981070654733,5.778089141845703,86653.05714285714,7,E01001951,0,9,1,7,8,8,5.7298562952450345,4.795369525040899,6.029787199837821,4.793538551245417,5.50561065439667,6.083779256258692,5.860216145004545,110733.4375,7,0,9,1,8,7,9,1.0,0,0,0,0,1,-1,1
1902,5.3392208399397605,4.944889223977421,5.7921201513054665,4.985226770465293,5.415060498741235,5.775652845254105,5.481466281280089,87065.03370786516,1,E01001952,1,7,6,3,1,4,5.431151967875811,4.897465665729678,5.843669329370771,4.908550432750157,5.382185152598789,5.87906551361084,5.566251594193128,111164.33673469388,3,0,8,3,5,3,4,1.0,2,-1,1,-3,2,2,0
1903,5.42582358947167,4.806120072878324,5.981573302929218,4.8088553942166845,5.431100782981286,5.920418530244094,5.636799320807824,83129.38461538461,2,E01001953,0,9,3,3,3,6,5.428747141197936,4.864849095475184,5.860202799104664,4.884608035218226,5.4444349726585495,5.912851598164806,5.640593318090047,106332.52054794521,3,0,8,3,6,3,6,1.0,1,0,-1,0,3,0,0
1904,6.042297622825526,4.636755715442609,6.1111579394038715,4.755865714218043,5.543377136882348,6.492230195033399,5.82097405421583,254043.98734177215,9,E01001954,0,9,2,6,9,9,5.99481290390617,4.761864894314816,6.163913809625726,4.648936812501205,5.568609014310335,6.503117877558658,6.0023498723381445,327189.4210526316,9,0,9,0,9,9,9,1.0,0,0,0,-2,3,0,0
1905,5.732403643131256,5.271369262536367,5.600913503964742,4.847426104545593,5.529711610476176,6.022736293474833,5.539586560726166,253593.13333333333,6,E01001955,5,4,4,6,5,5,5.71285660168123,5.153530321177646,5.676285357870293,4.885813864730519,5.524119416637533,6.066307642050749,5.6116601151122145,326634.75147928996,7,4,6,3,8,6,5,1.0,1,-1,2,-1,2,1,0
1906,5.931696185198697,4.918151918324557,5.787462108785456,4.696209748224779,5.579605309529738,6.245333309607072,5.845860290527344,254623.5,8,E01001956,0,7,1,7,8,9,5.939473233970941,4.793706871715247,5.912293840857113,4.765160905379875,5.577932229229048,6.367150194504681,5.8793854514757795,327899.60784313723,9,0,9,1,9,9,9,1.0,1,0,2,0,2,1,0
1907,5.692909846434722,5.152312794247189,5.721092968373685,4.822084104692614,5.555401479875719,6.031826280258797,5.605238088079401,205588.82432432432,5,E01001957,3,6,3,6,5,6,5.730624219349452,5.131878479889461,5.567501129422869,4.787346478870937,5.584685914857047,5.949465128353664,5.582598837784358,264111.0142857143,7,3,4,1,9,4,5,1.0,2,0,-2,-2,3,-1,-1
1908,5.609204059423402,5.112938869831174,5.721937950267348,4.973909569341083,5.453037245329036,5.953758566878562,5.455255591592123,248026.97674418605,4,E01001958,2,6,6,4,4,3,5.612127936803377,5.07308554649353,5.727202016573686,4.836613407501807,5.472748875617981,6.0426724553108215,5.510726662782522,323460.8846153846,5,2,7,2,7,6,3,1.0,1,0,1,-4,3,2,0
1909,5.784569355401587,5.280085866755628,5.531335215619269,4.782639499674452,5.551649168450782,6.210205596812228,5.729329073682744,254368.47872340426,6,E01001959,5,3,2,6,8,8,5.778662088003801,5.200521224520985,5.641045829792715,4.860525302318711,5.495835972573473,6.180041268699528,5.695108741676251,327616.9481865285,7,4,5,2,7,8,7,1.0,1,-1,2,0,1,0,-1
1910,6.026795860320803,4.784249222467816,6.118530405892266,4.67071274916331,5.611294307405987,6.391841123974513,5.854812243628124,253838.95238095237,8,E01001960,0,9,1,8,9,9,5.882840136119298,4.769615595681326,6.0758452824183875,4.709230235644749,5.531474789551326,6.421223476954869,5.859306269032615,326938.54285714286,8,0,9,0,8,9,9,1.0,0,0,0,-1,0,0,0
1911,5.667866193642051,5.130519499213008,5.68423365334333,4.790099691536467,5.538817886578834,6.018390243336306,5.457982081477925,253609.06779661018,5,E01001961,2,6,3,6,5,3,5.600609179856121,5.098963257195293,5.750422204750172,4.865725365237913,5.586845636367798,6.002161243687505,5.3708295476609385,326652.71014492755,5,3,7,3,9,5,1,1.0,0,1,1,0,3,0,-2
1912,6.0621136496638695,5.236340988449186,5.7092196550982734,4.64132937632109,5.655804645248324,6.19478896626255,5.726785374663726,406710.50292397663,9,E01001962,4,6,0,8,8,8,5.772380542092853,5.216674831840727,5.515832047330009,4.892853060033587,5.406582161453035,6.043000950415929,5.604202281104194,519199.7888888889,7,5,3,3,5,6,5,1.0,-2,1,-3,3,-3,-2,-3
1913,6.132386939435065,4.995138381100908,5.874395534962038,4.6173718616932256,5.660612184790116,6.33403248877465,5.8477910070479675,407961.32911392406,9,E01001963,1,8,0,8,9,9,5.864524878734766,4.97986458137978,5.771535278059716,4.850759445927864,5.41918916688409,6.187041272950727,5.724191061979116,520551.56395348837,8,1,7,2,6,8,7,1.0,-1,0,-1,2,-2,-1,-2
1914,6.157952453108395,5.1681322104790635,5.64945092902464,4.67054175489089,5.617303647013271,6.1843422048232135,5.800443831612082,407385.90588235296,9,E01001964,3,5,1,8,8,8,6.047191799349255,5.088255058394538,5.57318592203988,4.707032646073236,5.493056130409241,6.089228373103672,5.68725419640541,519912.02777777775,9,3,4,0,7,7,7,1.0,0,0,-1,-1,-1,-1,-1
1915,6.30410282365207,4.881766067154106,6.103527907667489,4.498059416639394,5.692537326922362,6.600451039171767,6.018207580193706,406612.724137931,9,E01001965,0,9,0,9,9,9,6.13517487186125,4.870954646461311,6.031495453297407,4.686195135116577,5.504785935084025,6.406671529528738,6.048935821686668,519019.275862069,9,0,9,0,8,9,9,1.0,0,0,0,0,-1,0,0
1916,6.231842717749583,5.215104165035564,5.6594942959114976,4.603913206200413,5.668453213429347,6.128307522644643,5.79697375318369,405753.09170305677,9,E01001966,4,5,0,8,7,8,5.975807434982723,5.171497782623327,5.653245491562067,4.736855702819647,5.514318894456934,6.105075710349613,5.81048263002325,518724.9953703704,9,4,5,0,8,7,8,1.0,0,0,0,0,0,0,0
1917,6.291594735435818,4.981393155844315,6.093682127413542,4.491639709472656,5.660503787579744,6.656123818521914,6.094391549151877,408066.37391304347,9,E01001967,1,9,0,8,9,9,6.018113115141468,4.836640690603564,6.142661881062292,4.729299526060781,5.591203862620938,6.439629466302933,6.053706834393163,520724.17741935485,9,0,9,0,9,9,9,1.0,0,-1,0,0,1,0,0
1918,6.235840751413713,4.868208984533946,6.050086887259233,4.4835990531402725,5.66381343624048,6.455174979410674,6.016336268500278,408283.5789473684,9,E01001968,0,9,0,8,9,9,6.096067198685238,4.82827732286283,6.05136737866061,4.686258010566235,5.594023244721549,6.403475882751601,6.035250361476626,520996.84821428574,9,0,9,0,9,9,9,1.0,0,0,0,0,1,0,0
1919,5.82023549079895,5.185851001503444,5.85154670063812,4.787800903367524,5.558629503344545,6.2467759127664095,5.7161915113430215,405896.6336633663,7,E01001969,3,8,3,6,8,7,5.684864485891242,5.1191544645711,5.6624959945678714,4.8852753074545605,5.324657430146869,6.027839457361321,5.622649903046457,518175.18947368424,6,3,6,3,3,6,5,1.0,-1,0,-2,0,-3,-2,-2
1920,5.553615461316025,5.347454329331716,5.482591603931628,4.919805145054533,5.367109792274341,5.943083047866821,5.424132540560605,406109.1754385965,4,E01001970,6,3,5,2,4,3,5.373972200129154,5.275911855001519,5.532904240336731,5.13737439065084,5.244387919885399,5.865586949090888,5.446050053095296,518415.102189781,2,6,3,8,1,2,2,1.0,-2,0,0,3,-1,-2,-1
1921,5.354083711902301,5.325797299544017,5.623199654122193,5.029322914779186,5.308116329212983,5.908382872740428,5.34095444654425,406448.3958333333,2,E01001971,6,5,7,1,3,2,5.32847827176253,5.199792699267467,5.531626219550769,5.155668834845225,5.217591690520446,5.854808494448662,5.4392642465730505,518800.4270833333,2,4,3,8,1,2,2,1.0,0,-2,-2,1,0,-1,0
1922,5.967901247179406,5.0967524072043915,5.753214603815323,4.673846993690882,5.620922433005439,6.24969266826271,5.750409029487871,406894.7264957265,8,E01001972,2,7,1,8,8,8,5.837193885803223,5.108027996063233,5.7248480548858645,4.9099275484085085,5.482038072586059,6.220534133911133,5.803878242492676,519295.264,8,3,7,3,7,9,8,1.0,0,1,0,2,-1,1,0
1923,5.748200887983495,5.313639000961275,5.544754994638039,4.837670095942237,5.50805919639992,6.054599450393156,5.533716959032145,406336.1818181818,6,E01001973,5,4,4,5,5,5,5.573090609842843,5.3199534059441005,5.474831844333314,5.010462247107151,5.275894451315385,5.930973482828071,5.537966009039078,518705.01824817515,5,7,2,6,2,4,4,1.0,-1,2,-2,2,-3,-1,-1
1924,5.921333500176422,4.912448312625412,5.934397573313437,4.7763920076622455,5.54854390246809,6.33063878303717,5.751393334924682,405675.03305785125,8,E01001974,0,9,2,6,9,8,5.728279686171161,4.959708774385374,5.842943063452224,4.797995874704409,5.398991841915225,6.147035695304555,5.705402039299327,517914.62809917354,7,1,8,1,5,8,7,1.0,-1,1,-1,-1,-1,-1,-1
1925,5.899412384499675,5.115418765855872,5.834881500057552,4.702927645133889,5.481411081293355,6.301113532937092,5.857617345841034,405644.72826086957,8,E01001975,2,8,1,5,9,9,5.811013934725807,5.002645296142215,5.870206054051717,4.7354766493751885,5.429123751322428,6.241428597768148,5.869948825382051,517881.69523809524,8,1,8,0,6,9,9,1.0,0,-1,0,-1,1,0,0
1926,6.002052705366533,4.97932795377878,6.027707149694254,4.60601132780641,5.55303123495081,6.346427532342764,5.748828027274582,401271.3076923077,8,E01001976,1,9,0,6,9,8,5.960166958189502,4.8462924994144245,5.985111683914342,4.7305122073163695,5.465706007996785,6.317524683844183,5.773346564204423,512682.1855670103,9,0,9,0,7,9,8,1.0,1,-1,0,0,1,0,0
1927,6.138458918834078,4.992909334707951,5.902101209198219,4.716910191204237,5.5539775585782705,6.381594968878704,5.729333469833153,401854.46376811597,9,E01001977,1,8,1,6,9,8,5.9797178989364985,4.822877182846978,5.949351824465252,4.745527054582324,5.472253844851539,6.288625200589498,5.757857694512322,513506.5238095238,9,0,9,1,7,9,8,1.0,0,-1,1,0,1,0,0
1928,5.829322463458347,5.039924375789681,5.776466971820163,4.759004026344142,5.416360611768113,6.151479401539281,5.703216230746397,401336.9896907217,7,E01001978,1,7,2,3,7,7,5.817373398308442,4.941585688947518,5.826897188881848,4.794357405644711,5.399168717526944,6.072568949137892,5.7260104930289435,512833.73831775703,8,1,8,1,5,7,7,1.0,1,0,1,-1,2,0,0
1929,5.283504714650556,5.11900095604668,5.625293788831096,4.971033289412822,5.289656239107621,5.768951295821135,5.340409044391853,399165.54545454547,1,E01001979,2,5,6,1,1,2,5.359891600268227,4.987971383333206,5.6627312541008,5.036678177118302,5.244341430493764,5.842338235037667,5.371694687434605,508886.90714285715,2,1,6,6,1,2,1,1.0,1,-1,1,0,0,1,-1
1930,5.840537106053213,5.048357580484969,5.76628785186939,4.772835995374101,5.472847724228762,6.364881767315811,5.655996646773949,401545.8988764045,7,E01001980,1,7,2,4,9,7,5.710612209716646,4.983954568900685,5.753147738994938,4.8494661043186,5.37081766482627,6.217008800789861,5.740625281145077,513072.5346534653,7,1,7,2,4,8,7,1.0,0,0,0,0,0,-1,0
1931,5.829999009316618,4.997972317717292,5.875035575845025,4.680711923675104,5.491808566180143,6.200828013094989,5.613971941850402,392881.4431818182,7,E01001981,1,8,1,5,8,6,5.752384853363037,4.951820300420125,5.868463077545166,4.851265589396159,5.399536139170329,6.245254847208659,5.654574537277222,503259.64,7,1,8,2,5,9,6,1.0,0,0,0,1,0,1,0
1932,6.057032349235133,4.9385462146056325,6.052307402460198,4.51590613064013,5.64736842607197,6.444574386195133,5.940654129731028,394620.7052631579,9,E01001982,0,9,0,8,9,9,5.949988034036425,4.878138599130843,5.9941819614834255,4.64542735947503,5.400345415539212,6.359401165114509,5.933028999964396,504593.2555555556,9,0,9,0,5,9,9,1.0,0,0,0,0,-3,0,0
1933,5.869349222557218,4.991395381151461,5.989919753635631,4.584460060970456,5.51628846280715,6.271174386435864,5.684056391902998,400795.79411764705,7,E01001983,1,9,0,5,8,7,5.709692738272927,4.8557694532654505,5.999939146908846,4.858107566833496,5.331171704422344,6.279436774687333,5.894661896879023,512396.7818181818,7,0,9,2,3,9,9,1.0,0,-1,0,2,-2,1,2
1934,6.186623417345205,5.13700971388279,5.724245820726667,4.552458066689341,5.641497506234879,6.132884631479593,5.753198260651495,186249.94736842104,9,E01001984,3,6,0,8,7,8,6.046677049568721,5.024957810980933,5.700691941806248,4.728768572637013,5.5485297628811425,6.1389245288712635,5.75140756879534,225033.86428571428,9,2,6,0,8,8,8,1.0,0,-1,0,0,0,1,0
1935,6.293053409031459,5.001500369253613,5.962385168529692,4.64330848966326,5.675560599281674,6.385209424155099,6.028174545651391,396264.06666666665,9,E01001985,1,9,0,9,9,9,6.057043670571368,5.000567409266596,5.886039885230686,4.726681024095287,5.547032816513725,6.298028100055197,5.996632484767748,484955.6695652174,9,1,8,0,8,9,9,1.0,0,0,-1,0,-1,0,0
1936,6.243415571295697,4.914958460434623,5.963333032442176,4.6818558599637905,5.60276894984038,6.363569481476493,5.894490830794624,343483.26086956525,9,E01001986,0,9,1,7,9,9,5.939402280375361,4.941727732308209,5.784964321181178,4.754262967966497,5.397600508295,6.295340111479163,5.956927867606282,443018.703125,9,1,7,1,5,9,9,1.0,0,1,-2,0,-2,0,0
1937,6.185469253739314,5.077744145891559,5.80427763889085,4.525230550054294,5.676789251726065,6.263834563653861,5.837369592332128,330812.50746268657,9,E01001987,2,7,0,9,8,9,6.100310690314681,4.972229955814503,5.854982308988218,4.680055386048776,5.564773863333243,6.27048129858794,5.927135478125678,423119.7111111111,9,1,8,0,9,9,9,1.0,0,-1,1,0,0,1,0
1938,6.2682667175928755,4.943823649485906,6.019958907365799,4.543974601229032,5.641409397125244,6.383875079949697,5.910991051793099,328772.1666666667,9,E01001988,1,9,0,8,9,9,6.090303222672278,4.959123522293668,5.939615992938771,4.661385442028527,5.457241982972922,6.235741382887383,5.987822551687224,428536.12605042016,9,1,9,0,7,9,9,1.0,0,0,0,0,-1,0,0
1939,6.108677573204041,5.0650214633941655,5.895469432830811,4.610205099105835,5.709458600997925,6.3401856670379635,5.851944198608399,396198.304,9,E01001989,2,8,0,9,9,9,5.879942963952604,5.020261146020198,5.741123779960301,4.832681572091753,5.4134425926899565,6.148308615753616,5.813754246718641,506564.7536231884,8,2,7,2,5,8,8,1.0,-1,0,-1,2,-4,-1,-1
1940,5.753732436932392,4.778679620405161,5.936901715971668,4.795580019862015,5.515590554438763,6.023348652798196,5.657213942604776,395474.3229813665,6,E01001990,0,9,3,5,5,7,5.680904505429445,4.753713040440171,5.924350513352288,4.861167274139546,5.395496444937623,6.0082585061037985,5.697580092483097,505695.31481481483,6,0,9,2,5,5,7,1.0,0,0,0,-1,0,0,0
1941,6.174686483953191,4.787287724429164,6.07379272340358,4.5804421737276275,5.659571133810898,6.31623518878016,6.014708336742445,404681.6666666667,9,E01001991,0,9,0,8,9,9,6.04989207221801,4.753379314778799,6.044691806816193,4.659120217863336,5.494231310235449,6.265046007661934,6.113770489233086,516420.843373494,9,0,9,0,7,9,9,1.0,0,0,0,0,-1,0,0
1942,6.200231560816367,5.141205181678136,5.751412479827802,4.576124913990498,5.746118068695068,6.325779368480046,5.89756740629673,400002.0520833333,9,E01001992,3,7,0,9,9,9,6.007006610968174,5.11156662549728,5.796603603852101,4.738551786007025,5.577893056624975,6.255828224084316,5.962138274999766,511537.8615384615,9,3,8,0,9,9,9,1.0,0,0,1,0,0,0,0
1943,6.291764285067003,5.071543792168871,5.913926114281304,4.582338857993805,5.732182871523521,6.482551739370223,5.972981794274968,397917.74820143887,9,E01001993,2,8,0,9,9,9,6.110332611653445,4.984134082313922,5.829838639540638,4.701753756982817,5.583742549951128,6.378967060459604,5.935927023990549,508658.7985611511,9,1,8,0,9,9,9,1.0,0,-1,0,0,0,0,0
1944,6.049041420221329,5.2589514132427135,5.756300461033116,4.709962467136591,5.614304683778597,6.215884383605874,5.907382935285568,398342.1793478261,9,E01001994,4,7,1,8,8,9,5.843899353096883,5.266993869716923,5.646901535491149,4.929526758690675,5.450376351053516,6.101458370685577,5.780665103346109,509244.6458333333,8,6,5,4,6,7,8,1.0,-1,2,-2,3,-2,-1,-1
1945,5.563116118989208,5.393801019273021,5.560703372413462,4.813257744366473,5.447139747440815,6.050458736040375,5.641159594736316,409348.8522727273,4,E01001995,7,4,3,4,5,6,5.537730600244256,5.128250670689408,5.671517499031559,4.8682303473513615,5.421008959252347,6.005493049339582,5.640522525515608,522238.8870967742,4,3,6,3,6,5,6,1.0,0,-4,2,0,2,0,0
1946,6.143056044391558,5.029963661642635,5.89361446277768,4.5473915022962235,5.653478627111397,6.400734938827216,5.9824579393162445,409064.56862745096,9,E01001996,1,8,0,8,9,9,5.931937052471803,4.9384393680213705,5.964219064995794,4.735336171518458,5.545736308145051,6.304369973664237,5.925087110831006,521853.82178217825,9,1,9,0,8,9,9,1.0,0,0,1,0,0,0,0
1947,5.9670830760683335,4.9650517804282055,5.913158416748047,4.706870804514204,5.564021478380476,6.208063016619001,5.823366189002991,407737.7428571429,8,E01001997,1,8,1,7,8,9,5.756568328734556,4.904609625324881,5.922501879967063,4.820442577812569,5.444768896863504,6.048974041558482,5.759245586541533,520188.47852760734,7,1,9,2,6,6,8,1.0,-1,0,1,1,-1,-2,-1
1948,6.281953780205695,4.875029949041513,6.034420880642566,4.540333358796088,5.696118978353647,6.461273533957345,5.96617130787818,393069.52747252746,9,E01001998,0,9,0,9,9,9,6.1455348192476755,4.771739375357535,6.065793409067042,4.674888101278567,5.5617962023791145,6.3854580229403926,5.842726574224584,502885.32352941175,9,0,9,0,8,9,9,1.0,0,0,0,0,-1,0,0
1949,5.924845876732493,4.723073405948112,6.01196415831403,4.788588052842675,5.510262414691894,6.279470633685104,5.871058881767397,394258.3658536585,8,E01001999,0,9,3,5,9,9,5.782942545695568,4.757340542913422,6.0022138235137215,4.721478240696464,5.447806593001358,6.211888933744956,5.7901066813881945,504270.0078740158,7,0,9,0,6,8,8,1.0,-1,0,0,-3,1,-1,-1
1950,6.231574185689291,4.86470275455051,6.194060823652479,4.605258380042182,5.632560796207851,6.493835965792338,6.062332060601976,394539.44444444444,9,E01002000,0,9,0,8,9,9,6.080600020326214,4.779246383243137,6.068199560966021,4.711240902359103,5.5720270563054966,6.338279191358589,5.959879124606097,504597.4938271605,9,0,9,0,9,9,9,1.0,0,0,0,0,1,0,0
1951,6.253818916237873,4.813759665558304,6.126356815946275,4.578564538471941,5.709350261135378,6.575830611629763,6.112718219342439,393767.8115942029,9,E01002001,0,9,0,9,9,9,6.16279337182641,4.766223454847932,6.238392598927021,4.5447668842971325,5.6499601528048515,6.507872138172388,6.003737770020962,503840.109375,9,0,9,0,9,9,9,1.0,0,0,0,0,0,0,0
1952,5.941473507881165,5.166603217124939,5.691222059726715,4.756622844537099,5.686607687473297,6.153918233712514,5.714443457126618,222533.16666666666,8,E01002002,3,6,2,9,7,7,5.918291357126129,4.933234810829163,5.6733699923150995,4.897947875301489,5.473026074050518,6.131178281280432,5.676416455359941,295931.2078651685,8,1,6,3,7,8,6,1.0,0,-2,0,1,-2,1,-1
1953,5.809337221440815,5.021951105623018,5.809937512590771,4.812361070087978,5.5963175396124525,6.03992967023736,5.587551559011142,392605.54761904763,7,E01002003,1,7,3,7,5,6,5.64767790936135,4.954588857856956,5.821196953026024,4.9519170303602476,5.402725385330819,5.9676758611524425,5.578345904479155,502347.2702702703,6,1,8,4,5,4,5,1.0,-1,0,1,1,-2,-1,-1
1954,6.422822518008096,4.728934444132305,6.240675440856388,4.361819825002125,5.775779000350407,6.611513994988941,6.1472978336470465,393888.4166666667,9,E01002004,0,9,0,9,9,9,6.220380543190756,4.738305973417965,6.249873923666684,4.565091804221824,5.536471602357464,6.526933308000918,5.849551882272885,503866.6913580247,9,0,9,0,8,9,9,1.0,0,0,0,0,-1,0,0
1955,5.95744968354702,4.820345233380794,6.010468810796738,4.655755236744881,5.631615000963211,6.246349021792412,5.766442792117596,124244.9375,8,E01002005,0,9,1,8,8,8,5.664268168665114,4.80989423536119,5.887148854278383,4.783192772240866,5.413459939616067,6.046417139825367,5.762584061849685,156953.7857142857,6,0,8,1,5,6,8,1.0,-2,0,-1,0,-3,-2,0
1956,6.181349563074636,5.008869634879814,5.965527165067065,4.605075844041594,5.699174954341008,6.175204945134593,5.766457488248636,120491.53846153847,9,E01002006,1,9,0,9,7,8,5.940439918989776,4.869529611320906,5.797770659128825,4.736009252968655,5.424802959606212,6.179464017191241,5.8129756476289485,152415.9247311828,9,0,8,0,6,8,8,1.0,0,-1,-1,0,-3,1,0
1957,6.311534161887952,5.007117277650691,5.888105590841663,4.545158590843428,5.704430745608771,6.191472423610403,5.8988627853678235,386871.10447761195,9,E01002007,1,8,0,9,8,9,5.964180933104621,5.000311676826742,5.760628826088375,4.747585621145037,5.514739456276099,6.119837395019001,5.7447540445460215,495377.90972222225,9,1,7,1,8,7,8,1.0,0,0,-1,1,-1,-1,-1
1958,6.085856621410684,5.149158218428226,5.660169013939451,4.666780297046921,5.668735217877186,6.082411190942197,5.803821959375908,398325.43727598566,9,E01002008,3,5,1,8,6,8,5.908207793432967,5.214510567206189,5.60837820911766,4.838924716289778,5.493441393052725,6.016984443019207,5.667308715501226,509125.9962406015,8,5,5,2,7,5,6,1.0,-1,2,0,1,-1,-1,-2
1959,6.089226785281026,5.049140548875146,5.808845121809777,4.6764390578506685,5.610138640336111,6.092608117042704,5.743136780481812,238481.304964539,9,E01002009,1,7,1,8,6,8,5.908404159379172,4.968277584422719,5.764293280514804,4.799241245209754,5.404913728053753,6.019813395880319,5.69283683400054,291881.8041958042,8,1,7,1,5,6,7,1.0,-1,0,0,0,-3,0,-1
1960,5.851659043451374,5.210587130503708,5.689594938513938,4.740765763802475,5.5165355439936175,6.035250346312362,5.680649297290973,398009.8370786517,7,E01002010,4,6,2,5,5,7,5.766506361711712,5.18984364714298,5.659539975420967,4.9186999797821045,5.417378759508982,6.0653459576412025,5.647350336868725,508790.71204188484,7,4,6,4,5,6,6,1.0,0,0,0,2,0,1,-1
1961,6.0477525437075785,5.145528680053205,5.686564510039862,4.646907399372501,5.646192790394989,6.042335331110665,5.7015289621458525,397366.0828729282,9,E01002011,3,6,0,8,5,7,5.940634436785856,5.082872026744373,5.703525204072024,4.750011902441953,5.532089730635047,6.045350678464308,5.680695384581459,507961.0695187166,9,2,6,1,8,6,7,1.0,0,-1,0,1,0,1,0
1962,6.162466304055576,4.856623838687765,6.032981277882368,4.567823077070302,5.6952229943768735,6.433451496321579,6.020460330206772,396528.3218390805,9,E01002013,0,9,0,9,9,9,6.036650019600278,4.899041327976045,5.959869879768008,4.689732645806812,5.415776861281622,6.320270218167987,5.983112932386852,506752.3904761905,9,0,9,0,5,9,9,1.0,0,0,0,0,-4,0,0
1963,5.828976604996658,5.052817929081801,5.812181961245653,4.775303248467484,5.451260828390354,6.090121771261944,5.639159863557273,393521.2845528455,7,E01002014,1,7,2,4,6,6,5.715218428611755,5.094992983818054,5.756660030364991,4.911479181289673,5.395876463890076,5.973574871063232,5.5525061244964595,503453.968,7,3,7,3,5,5,4,1.0,0,2,0,1,1,-1,-2
1964,5.829245478242308,5.2464358321913,5.687902256682679,4.830547546292399,5.443361206369086,6.029853275844029,5.50280668578305,394423.7802197802,7,E01002015,4,6,3,4,5,4,5.523741691962056,5.229273861852185,5.510550145445199,5.121496617108926,5.260217432318063,5.904036932978137,5.491232597964934,504359.6781609195,4,5,3,8,2,3,3,1.0,-3,1,-3,5,-2,-2,-1
1965,6.123478660507808,4.747107221966698,6.128651974693177,4.63462412830383,5.6447056153463935,6.363987994572473,5.827082984031192,394362.2619047619,9,E01002016,0,9,0,8,9,9,5.847362372279167,4.811394368608792,5.8329908400774,4.740432608127594,5.42011248866717,6.178411736090978,5.836392968893051,504218.5416666667,8,0,8,1,6,8,9,1.0,-1,0,-1,1,-2,-1,0
1966,5.993740620035114,4.951126341867929,5.883605848659169,4.719104559734614,5.579382352154664,6.276712292372578,5.785620972363636,394525.82828282827,8,E01002017,1,8,1,7,8,8,5.699711395962404,4.897937788821683,5.697840576124664,4.876821225232417,5.431682675191672,6.111509696091756,5.867464086796978,504517.0594059406,6,0,6,3,6,7,9,1.0,-2,-1,-2,2,-1,-1,1
1967,6.045799206212624,4.984934898995862,5.845973978337553,4.6874108203907605,5.683102089105193,6.304737813693961,5.960317842739144,399189.74226804124,9,E01002018,1,8,1,9,9,9,5.7671206457780135,5.017470195741937,5.737905036104788,4.920304192174779,5.403871913947682,6.148141334552576,5.832574045304025,510016.2376237624,7,2,7,4,5,8,8,1.0,-2,1,-1,3,-4,-1,-1
1968,6.186216782246317,4.944290419774396,5.879522310835974,4.578537802611079,5.616494691797665,6.29003798535892,6.0053795501589775,396297.58035714284,9,E01002019,1,8,0,8,9,9,5.991904591902708,4.953801996687538,5.909367930175912,4.800823211669922,5.452368226825682,6.330346600622193,6.034920138171596,506620.00854700856,9,1,9,1,6,9,9,1.0,0,0,1,1,-2,0,0
1969,5.910516442052576,5.223873466055914,5.610952647316535,4.7060985280977965,5.542748471759013,5.966640335045113,5.636212388411263,397883.7947019868,8,E01002020,4,5,1,6,4,6,5.839106455183866,5.185118680808976,5.666038143007379,4.80820327683499,5.391111234475297,6.003734219143962,5.637933243087858,508719.98245614034,8,4,6,2,5,5,6,1.0,0,0,1,1,-1,1,0
1970,6.443628117442131,4.802653740160167,6.1559630911797285,4.477011843584478,5.8033825643360615,6.590808408334851,6.114742990583181,396062.8359375,9,E01002021,0,9,0,9,9,9,6.220935526731852,4.801832284476306,5.9975474750673445,4.5591071336656,5.567451812125541,6.468611295158799,6.139863165649208,506354.41891891893,9,0,9,0,9,9,9,1.0,0,0,0,0,0,0,0
1971,6.059145678414239,4.840782813672666,6.047622444011547,4.6660170034126,5.629754341090167,6.257884601310447,5.854979679319594,397327.5407407407,9,E01002022,0,9,1,8,8,9,5.8493733508833525,4.834392751770458,5.971484977623512,4.69976600970345,5.56101451111936,6.1405550104448166,5.788570006003325,507980.3103448276,8,0,9,0,8,8,8,1.0,-1,0,0,-1,0,0,-1
1972,6.228967565004943,4.99174748971814,5.967705568329233,4.554416898821221,5.612693964457903,6.351499903397482,5.987386728896469,396825.54098360654,9,E01002023,1,9,0,8,9,9,5.979857248584117,4.9446123021794115,5.935379223560724,4.712204635612608,5.521869941020575,6.260369114988432,5.84330322235588,507270.6929133858,9,1,9,0,8,9,9,1.0,0,0,0,0,0,0,0
1973,5.942497274610731,5.130993534459008,5.887377193239,4.703166815969679,5.489310593075222,6.309840456644694,5.7930692182646855,396035.8777777778,8,E01002024,2,8,1,5,9,8,5.764888307922765,5.121191083757501,5.775183396590384,4.816928100585938,5.379346365677683,6.141291683598569,5.735447069218284,506267.92631578946,7,3,7,2,4,8,7,1.0,-1,1,-1,1,-1,-1,-1
1974,6.248646163514683,5.044549750430243,5.892689677221434,4.500773612942014,5.725139443363462,6.458670060549464,5.99403070977756,396789.40178571426,9,E01002025,1,8,0,9,9,9,5.9680682784419945,4.958792571294105,5.900306453139095,4.653850406913434,5.517594644578836,6.395361021413642,5.9739233366513655,507226.3898305085,9,1,9,0,8,9,9,1.0,0,0,1,0,-1,0,0
1975,5.4396094348695545,5.041389447270018,5.737951037859676,4.9918128264070765,5.38128019101692,5.9152645245947015,5.412705618925769,406138.6767676768,2,E01002026,1,7,6,2,3,3,5.360389444173551,4.8805598768533445,5.801893381511464,4.989018626072827,5.317416968298893,5.7986152359083585,5.442612946033478,518559.3137254902,2,0,8,5,3,1,2,1.0,0,-1,1,-1,1,-2,-1
1976,5.881331348157191,4.951699239867074,5.87451050045726,4.714704281681186,5.513611612739144,6.495970377555261,6.021198086686187,404078.3296703297,7,E01002027,1,8,1,5,9,9,5.806778674324353,4.974221205959718,5.824843650062879,4.811902921646833,5.388056476910909,6.320844401915868,5.907220852871736,516105.6979166667,8,1,8,2,5,9,9,1.0,1,0,0,1,0,0,0
1977,5.95321347117424,4.949666978915532,5.9621589799722035,4.593303560217222,5.531872322161992,6.464870742956797,5.9221981972455975,403711.50833333336,8,E01002028,1,9,0,6,9,9,5.7763305609343485,4.839191514937604,5.895959445687591,4.794324826021663,5.387246026367437,6.246999562763777,5.876348847248515,515689.95901639346,7,0,8,1,5,9,9,1.0,-1,-1,-1,1,-1,0,0
1978,5.554634735074346,5.1726040474941275,5.644278613129103,4.919644724426931,5.417794428808841,5.898212534154771,5.539393136267028,407282.9248554913,4,E01002029,3,5,5,3,3,5,5.474799743720463,5.062372226800237,5.611490097074282,5.083263297166143,5.316373326239132,5.787913786513465,5.470356288410368,519775.125,4,2,5,7,3,1,3,1.0,0,-1,0,2,0,-2,-2
1979,5.320715919346877,5.335602831672615,5.4830352445723305,5.041035311322816,5.239235104809345,5.842322406634478,5.348875347157599,399625.1478873239,1,E01002030,6,3,7,0,2,2,5.25099388290854,5.265552920453689,5.411686675513492,5.267861270729234,5.153758457478355,5.6637162899269775,5.374565612743883,511606.5661764706,1,6,1,9,0,0,1,1.0,0,0,-2,2,0,-2,-1
1980,5.608436622270724,4.9843040404281,5.833034230441582,4.921106577888737,5.404362826812558,6.061663197308052,5.601210781229221,396603.7073170732,4,E01002031,1,8,5,3,6,6,5.557369526634869,4.902616689347814,5.798400322596232,4.972200197032374,5.305266929487897,6.000234110742553,5.555657514140138,507275.10256410256,5,0,8,5,3,5,4,1.0,1,-1,0,0,0,-1,-2
1981,5.971338482186345,4.939183441719206,5.9222332345377104,4.685972489932976,5.54345983443874,6.364694630745614,5.970587611198425,403994.37623762374,8,E01002032,0,8,1,6,9,9,5.786136418581009,4.794113732046551,5.84183120948297,4.8979952346395565,5.373640446751206,6.268153510711811,5.879967051523703,516022.8611111111,7,0,8,3,4,9,9,1.0,-1,0,0,2,-2,0,0
1982,6.019895116175253,4.831250524896336,5.824192623453816,4.596004224199009,5.579942256446898,6.316122744027085,5.8868454873092535,404867.13385826774,8,E01002033,0,8,0,7,9,9,5.845129916338417,4.910701524920579,5.824954684187726,4.7659634787861895,5.418118579600884,6.277489857945016,5.951171985486659,516960.39837398374,8,1,8,1,6,9,9,1.0,0,1,0,1,-1,0,0
1983,5.172763061232683,5.354585819854969,5.529110076223931,5.095569817031302,5.245684995156963,5.7009420358553164,5.2477805832537205,402016.8658536585,0,E01002034,6,3,8,0,0,1,5.148219152125056,5.164579467145269,5.534601941793978,5.133889012707922,5.240568752060393,5.7154453714450675,5.3995468095391095,513848.2035928144,0,4,3,8,1,0,2,1.0,0,-2,0,0,1,0,1
1984,5.418579441568125,5.312239936123723,5.5878284164097,5.030230660023896,5.409512499104375,5.951021325069925,5.337499280597853,401529.7652173913,2,E01002036,5,4,7,3,4,2,5.175866869779734,5.291498326847696,5.456664366599841,5.088774578184144,5.069923466087406,5.793735459319547,5.323943748433366,512946.44444444444,0,6,2,7,0,1,1,1.0,-2,1,-2,0,-3,-3,-1
1985,5.00080880575757,5.616905559424404,5.0904224012245916,5.304623739575152,5.092841685454617,5.481308968465948,5.007892836031116,399691.4590747331,0,E01002037,9,0,9,0,0,0,5.030068133316987,5.43436562000437,5.157618250407226,5.357560493844621,5.029771261181391,5.488311171954405,5.068646446187445,510938.02482269506,0,8,0,9,0,0,0,1.0,0,-1,0,0,0,0,0
1986,5.439964612325032,5.240017923654294,5.548390222530739,4.917466139092165,5.406415953355677,5.869321009692023,5.358065273247513,400935.51960784313,2,E01002038,4,4,5,3,2,2,5.215576277971268,5.113429526090622,5.593264595270157,5.122979447841645,5.198517210483551,5.815973410606384,5.399932101964951,512400.13,1,3,4,8,1,2,2,1.0,-1,-1,0,3,-2,0,0
1987,5.3225961298239035,5.293585052255724,5.627234197053753,5.080006763583324,5.295113942662224,5.859136221838779,5.426419017744846,399989.08196721313,1,E01002039,5,5,8,1,2,3,5.198195219039917,5.326494307518005,5.483674521446228,5.140771684646606,5.1982063913345335,5.752599563598633,5.509688160419464,511312.98,1,7,2,8,1,1,3,1.0,0,2,-3,0,0,-1,0
1988,5.671635670822208,5.161562038069012,5.697668600483101,4.809804986504948,5.496512384975658,6.0734113424765965,5.49568415790045,400268.3193277311,5,E01002040,3,6,3,5,6,4,5.328609689589469,5.119345145840799,5.6379039316408095,5.054732769727707,5.192688644893708,5.952701012934408,5.495171228724141,511576.8387096774,2,3,5,6,1,4,3,1.0,-3,0,-1,3,-4,-2,-1
1989,5.538321164250374,5.251681434114774,5.54308966199557,4.907119230429331,5.459528879324595,5.965819581349691,5.296894681453705,401442.94166666665,4,E01002041,4,3,5,4,4,1,5.514081946125737,5.038375811444388,5.612723251183827,4.928189071240248,5.3828346243611085,5.842423922485775,5.307546320888731,512947.22222222225,4,2,5,4,5,2,1,1.0,0,-2,2,-1,1,-2,0
1990,5.835266653017782,5.3067440189907895,5.611362138585229,4.761740599445362,5.485955584588362,6.07852297811652,5.58110897265487,394564.2412060301,7,E01002042,5,5,2,5,6,5,5.676803608830466,5.2453804654938185,5.481666950517864,4.979040802380685,5.319270691803197,5.957331757796438,5.415965379140023,504608.9043062201,6,5,2,5,3,4,2,1.0,-1,0,-3,3,-2,-2,-3
1991,5.882183332121774,4.967215740278865,5.879517807049698,4.672371352656504,5.49220877818847,6.308250397778629,5.846752422579219,393333.0449438202,7,E01002043,1,8,1,5,9,9,5.700516817569732,4.921694701910019,5.8204871988296505,4.78018790602684,5.407920882701874,6.1244058465957645,5.675250337123871,503190.42,7,1,8,1,5,7,6,1.0,0,0,0,0,0,-2,-3
1992,5.88268604396302,4.747400604648354,6.046476743839405,4.705197016398112,5.601699340490647,6.187437551992911,5.783903336819307,394600.6296296296,7,E01002044,0,9,1,7,8,8,5.746930649251114,4.76943999160955,5.95861460250101,4.739977649700495,5.485261550656071,6.159523540072971,5.711412771248523,504655.1728395062,7,0,9,1,7,8,7,1.0,0,0,0,0,0,0,-1
1993,5.56431697389131,5.198843051028508,5.675124570887576,4.844813125107878,5.358872059852846,5.970344602420766,5.423115964858763,394688.311827957,4,E01002045,3,6,4,2,4,3,5.440165692997962,5.172875997946434,5.605934548623783,5.083521319418838,5.319970848634071,5.893726017057281,5.485235884017551,504717.793814433,3,4,5,7,3,3,3,1.0,-1,1,-1,3,1,-1,0
1994,5.31628899787789,5.3623499799130565,5.457304685863097,4.9594201881494095,5.326326243023374,5.7174571236567715,5.249187159004496,393981.9253731343,1,E01002046,6,2,6,1,1,1,5.225859672289628,5.246052590700296,5.430542336060451,5.212239862405337,5.162699104272402,5.726038377101605,5.275929484000573,503889.6230769231,1,5,2,9,0,1,0,1.0,0,-1,0,3,-1,0,-1
1995,5.931484341621399,4.804193954997593,5.967388235198127,4.705269563198089,5.700605940818787,6.221198892593383,5.802263534069061,394828.43333333335,8,E01002047,0,9,1,9,8,8,5.837325018771152,4.867375643963509,5.888089743066342,4.85036859994239,5.516201588701694,6.083652919911324,5.713608659328298,505044.60638297873,8,0,8,2,8,7,7,1.0,0,0,-1,1,-1,-1,-1
1996,5.660942638488043,5.009180489040556,5.691456831069219,4.862988221077692,5.481456152598063,6.059460819335211,5.602330929892403,393259.7238095238,5,E01002048,1,6,4,5,6,6,5.453162805901633,5.024906480753863,5.609655289738266,5.022536245761095,5.366337147023943,5.995140020494108,5.5983986766250045,503103.9166666667,3,2,5,6,4,5,5,1.0,-2,1,-1,2,-1,-1,-1
1997,5.417050116467026,5.263637903726326,5.609564606873494,4.918389593655208,5.293882695009124,5.892559951206423,5.347294300232294,393144.56603773584,2,E01002049,5,5,5,1,3,2,5.401717108684582,5.019429422996857,5.645123617989676,4.9914087777609355,5.284560912258023,5.903482913970947,5.431146113427131,503060.5494505495,3,2,5,5,2,3,2,1.0,1,-3,0,0,1,0,0
1998,5.6734760501882535,5.097043351812677,5.811876729294494,4.92217540871966,5.468221405050257,6.179346805090432,5.455107870992723,391701.7032967033,5,E01002050,2,7,5,4,7,3,5.40452466815351,5.053877366594522,5.7963853571788375,5.057061899139221,5.302532950079585,6.025659144642842,5.434412344392523,501259.6385542169,3,2,8,6,3,6,2,1.0,-2,0,1,1,-1,-1,-1
1999,5.578716992063725,5.094000296389803,5.792176462234335,4.883141152402188,5.472480229874875,6.058401445125011,5.455003735866953,391922.10638297873,4,E01002051,2,7,5,4,6,3,5.664805323213011,5.0032364038320685,5.811274316284683,4.844412146033822,5.308228167858752,5.975101903244689,5.555938714153164,501514.6043956044,6,1,8,2,3,5,4,1.0,2,-1,1,-3,-1,-1,1
2000,5.441517865657806,5.184614537954331,5.588670675754547,5.017798738479614,5.381993093490601,5.95277281165123,5.3438307118415835,390141.14,2,E01002052,3,4,7,2,4,2,5.1935842179733775,5.1955607986968495,5.620852185332256,5.213536493156267,5.214751826680225,5.860918900241023,5.332900298678356,499423.847826087,1,4,5,9,1,2,1,1.0,-1,1,1,2,-1,-2,-1
2001,5.626285710505077,5.160041730318751,5.634898300681796,4.835101488445487,5.497354343533516,5.950904603515353,5.453715403165136,386392.04464285716,5,E01002053,3,5,4,5,4,3,5.540306285504372,5.124901308167365,5.563946695097031,5.002384986608259,5.330801883051472,5.930162433655031,5.481256744553966,489181.43548387097,5,3,4,5,3,4,3,1.0,0,0,-1,1,-2,0,0
2002,5.693728831877191,5.158532406910356,5.762257667909186,4.7327149589377715,5.5120344621589386,6.047318142580699,5.602680411683508,392309.734939759,5,E01002054,3,7,2,5,5,6,5.534154079942143,5.13923039857079,5.6501451997195975,4.96126663684845,5.336637550241807,6.057087320439956,5.496385595377753,502019.5882352941,4,3,5,4,3,6,3,1.0,-1,0,-2,2,-2,1,-3
2003,5.805202028086019,5.061347648154857,5.866905071014582,4.832210266312887,5.576351212900739,6.1885017017985495,5.573446186475976,390617.73255813954,7,E01002055,2,8,4,7,8,5,5.644822562849799,4.987609588822653,5.898286966390388,4.937247488387795,5.367100769697234,6.210118324257607,5.72788590885872,500024.4767441861,6,1,9,4,4,8,7,1.0,-1,-1,1,0,-3,0,2
2004,5.526120106379191,5.173265903174472,5.674213093965232,4.857370411457659,5.4620842714698945,5.997120944010157,5.480413380934268,331941.56462585035,3,E01002056,3,6,4,4,4,4,5.418366925605875,5.096260913949928,5.634564826030605,5.059212435949717,5.203125953674316,5.888202128820861,5.399271177929759,424318.7814569537,3,3,5,6,1,3,2,1.0,0,0,-1,2,-3,-1,-2
2005,5.351299885908762,5.285139746136135,5.522968037923177,5.063767519262102,5.276355285114712,5.840549124611749,5.327399085627662,345629.1111111111,2,E01002057,5,3,8,1,2,1,5.14256183497877,5.290462832853018,5.418231587812125,5.258731201470616,5.134693830846304,5.6800318281334565,5.2298994825547,437037.2771084337,0,6,1,9,0,0,0,1.0,-2,1,-2,1,-1,-2,-1
2006,5.619212811276064,5.175795976388252,5.614750114537902,4.889565821421349,5.379898165242147,6.000079011513015,5.60305665206101,206977.9745762712,5,E01002058,3,5,5,2,5,6,5.5601735209996725,5.033864416907319,5.55369312995303,4.976356734216741,5.277817195495673,5.992062387213243,5.663824252322712,263535.49557522126,5,2,4,5,2,5,6,1.0,0,-1,-1,0,0,0,0
2007,6.444620410601298,4.878264313204246,6.114645849194443,4.446704107418395,5.849338615149782,6.582176515930577,5.955825198114964,394204.0701754386,9,E01002059,0,9,0,9,9,9,5.667199422631945,5.1114723614283974,5.582033913476127,4.854968181678227,5.320815926790237,6.037566620111465,5.558734001432146,504258.3357142857,6,3,4,2,3,6,4,1.0,-3,3,-5,2,-6,-3,-5
2008,6.357994414947846,4.8680656637464255,6.1908077748267205,4.6510794555747905,5.6285632992838766,6.53852346441248,5.928099672872942,393997.5164835165,9,E01002060,0,9,0,8,9,9,6.017130655712552,4.772487411234114,6.0392650312847564,4.6341288500361975,5.487002119753096,6.514776166280111,6.077976923518711,503875.3888888889,9,0,9,0,7,9,9,1.0,0,0,0,0,-1,0,0
2009,6.311938871036876,4.898639330960283,6.099357597755663,4.537648332239401,5.691034642132846,6.469950502569025,6.033077798708521,294579.0202020202,9,E01002061,0,9,0,9,9,9,5.901816512529667,4.9381288553659735,5.88548978475424,4.78980634533442,5.479006444032375,6.256173998117447,5.952568815304683,365270.2403846154,8,1,8,1,7,9,9,1.0,-1,1,-1,1,-2,0,0
2010,6.095547877756276,5.023684485514361,5.865066114224885,4.69386036772477,5.610549907038982,6.283552297075889,5.831342873716713,121705.05263157895,9,E01002062,1,8,1,8,9,9,5.982988638471263,4.944374804348909,5.806737994038781,4.68888444678728,5.507706594097522,6.192847956058591,5.912134781364323,155415.99224806202,9,1,8,0,8,8,9,1.0,0,0,0,-1,0,-1,0
2011,5.9918410351517,5.044750524223398,5.909861679470867,4.682098937690805,5.636888762132837,6.288198998215002,5.742837960566949,109337.69724770643,8,E01002063,1,8,1,8,9,8,5.82075572013855,5.037587314302271,5.889374550906095,4.834591743079099,5.407572167569941,6.21380194533955,5.878599620949139,139028.35454545455,8,2,8,2,5,8,9,1.0,0,1,0,1,-3,-1,1
2012,5.758445720723334,5.034232828211277,5.920460939407349,4.749713058167315,5.628084852340374,6.149974257388013,5.646565006134358,109567.22340425532,6,E01002064,1,8,2,8,7,6,5.537684795807819,5.067347795379405,5.826420589369171,4.9072414721761435,5.424346636752693,6.069648441003293,5.627382859891775,139302.23469387754,4,2,8,3,6,7,6,1.0,-2,1,0,1,-2,0,0
2013,5.775561074821317,4.975943341547129,6.018409113494718,4.782034809492072,5.647104304663989,6.161993642242587,5.699459797265578,109841.48979591837,6,E01002065,1,9,2,8,7,7,5.658297286314123,4.8672473535818215,6.030001694080877,4.815370652021146,5.4565795601583,6.072990917691998,5.821108849609599,139620.33333333334,6,0,9,2,7,7,8,1.0,0,-1,0,0,-1,0,1
2014,5.339855872544666,5.380661110749981,5.402934616844126,5.02951713296391,5.3359756373719085,5.6952760291579585,5.2580424371181715,392481.2416107383,1,E01002066,7,1,7,2,0,1,5.379168040043599,5.291352478233543,5.510543333517538,5.0892078683183,5.272609325679573,5.8261217329953165,5.39406446105725,502329.66891891893,2,6,3,7,2,2,2,1.0,1,-1,2,0,0,2,1
2015,5.544664885520935,5.259346323013306,5.67927021598816,4.8305039215087895,5.373731004714966,6.033676513671875,5.566414636611938,392471.304,4,E01002067,4,6,3,2,5,5,5.602395534515381,5.1604776002742625,5.59694602754381,4.956295303062157,5.369074442651537,6.0183759283136435,5.63356066191638,502198.57037037035,5,4,4,4,4,6,6,1.0,1,0,-2,1,2,1,1
2016,5.296335098694782,5.259954003655181,5.474311374888128,5.111267864704132,5.317893994706018,5.724006782989113,5.275506549951982,391334.5612244898,1,E01002068,4,2,8,1,1,1,5.238517008914848,5.197945844324142,5.47022462508839,5.182687829813191,5.254907917482248,5.738391390736239,5.296874328598458,500826.65284974093,1,4,2,8,2,1,0,1.0,0,0,0,0,1,0,-1
2017,5.490979017409603,5.000068432461899,5.746761326241282,4.824115194050612,5.454643694700393,5.8890352059254605,5.473576101581608,393014.90265486727,3,E01002069,1,7,3,4,3,4,5.407076782431484,4.924015948595095,5.779502919882782,4.930125773445634,5.340709297125005,5.905025874287629,5.487716022601798,502766.0082644628,3,1,7,4,3,3,3,1.0,0,0,0,1,-1,0,-1
2018,5.8077541502083045,5.168855980915182,5.790659862406113,4.753869766698164,5.530570845393574,6.2024263003293205,5.713871141566949,393056.9411764706,7,E01002070,3,7,2,6,8,7,5.716061657980869,5.004127105599956,5.763187017879988,4.940846279263496,5.470749608780208,6.124167366247428,5.678637341449135,502900.2631578947,7,1,7,4,7,7,6,1.0,0,-2,0,2,1,-1,-1
2019,5.553861530979028,5.203516346685002,5.692306304245852,4.8730339615532525,5.474047139789281,5.957580826255713,5.369047379225828,392599.7303370786,4,E01002071,4,6,4,4,4,2,5.561493278695987,5.098868930569062,5.687089940676322,4.949019112266027,5.389496745971533,5.936269897681016,5.48962824505109,502205.48076923075,5,3,6,4,5,4,3,1.0,1,-1,0,0,1,0,1
2020,5.641904483705559,5.237181275482945,5.659478326771883,4.891835292713754,5.528410554732252,5.9707520600133295,5.514902900529388,394161.99328859063,5,E01002072,4,5,5,6,4,4,5.541283826305442,5.147679067637823,5.617266705591384,4.9467482256562745,5.41514827943828,5.97921234777529,5.63380336516524,504129.58219178085,5,4,5,4,5,5,6,1.0,0,0,0,-1,-1,1,2
2021,5.616473597975878,5.223062648222997,5.668111132887693,4.914611001427357,5.47564925138767,6.0436802598146295,5.502851566443076,394136.21153846156,4,E01002073,4,5,5,4,5,4,5.554503911733628,5.0191257548332215,5.68038192987442,4.988983100652694,5.4067825508117675,6.004885195493698,5.556479042768478,504131.99,5,2,6,5,5,5,4,1.0,1,-2,1,0,1,0,0
2022,5.509107302535664,5.139160838994113,5.588962281292135,4.894213513894514,5.366578245704824,6.001816768537868,5.452000326730988,400625.8409090909,3,E01002074,3,4,5,2,5,3,5.324191503141118,5.185622342701616,5.525352151914575,5.096227249879947,5.311936205831067,5.897614618827557,5.408793360337444,512002.5057471264,2,4,3,7,3,3,2,1.0,-1,1,-1,2,1,-2,-1
2023,5.4715957325181845,5.539915606563474,5.378282335805304,5.089148359534181,5.302979820304447,5.798553122414483,5.302428020371331,400033.0308641975,3,E01002075,9,1,8,1,1,1,5.437631663559489,5.426375318124804,5.30802343966644,5.190913735097543,5.238875515888192,5.772990182645059,5.350248485631337,511336.79768786125,3,8,0,8,1,1,1,1.0,0,-1,-1,0,0,0,0
2024,5.651189460473902,5.217952805406907,5.678664516000187,4.835654103288464,5.46814712005503,6.185431884784324,5.3189187552414685,400549.17647058825,5,E01002076,4,6,4,4,8,1,5.445389178524847,5.108689182737599,5.593223007865574,5.023740857580433,5.3021021480145665,5.967234798099684,5.1951278987138165,511910.8,3,3,4,6,3,4,0,1.0,-2,-1,-2,2,-1,-4,-1
2025,5.403743243045944,5.193886097386587,5.655649869562053,4.97048728671863,5.349278832511079,5.912230583403608,5.3849157343665475,400865.035971223,2,E01002077,3,5,6,2,3,2,5.424453076000871,5.089395971133791,5.601694424399014,5.088447683433007,5.338774024207017,5.861590089469121,5.301118120653876,512264.0275862069,3,3,4,7,3,2,0,1.0,1,0,-1,1,1,-1,-2
2026,5.640953684356851,5.361222027053295,5.534946434934374,4.87120430486303,5.520947674630394,5.8595641246983705,5.284007538372363,389827.73943661974,5,E01002078,6,3,4,6,2,1,5.356641566666373,5.422085328693807,5.364444433337581,5.163449182997655,5.268132061853896,5.71487625323943,5.289556980133057,499082.7810218978,2,8,1,8,2,0,0,1.0,-3,2,-2,4,-4,-2,-1
2027,5.637828866640727,5.197955872331347,5.748511910438538,4.823121811662402,5.4620333555198854,6.196654606433142,5.381559905551729,400631.2619047619,5,E01002079,3,7,3,4,8,2,5.619660454988479,5.073465253412723,5.822293001413345,4.816510199010372,5.327513715624809,6.026842430233955,5.272312790155411,512018.15,6,2,8,2,3,6,0,1.0,1,-1,1,-1,-1,-2,-2
2028,5.382430074195708,5.439650919168226,5.3096822937650066,5.116303613589656,5.219114745336194,5.739487605229501,5.251353168199139,397637.6129032258,2,E01002080,7,1,8,0,1,1,5.276659598946571,5.3313446169098215,5.36440648684899,5.11986519296964,5.204004964232444,5.77280606875817,5.3182682424783705,508599.8416666667,1,7,1,8,1,1,1,1.0,-1,0,0,0,1,0,0
2029,5.354449212156384,5.329508633013592,5.484345988722037,5.0647187690861175,5.331201967024645,5.737921311365848,5.201069586324376,394136.00662251655,2,E01002081,6,3,8,1,1,0,5.179370822495972,5.398531909809996,5.466080831376132,5.218480365955277,5.2803361668491995,5.748864127310696,5.19077919729498,504266.7417218543,0,8,2,9,2,1,0,1.0,-2,2,-1,1,1,0,0
2030,5.203040280125358,5.481963272799145,5.30634209242734,5.114612874659625,5.267417097633535,5.695227939974178,5.277825392105362,402392.375,0,E01002082,8,0,8,1,0,1,5.093696630129251,5.263033288781361,5.397395149354012,5.099110573850652,5.147338690296296,5.829610460547991,5.2818646507878455,514151.8817204301,0,6,1,7,0,2,0,1.0,0,-2,1,-1,-1,2,-1
2031,5.847062244415283,5.0623996341228485,5.854172384738922,4.744716418981552,5.570133345127106,6.255336918830872,5.800098352432251,403735.39,7,E01002083,2,8,2,7,8,8,5.719498144401299,4.982849541601244,5.807533987275847,4.903998186300089,5.333688511953249,6.232746556565002,5.76949388902266,515761.021978022,7,1,8,3,3,9,8,1.0,0,-1,0,1,-4,1,0
2032,5.759728325924403,5.187192739735187,5.606032736704383,4.810956138120571,5.507842331704959,6.078728403843624,5.54861377914187,401420.9647887324,6,E01002084,3,4,3,5,6,5,5.6493797435627116,5.109670155531877,5.652998330709818,5.037957591610355,5.30438639233996,6.061837123824167,5.559024729095139,513129.88811188814,6,3,5,6,3,6,4,1.0,0,0,1,3,-2,0,-1
2033,5.858721294322936,5.080189393348053,5.799633818514207,4.815036025367865,5.389369753228516,6.204619820378408,5.6609905337085245,393108.4285714286,7,E01002085,2,7,3,3,8,7,5.643248646199202,5.059741248603628,5.764361952533241,4.945935823336369,5.290474497971415,6.116354168964033,5.648462006023952,502726.2268907563,6,2,7,4,2,7,6,1.0,-1,0,0,1,-1,-1,-1
2034,5.847432563179417,5.229368873646385,5.749305777800711,4.776597920217012,5.49408961095308,6.134066350836503,5.538710756050913,400532.9789473684,7,E01002086,4,7,2,5,7,5,5.629075227872185,5.127223316742026,5.800003945827484,4.9151458481083745,5.340132489152577,6.213191734707874,5.615818684515745,511451.82608695654,6,3,8,4,3,8,5,1.0,-1,-1,1,2,-2,1,0
2035,6.046259275504521,4.94305911234447,5.94648019472758,4.639167392537708,5.628156826609657,6.320757539499374,5.809782520646141,394600.5238095238,9,E01002087,1,9,0,8,9,8,5.8545836878985895,4.924486225698052,6.00097311124569,4.889993212571958,5.476130377955553,6.216186613571353,5.7085892921540795,504776.6951219512,8,1,9,3,7,8,7,1.0,-1,0,0,3,-1,-1,-1
2036,5.714993780091305,5.203427184348138,5.73860873311958,4.806501662171127,5.4977569332058795,6.197983888971725,5.580392677511945,403196.2953020134,6,E01002088,4,7,3,5,8,5,5.6855188095116915,5.029908531828772,5.7352560200268705,4.861425583121143,5.4176098953319505,6.211548770530315,5.734149053126951,515064.9936708861,6,2,7,2,5,8,7,1.0,0,-2,0,-1,0,0,2
2037,5.254740041844985,5.397080624804778,5.25226884729722,5.163870843017802,5.2065496409640595,5.570359068758347,5.201625427779029,402157.5,1,E01002089,7,0,9,0,0,0,5.204584636995869,5.229580037055477,5.484894148765072,5.2568686931364,5.185972909773549,5.528031049236175,5.283136340879625,513837.6129032258,1,5,2,9,1,0,0,1.0,0,-2,2,0,1,0,0
2038,5.290364506744569,5.532075103252165,5.433214625043254,5.0606595277786255,5.379257996236125,5.90309495214493,5.168352429905245,403858.73387096776,1,E01002090,9,2,8,2,3,0,5.15583516061306,5.336863311131795,5.542166111866633,5.163626671830813,5.214667414625485,5.8337890148162845,5.358710163831711,515975.55833333335,0,7,3,8,1,2,1,1.0,-1,-2,1,0,-1,-1,1
2039,5.5571586670194355,5.497980521065848,5.435875320434571,5.016881929806301,5.380867761884417,5.9529512459891185,5.296555205753871,402564.34857142856,4,E01002091,8,2,7,2,4,1,5.3798842279307815,5.287437628550702,5.45792211035648,5.101175924381578,5.253078811858074,5.884652031473367,5.408941243786409,514355.3072289157,2,6,2,7,2,3,2,1.0,-2,-2,0,0,0,-1,1
2040,5.744754641706293,5.345555144006556,5.635485397685658,4.816556347500194,5.525666531649503,6.1015485590154475,5.554014812816273,402369.2181818182,6,E01002092,6,5,3,6,6,5,5.61534644650147,5.161700492411589,5.6977048616493695,4.965720552258787,5.338897111141576,6.024273914573467,5.585751089374576,513988.21238938055,5,4,6,5,3,6,5,1.0,-1,-2,1,2,-3,0,0
2041,5.472725225495291,5.367950491138272,5.5161041313118035,5.004949722256693,5.3577382881324604,5.94996147055726,5.398919730753332,403056.8041958042,3,E01002093,6,3,7,2,4,2,5.369684222972754,5.251934260129929,5.550046490900444,5.013944468714974,5.286422503717018,5.96293829607241,5.558762171051719,514965.7803030303,2,5,4,6,2,4,4,1.0,-1,-1,1,-1,0,0,2
2042,5.89759855722859,5.359798289563534,5.679602807455689,4.7118673368092,5.511426339184281,6.2518142661909115,5.637794044766113,402371.4598540146,7,E01002094,6,6,1,5,8,6,5.602595134134646,5.25436178666574,5.52787702790013,4.953915508588155,5.210637650666413,6.121793038756759,5.615309659639994,514102.1111111111,5,5,3,4,1,7,5,1.0,-2,-1,-3,3,-4,-1,-1
2043,6.032324595884844,5.207745011477547,5.6860609398806155,4.676964539895083,5.6841838767821775,6.23158900495519,5.748186984164192,401944.33689839573,8,E01002095,4,6,1,9,8,8,5.775449646080975,5.154638801569714,5.645489686446664,4.797651149215499,5.439254028010743,6.168204674546007,5.6864687578840405,513626.2617801047,7,4,5,1,6,8,7,1.0,-1,0,-1,0,-3,0,-1
2044,5.7929883591540445,5.37726760839487,5.654326926578175,4.8659185929731885,5.517240567640825,6.167148409725784,5.584909211505543,403003.66233766236,7,E01002096,6,5,4,5,7,6,5.496572330400541,5.3419580560225945,5.477472675311101,5.021460732082268,5.284696724507715,6.023574849227806,5.548880618888062,514886.3961038961,4,7,2,6,2,6,4,1.0,-3,1,-3,2,-3,-1,-2
2045,6.021753792579357,5.1842051308888655,5.81682564662053,4.665833404430976,5.6074246649558726,6.432600179543862,5.85974114560164,403012.0576923077,8,E01002097,3,7,1,7,9,9,5.669635743536848,5.048020352708533,5.650993849368805,4.815600922767152,5.237350011125524,6.2785502469286,5.855396027260638,514907.24468085106,6,2,5,2,1,9,9,1.0,-2,-1,-2,1,-6,0,0
2046,5.683879953815091,5.120635980175387,5.7531365717611,4.810921689002744,5.532458140773158,6.095070169818017,5.682261643102092,406928.6064516129,5,E01002098,2,7,3,6,6,7,5.550646272126366,5.019831480699427,5.66907335099052,4.944602898289175,5.377815215026631,5.9776157168781054,5.615808052175185,519382.8588235294,5,2,6,4,4,5,5,1.0,0,0,-1,1,-2,-1,-2
2047,5.525257154305776,5.405489630169338,5.526231050491333,5.007713958952162,5.428603071636624,5.871623195542229,5.302547473377651,406023.64444444445,3,E01002099,7,3,7,3,2,1,5.509983232487803,5.233541339635849,5.553871626439302,5.090613026981768,5.282095753628274,5.915602093157561,5.362796928571618,518202.5,4,5,4,7,2,3,1,1.0,1,-2,1,0,-1,1,0
2048,5.494541907539735,5.22409100486682,5.765974835707591,5.013805032922671,5.467163189099385,6.078118095031152,5.508610530541493,403409.8653846154,3,E01002100,4,7,7,4,6,4,5.398362660870968,5.13117884547965,5.659875800308672,4.96626962735815,5.321389548986861,5.988487912613211,5.518611857034628,515358.47572815535,3,3,6,5,3,5,4,1.0,0,-1,-1,-2,-1,-1,0
2049,6.197393467666906,4.917424084943369,5.947170716906906,4.597054684927704,5.668410831635152,6.530576358147718,5.832857395530841,405601.6605504587,9,E01002101,0,9,0,8,9,9,5.985261470079422,4.840318802457589,5.81444778579932,4.679132579610898,5.526762772064942,6.317053746718627,5.778996865336712,517934.64423076925,9,0,8,0,8,9,8,1.0,0,0,-1,0,0,0,-1
2050,5.855497289888607,5.1651316333261335,5.759955968175616,4.763369870482024,5.6070150507162815,6.192119696125481,5.616099405732954,405808.26086956525,7,E01002102,3,7,2,7,8,6,5.870041781330701,5.038270637115336,5.695237281159584,4.9294368754262505,5.437864382814917,6.07460780173355,5.625100097300844,518139.12422360247,8,2,6,4,6,7,6,1.0,1,-1,-1,2,-1,-1,0
2051,5.784501570422633,5.1890269647650165,5.764966203241932,4.950544245389043,5.506452351200338,6.181159387640402,5.549836527733576,404310.49659863947,6,E01002103,3,7,6,5,7,5,5.64003491244818,5.09588140092398,5.583573032366602,5.0285096192046215,5.319889216830856,6.138004478655364,5.683264357478995,516373.96710526315,6,3,4,6,3,8,7,1.0,0,0,-3,0,-2,1,2
2052,5.601591976647525,5.2513596409374905,5.749502059110661,4.97448944922575,5.4310420321435044,6.17149180235322,5.480725086841387,403881.03092783503,4,E01002104,4,7,6,3,7,4,5.3634963923809575,5.099798903745763,5.572140857285144,5.105909837227242,5.273864110310872,5.9330159963346,5.576608093345866,515875.46078431373,2,3,4,7,2,4,5,1.0,-2,-1,-3,1,-1,-3,1
2053,5.728255920939976,5.155777098955931,5.798185600174798,4.857848859495586,5.594701023013504,6.129163393267879,5.452685591247347,406857.19444444444,6,E01002105,3,7,4,7,7,3,5.5307153954225425,5.14888346996628,5.671797387740192,4.951858568592232,5.3774217417260175,6.001174868655806,5.472485194687082,519271.4117647059,4,4,6,4,4,5,3,1.0,-2,1,-1,0,-3,-2,0
2054,5.615050890087303,5.394619971318962,5.691066670261956,4.91255564003988,5.543680395955354,6.2483963826123405,5.622864027428471,42861.78431372549,4,E01002106,7,6,5,6,8,6,5.506540488152608,5.415074854871652,5.660412805793929,4.96190837177917,5.422312513755186,6.220808975887994,5.808188602001998,55453.10218978102,4,8,6,4,6,9,8,1.0,0,1,0,-1,0,1,2
2055,5.691908977175719,5.401338785286717,5.544780721600424,4.945922062701027,5.619778284290493,6.017141178950367,5.702432979673347,40694.281879194634,5,E01002107,7,4,6,8,5,7,5.696610892405276,5.308479617853633,5.81606764871566,5.013972462200727,5.590652407192793,6.162625101746106,5.668329758722274,52854.39344262295,6,6,8,6,9,8,6,1.0,1,-1,4,0,1,3,-1
2056,5.534230441758127,5.38786043452494,5.582173069318135,4.96908339677435,5.57382781939073,6.137518461906549,5.783533336538257,41789.545454545456,4,E01002108,7,4,6,7,7,8,5.631590150296688,5.216707527637482,5.759308014597211,4.91652079884495,5.558230825832912,6.171901447432382,5.817106310810361,54136.419642857145,6,5,7,4,8,8,8,1.0,2,-2,3,-2,1,1,0
2057,5.776221293629262,5.387979312946922,5.430361182020421,4.787299786220517,5.542601122667915,6.08594272429483,5.67988036023943,41451.78070175439,6,E01002109,7,2,3,6,6,7,5.945464241347124,5.265109892983793,5.67279402064857,4.799040761288042,5.634518384933472,6.221389806218085,5.636460149865844,53735.52422907489,9,6,6,1,9,9,6,1.0,3,-1,4,-2,3,3,-1
2058,5.783834850916299,5.391948951187954,5.537038635823034,4.885685218277798,5.589568757882682,6.065821475880121,5.681865840829829,41372.83870967742,6,E01002110,7,3,5,7,6,7,5.797971605675892,5.315186782948022,5.690646401886801,4.909479778368496,5.571320714302433,6.116869163744658,5.65321613515465,53559.35922330097,8,6,6,3,9,7,6,1.0,2,-1,3,-2,2,1,-1
2059,5.380132855613375,5.402019108579458,5.577936988059289,5.005709424044917,5.447919414343079,6.000225837113427,5.428562167563725,42364.983606557376,2,E01002111,7,4,7,4,5,3,5.2799515570147655,5.361992685982351,5.539281569170148,5.107749865965896,5.324697377976407,5.996671257394083,5.551234022954876,54837.61235955056,1,7,3,7,3,5,4,1.0,-1,0,-1,0,-1,0,1
2060,5.93031235469435,5.362828470174239,5.5235738095878055,4.825066821844508,5.5725559165786995,6.0456960141409395,5.614688863814126,40234.70292887029,8,E01002112,6,3,3,7,5,6,6.0470192196468515,5.339040794720252,5.6252887604965105,4.7997645445995865,5.649878527141279,6.12033228824536,5.628536706997289,52034.239583333336,9,7,5,1,9,7,6,1.0,1,1,2,-2,2,2,0
2061,5.897396962630925,5.382419320750119,5.541886833500979,4.777059933234906,5.597017780313351,6.09805469970985,5.677610218818552,39744.91625615764,7,E01002113,7,3,2,7,6,7,5.925428211985536,5.336512104788823,5.610993636781304,4.823353593622274,5.598272184827435,6.172478180026534,5.626815949506428,51489.59701492537,9,7,5,2,9,8,6,1.0,2,0,2,0,2,2,-1
2062,6.048876812991403,5.531031333921517,5.068803331820049,4.7866454087981305,5.5054290369865315,5.69053184826561,5.3676018379842345,114591.03059273423,9,E01002114,9,0,3,5,0,2,5.983017915526763,5.592347717837782,5.124472314356178,4.922541887357535,5.363760134242228,5.813517224907086,5.354631270596523,148491.03973509933,9,9,0,4,4,2,1,1.0,0,0,0,1,-1,2,-1
2063,5.665266292325912,5.500567591574884,5.544714444683444,4.825371963747086,5.587021741559429,6.167885992603917,5.657610329504936,40605.29677419355,5,E01002115,8,3,3,7,7,7,5.702278142106043,5.390299443512747,5.641756908534324,4.857481791548533,5.58427250221984,6.130042801164601,5.620076528967243,52643.66438356164,7,8,5,2,9,7,5,1.0,2,0,2,-1,2,0,-2
2064,6.038718589544296,5.318634970188141,5.5816375148296355,4.618572872281074,5.705033426880837,6.139879214763641,5.700659310817718,38768.72,9,E01002116,5,4,0,9,7,7,5.938277101995957,5.226376009945893,5.691051431037673,4.838691277120581,5.644070353939306,6.102275872350338,5.647641379030506,50200.18090452261,9,5,6,2,9,7,6,1.0,0,0,2,2,0,0,-1
2065,5.484452929914272,5.494716079553701,5.38847065026859,5.049493460061913,5.450092856785119,5.9581846729401615,5.4885079492621704,40387.77419354839,3,E01002117,8,1,7,4,4,4,5.541027027279584,5.336040294437266,5.573870374195612,4.996926240511795,5.479278314024655,6.0016940787656985,5.432731925996382,52389.92910447761,5,7,4,5,7,5,2,1.0,2,-1,3,-2,3,1,-2
2066,5.457081723040429,5.267100396363632,5.649570909099302,4.979143083959386,5.523132790689883,6.009518431580585,5.362868205360744,38439.69565217391,3,E01002118,5,5,6,6,5,2,5.31975052186421,5.2694423407703255,5.552106871233358,5.092063004320318,5.350854874431313,5.87471801197374,5.372750874463614,49766.14935064935,2,6,4,7,4,3,1,1.0,-1,1,-1,1,-2,-2,-1
2067,5.377875477434641,5.395537382148834,5.4236951434468645,5.045530480792723,5.356751968343574,5.884143786258008,5.446620791073305,37553.6265060241,2,E01002119,7,2,7,2,3,3,5.370334025393141,5.350475693636752,5.531006688767291,5.121676445641416,5.33893666115213,5.9783928508454185,5.558869489964018,48714.30319148936,2,7,3,8,3,5,4,1.0,0,0,1,1,1,2,1
2068,5.51361959714156,5.402159491738121,5.44921490255293,5.026974260152041,5.358328960754059,6.046632491625273,5.5061950866992655,39200.12087912088,3,E01002120,7,2,7,2,5,4,5.406618381539981,5.273101020604372,5.587989633282025,4.987503757079442,5.346027153233687,6.052531942725182,5.597690362483263,50835.427083333336,3,6,4,5,4,6,5,1.0,0,-1,2,-2,2,1,1
2069,5.3575462171009605,5.363438804660524,5.510665360518864,5.073475211858749,5.391439196893147,6.080979037284851,5.741273219244821,38549.97857142857,2,E01002121,6,3,8,3,6,8,5.335136646224607,5.296196905835982,5.655779932775805,5.105059906359641,5.373450421517895,6.036585075239981,5.661352215274688,49883.06451612903,2,6,5,7,4,6,6,1.0,0,0,2,-1,1,0,-2
2070,5.388549857399091,5.170584327509614,5.543831270568225,4.95103674113345,5.462430850178206,5.914310667790523,5.5659076510643475,37355.292517006805,2,E01002122,3,3,6,4,3,5,5.392984801263951,5.127146168431239,5.701562123512154,4.975631819732153,5.348366596805516,5.97410719608193,5.557036560862811,48459.84328358209,3,3,6,5,4,5,4,1.0,1,0,3,-1,0,2,-1
2071,5.201148015215881,5.254777851857637,5.505897536313624,5.074773509699599,5.319938345063002,5.69714885905273,5.453932224359727,36892.44360902256,0,E01002123,4,3,8,1,0,3,5.137468502439302,5.128510596012247,5.691012851945285,5.232069646901098,5.2806950034766365,5.784860578076593,5.336353485337619,47810.06206896552,0,3,6,9,2,1,1,1.0,0,-1,3,1,1,1,-2
2072,5.216120249968915,5.486066670457194,5.411058354968867,5.183386699227262,5.344186881356988,5.749165048283979,5.21845729784532,37768.38016528926,0,E01002124,8,1,9,2,1,0,5.103043254751426,5.271503521845891,5.522810186331089,5.337520261223499,5.259792212110299,5.75500212265895,5.209432549201525,48903.95192307692,0,6,3,9,2,1,0,1.0,0,-2,2,0,0,0,0
2073,5.282673136202875,5.348768506935257,5.555257164075703,5.0876523998683085,5.3114743382630945,5.867727011263727,5.460443555238005,37003.71856287425,1,E01002125,6,4,8,1,2,3,5.167300021518832,5.423630706641985,5.581675177035124,5.193810065155444,5.237394457925921,5.8178881290166276,5.400400358697643,48083.788043478264,0,8,4,8,1,2,2,1.0,-1,2,0,0,0,0,-1
2074,5.505132425576448,5.367518949721541,5.515161110354321,5.024769368980612,5.4429345934518745,5.90479582122394,5.487359064498118,48057.90178571428,3,E01002126,6,3,7,4,3,4,5.432063620767476,5.194583433645743,5.548432640578031,5.011541709487821,5.348034486358548,5.923790841926763,5.588958368379883,62511.53086419753,3,4,3,6,4,4,5,1.0,0,-2,0,-1,0,1,1
2075,5.8073680275364925,5.292556362044542,5.644001044725117,4.785479758915148,5.576875584466117,6.174983892225681,5.738483967637658,28121.248120300752,7,E01002127,5,5,3,7,7,8,5.733408767785599,5.2586558283264955,5.735912847874769,4.828436510776406,5.522757325599443,6.205394753769262,5.9397453816969,36770.985074626864,7,5,7,2,8,8,9,1.0,0,0,2,-1,1,1,1
2076,5.73291926824746,5.116172592179114,5.7251907877561425,4.856974913292572,5.555863651908746,6.1867413500777815,5.600220792433795,52374.02521008404,6,E01002128,2,6,4,6,8,6,5.730596419303648,5.113662539951263,5.783282147299859,4.868093686719095,5.461675988089654,6.249668415515654,5.795162404737165,67679.08870967742,7,3,7,3,7,9,8,1.0,1,1,1,-1,1,1,2
2077,5.5346480044249065,5.248732231264917,5.566307947568804,4.956377518734085,5.403030928050246,5.840022011337993,5.424046638524421,53916.839252336445,4,E01002129,4,4,6,3,2,3,5.491489863137476,5.195633486720199,5.536877897241916,5.009514005175566,5.3401772907064275,5.861364816500392,5.504486308201125,69432.84837545126,4,4,3,6,3,2,3,1.0,0,0,-1,0,0,0,0
2078,5.380160520137367,5.223073452205981,5.586952242305723,5.031614331370693,5.361219035871958,5.9319942138962825,5.379794889587467,51340.82627118644,2,E01002130,4,4,7,2,3,2,5.323545872282099,5.238139824955551,5.537378077153806,5.114746522903443,5.210483251236103,5.831576665242513,5.416216987150687,66439.62222222223,2,5,3,7,1,2,2,1.0,0,1,-1,0,-1,-1,0
2079,5.09455397345803,5.498976388844577,5.407640370455655,5.2153499624945905,5.336940650506453,5.889653658866882,5.22776244987141,27902.963636363635,0,E01002131,8,1,9,2,3,0,5.102635386586189,5.462955085436503,5.40478547612826,5.304382881522178,5.142633827527364,5.834904932975769,5.402940035859744,37216.13333333333,0,9,1,9,0,2,2,1.0,0,1,0,0,-2,-1,2
2080,5.875740595628743,5.212515352961414,5.606335892115619,4.7448479991807675,5.576077711612061,6.03218294205821,5.510736932730615,57651.89473684211,7,E01002132,4,4,2,7,5,4,5.7320561865878,5.221394248470861,5.552656832245478,4.8668410462955025,5.422794659232253,5.982935496889022,5.572940924619263,74365.41850220265,7,5,4,3,6,5,5,1.0,0,1,0,1,-1,0,1
2081,5.489890843449217,5.4283104282436945,5.452525487090602,5.074670950571696,5.363971454446966,5.85837723125111,5.379315199274005,58185.84848484849,3,E01002133,7,2,8,2,2,2,5.420020043849945,5.2302645697043495,5.475774946121069,5.037353066297678,5.35430025213804,5.825044688506004,5.430548682426795,75006.30769230769,3,5,2,6,4,2,2,1.0,0,-2,0,-2,2,0,0
2082,6.028257352700505,5.407066635517259,5.215402102840997,4.753789870850163,5.605932058448001,5.8680083560202405,5.379457310073734,59191.455958549224,8,E01002134,7,0,2,7,2,2,6.0393263882997505,5.392304155815161,5.285713839759096,4.803341068719563,5.444772153379814,5.936818714917561,5.544858203550275,77237.88038277513,9,8,0,1,6,4,4,1.0,1,1,0,-1,-1,2,2
2083,5.530198256396715,5.293577675046867,5.486592521880592,4.928883201583138,5.47257931671995,5.912442685505531,5.463555463199509,61707.95530726257,3,E01002135,5,3,5,4,3,3,5.600320453303201,5.343183401652745,5.485712065583184,4.939672346342178,5.381621155852363,5.922562802405585,5.546626042752039,79658.72857142857,5,7,2,4,5,4,4,1.0,2,2,-1,-1,1,1,1
2084,5.620685020866602,5.420426172406777,5.5682801928209225,4.932045199300932,5.500763725975285,6.093294652907745,5.443234417749488,57113.57065217391,5,E01002136,7,4,5,5,6,3,5.602814190166512,5.273452065040156,5.597486237889712,4.8923317777741815,5.479645878383794,6.123632011954317,5.622779951882117,73515.98453608247,5,6,4,3,7,7,5,1.0,0,-1,0,-2,2,1,2
2085,5.809623673558235,5.320454609890779,5.4661034767826395,4.793140392750502,5.532642823954423,5.8232801121970015,5.3409623596817255,56054.09375,7,E01002137,6,2,3,6,2,2,5.777855116518299,5.219700935497955,5.513350959998279,4.810337421283051,5.515222274478356,5.857282696057804,5.515555366199819,72365.08040201005,7,5,3,2,8,2,4,1.0,0,-1,1,-1,2,0,2
2086,5.465613488259354,5.404375521148124,5.622774131898957,5.022574157249637,5.450214353034167,6.10828146895742,5.540898715577474,57225.29268292683,3,E01002138,7,5,7,4,6,5,5.63994316969599,5.21348979643413,5.762619486876896,4.936249742337636,5.522148774351392,6.153792304652078,5.702011939457485,73710.64285714286,6,5,7,4,8,8,7,1.0,3,-2,2,-3,4,2,2
2087,5.406655264080019,5.547474983043241,5.343124244446145,5.112739462601511,5.425659232569816,5.873142891360405,5.224314224451108,46567.406015037595,2,E01002139,9,1,8,3,2,0,5.390583430465899,5.507943310235676,5.354520104433361,5.161892322333236,5.2539185881614685,5.877381505150544,5.389767364451759,60354.99342105263,3,9,1,8,2,3,1,1.0,1,0,0,0,-1,1,1
2088,5.534993226145521,5.401305387049545,5.474896182248622,4.998001393712597,5.514115150328036,5.984665797080523,5.487606250209573,45340.87037037037,4,E01002140,7,2,7,5,4,4,5.433587211301957,5.304841477295448,5.647440280037364,4.962522880784396,5.418321686914598,6.021026675728546,5.62077233640627,58676.75862068965,3,6,5,4,6,6,5,1.0,-1,-1,3,-3,1,2,1
2089,5.625597224070158,5.454748090981059,5.498794436454773,4.980477665201088,5.541389615549518,6.049456662525332,5.550828385215274,44132.40462427746,5,E01002141,8,3,6,6,5,5,5.608598777954591,5.393376088397388,5.529895638399583,4.964952809287903,5.4599367533138095,6.081380807142207,5.758490930904042,57090.49732620321,5,8,3,5,7,7,8,1.0,0,0,0,-1,1,2,3
2090,5.747988557247888,5.377867362612769,5.446080910591852,4.878770112991333,5.5082084496816,5.960753812676384,5.477809464931488,45108.719047619044,6,E01002142,6,2,4,5,4,4,5.687992064438203,5.355745207895792,5.5370803036878815,4.887505398447818,5.435638503881278,6.061228797299221,5.719381624906599,58397.95154185022,6,7,3,3,6,6,7,1.0,0,1,1,-1,1,2,3
2091,5.481845244117405,5.3622212150822515,5.38613032154415,5.052561955866606,5.436838003863459,5.974970268166584,5.529223563360131,46451.54782608696,3,E01002143,6,1,7,3,4,5,5.442266856503283,5.2141528180521775,5.654393630150037,4.973030336901673,5.426834760568081,5.995708790599791,5.613376569544148,60050.179487179485,3,5,5,5,6,5,5,1.0,0,-1,4,-2,3,1,0
2092,6.164504033980114,5.465005400019648,5.134286634849779,4.718983735515799,5.68145631437813,5.763604414768708,5.410832084420122,45878.07692307692,9,E01002144,8,0,1,9,1,3,6.12474032102546,5.3948982914416606,5.248014739855309,4.763442763433835,5.511985641839292,5.835472438624179,5.391589859801984,59262.31296891747,9,8,0,1,8,2,2,1.0,0,0,0,0,-1,1,-1
2093,5.771426727825945,5.524205522103743,5.3052180632948875,4.925642578439279,5.542211268435825,5.93589343807914,5.426691426472231,44270.09659090909,6,E01002145,8,0,5,6,3,3,5.666081816919388,5.430344038624917,5.411694483603201,4.937782791353041,5.464780995153611,5.980203627001854,5.583140956970953,57255.83870967742,6,8,1,4,7,5,5,1.0,0,0,1,-1,1,2,2
2094,5.953201911117457,5.271005540708952,5.718046360378024,4.65612109477007,5.757265309744243,6.227212516567375,5.677002530309219,47467.43670886076,8,E01002146,5,6,1,9,8,7,5.920890748500824,5.181801446386285,5.753049678093678,4.735734997568904,5.607248575300784,6.28544561927383,5.906511299513482,61462.9527027027,8,4,7,0,9,9,9,1.0,0,-1,1,-1,0,1,2
2095,6.136342282627904,5.330949066406072,5.49568909101708,4.659880331505176,5.72473418712616,6.098017491850742,5.485743422840917,47180.186046511626,9,E01002147,6,3,1,9,6,4,5.953522711551836,5.344368093706704,5.528753722242534,4.807939542925417,5.601698402113515,6.148129646414019,5.681670783775781,61124.28078817734,9,7,3,2,9,8,7,1.0,0,1,0,1,0,2,3
2096,5.824490579874706,5.444017379595761,5.428594643556619,4.9003016661994065,5.588825594523788,6.0370494826433525,5.469993842301992,47502.426160337556,7,E01002148,7,2,5,7,5,4,5.82887767443136,5.475371381314862,5.506715859685626,4.834299951541324,5.548758914991587,6.100514986935784,5.661458473245637,61500.252100840335,8,9,3,2,8,7,6,1.0,1,2,1,-3,1,2,2
2097,5.877826979740914,5.42227881189455,5.550156083131701,4.729285097492792,5.642659897631314,6.13662222012337,5.595786344202072,47876.16580310881,7,E01002149,7,4,2,8,7,6,5.820627243263917,5.422047615801014,5.546385867040862,4.860376754646781,5.491162250626762,6.18930977095598,5.80118546096034,62034.012578616355,8,8,3,2,7,8,8,1.0,1,1,-1,0,-1,1,2
2098,5.831758517559951,5.327994782265609,5.640421739438685,4.780844073954636,5.59140305257425,6.07669861723737,5.623949602367432,47908.4918699187,7,E01002150,6,5,2,7,6,6,5.725687579258339,5.315285285869678,5.623340987242186,4.885652369135744,5.474294722497047,6.033797625478331,5.617389555160816,62064.48601398602,7,6,5,3,7,6,5,1.0,0,0,0,1,0,0,-1
2099,5.161479303140959,5.49931449468056,5.282263917215703,5.198870664578306,5.213898423756139,5.718639965833089,5.153291641810294,48340.64114832536,0,E01002151,8,0,9,0,1,0,5.228799932769367,5.542934110122068,5.255258181797607,5.239434435963631,5.149613814162357,5.774814648287637,5.26554762678487,62429.62053571428,1,9,0,9,0,1,0,1.0,1,1,0,0,0,0,0
2100,6.063319637877116,5.379026975676911,5.5932738464590495,4.652862158996799,5.730189846590232,6.151453815930263,5.701026380344589,48764.729857819904,9,E01002152,7,4,1,9,7,7,6.0075670652611315,5.343877477978551,5.618526832447496,4.774138531573983,5.616156488241152,6.1998743012894035,5.807666347747626,63127.5488372093,9,7,5,1,9,8,8,1.0,0,0,1,0,0,1,1
2101,5.751842576671731,5.254640334031799,5.706833957271143,4.833834151652726,5.623816957527941,6.227475014599887,5.710303569381887,53296.505681818184,6,E01002153,4,6,4,8,8,7,5.6497634347904935,5.262338622902217,5.683775276280521,4.902083978894051,5.591739105374626,6.249883716695764,5.79700960269135,68839.80898876404,6,6,6,3,9,9,8,1.0,0,2,0,-1,1,1,1
2102,5.6139894359894384,5.457331258832044,5.301120503258159,4.958926703183706,5.449114787669582,5.900612474397849,5.4494085521188405,49174.412213740456,4,E01002154,8,0,6,4,3,3,5.650903044372308,5.464755210720125,5.363326364267068,4.993674813333105,5.380147712347937,5.958170830617186,5.374877220294515,63779.42622950819,6,9,1,5,4,4,1,1.0,2,1,1,-1,0,1,-2
2103,5.800797112974297,5.387906131974185,5.471686830961082,4.7965340834544845,5.618354070617492,6.119057190944871,5.557387961920007,50237.4859437751,7,E01002155,7,2,3,8,7,5,5.8598869438458205,5.394932127536688,5.563359482844073,4.838053008667509,5.563134792603944,6.217891787227831,5.746571295691612,65067.31203007519,8,8,4,2,8,9,8,1.0,1,1,2,-1,0,2,3
2104,5.902870049969903,5.128876577574632,5.709637041749625,4.729730005921988,5.65841683354871,6.280547944430647,5.9558469361272355,50483.668965517245,8,E01002156,2,6,2,8,9,9,5.826912539846757,5.173030060880325,5.7553865068099075,4.776550518239246,5.604511860538931,6.28491595212151,5.979810530648512,65437.76470588235,8,4,7,1,9,9,9,1.0,0,2,1,-1,1,0,0
2105,5.579031381665207,5.203653865471119,5.707763174685036,4.960980194370921,5.500264360410411,6.051773620814812,5.710744073478187,52215.29268292683,4,E01002157,4,6,6,5,5,7,5.609436660143682,5.133058317823906,5.654195188786942,4.935851183929884,5.491912289850974,6.070107880355306,5.689950558491525,67425.60693641618,5,3,5,4,7,7,7,1.0,1,-1,-1,-2,2,2,0
2106,5.851556742101684,5.208900943734592,5.707772855471847,4.696041141237531,5.721430629715884,6.308688478362291,5.866711523299827,53705.03007518797,7,E01002158,4,6,1,9,9,9,5.7166863246397535,5.139903646165674,5.765604883974249,4.909402930736542,5.633002957430753,6.304176696864041,5.977245679768649,69314.87272727273,7,3,7,3,9,9,9,1.0,0,-1,1,2,0,0,0
2107,5.572769758601983,5.258451543748379,5.659528848197725,4.864457998010847,5.466777765088612,6.222034350037575,5.611766383879715,52193.6875,4,E01002159,4,5,4,4,8,6,5.577401237999833,5.071387594978281,5.811379973520369,4.97212294524148,5.4500004765171335,6.139272025767589,5.589459180831909,67444.78523489933,5,2,8,5,6,8,5,1.0,1,-2,3,1,2,0,-1
2108,5.518420651242449,5.229983810778265,5.615845761099062,4.980447959232997,5.365381289195348,6.0026944067094705,5.382856192288699,52776.944055944055,3,E01002160,4,5,6,2,5,2,5.5194426659080715,5.146385234263208,5.6142598787943525,5.005504471560319,5.319072850048542,6.037827004988988,5.535452293025123,68204.57638888889,4,4,5,5,3,6,4,1.0,1,0,0,-1,1,1,2
2109,5.561190411874226,5.4100487342902595,5.467673357895443,4.960069245100021,5.415705846888678,6.078896348817008,5.534371676615306,51972.90714285714,4,E01002161,7,2,6,3,6,5,5.450603745121887,5.2158870481062625,5.624505910320559,5.085036092910213,5.388424377510513,5.966043460196343,5.607085427512294,67257.84782608696,3,5,5,7,5,4,5,1.0,-1,-2,3,1,2,-2,0
2110,5.608169391369208,5.299902228208689,5.516404705934035,4.8936479198626985,5.41791696808277,6.061133474875719,5.422934606289252,50661.78846153846,4,E01002162,5,3,5,3,6,3,5.552762851323167,5.186942606756132,5.5899459319571925,5.022126820805955,5.4212148785591125,6.054014718695862,5.57720379960047,65377.349315068495,5,4,4,6,6,6,5,1.0,1,-1,1,1,3,0,2
2111,5.743680152923438,5.175696565087434,5.630410751719384,4.781261012053034,5.574808503412138,6.241765152876544,5.81700753786002,51349.40127388535,6,E01002163,3,5,2,7,8,9,5.7230649682191705,5.062276081396983,5.783746276146326,4.868018542344753,5.602982430886,6.252007469152793,5.800602349715355,66439.69230769231,7,2,7,3,9,9,8,1.0,1,-1,2,1,2,1,-1
2112,5.912980858687383,5.071207505882166,5.809295907901351,4.748518240679601,5.579147675994095,6.315299769116056,5.844188527696452,51589.21656050955,8,E01002164,2,7,2,7,9,9,5.903735283882387,5.008610396231375,5.843036039413945,4.699457921520356,5.561162082610592,6.354362570854925,5.924414415513316,66754.5870967742,8,2,8,0,8,9,9,1.0,0,0,1,-2,1,0,0
2113,5.32415244066053,5.346386385460694,5.48935002171331,5.087973115344842,5.4098800122737885,5.972518417570326,5.470597969988982,26764.131944444445,1,E01002165,6,3,8,3,4,4,5.275149751029558,5.229165232421567,5.556558047365022,5.2486446927857875,5.323261867433587,6.003162284825472,5.5325603141080615,35080.70469798658,1,5,4,9,3,5,4,1.0,0,-1,1,1,0,1,0
2114,5.260584893164697,5.333803123467929,5.439420110219485,5.219369095641297,5.352463148631059,5.960941136657418,5.556376166931995,26369.616883116883,1,E01002166,6,2,9,2,4,5,5.284649702864633,5.175302189840397,5.505502841842007,5.196554285539707,5.4344955246213456,6.006370455446378,5.4981785836354105,34527.380281690144,1,4,3,9,6,5,3,1.0,0,-2,1,0,4,1,-2
2115,5.53611917584856,5.30681291250425,5.599903218100004,4.975696328644441,5.509913558157805,6.069297897481473,5.725099130211589,26049.065420560746,4,E01002167,5,4,6,5,6,8,5.417971559245177,5.222681291175611,5.574339784757055,5.094389649352642,5.35793663757016,5.960994103942254,5.693135926217744,34366.83838383838,3,5,4,7,4,4,7,1.0,-1,0,0,1,-1,-2,-1
2116,5.422747468526384,5.388101882639185,5.445751274581504,4.993552569794444,5.291414967680399,5.903413964583811,5.545904148996404,25721.849557522124,2,E01002168,7,2,6,1,3,5,5.407476980178083,5.359538429096097,5.498399453084977,5.103858663410437,5.245339798145607,5.980714221469691,5.714582644525121,33770.34426229508,3,7,3,7,2,5,7,1.0,1,0,1,1,1,2,2
2117,5.298514346766278,5.3537249749268945,5.539575767710926,5.0279201957268445,5.302224091398037,5.9652378869250535,5.356793448207824,26122.317073170732,1,E01002169,6,3,7,1,4,2,5.372110486888199,5.267020456224895,5.579656024630979,5.083573332793421,5.305338227491585,6.0291919022155325,5.495188463506081,34300.28057553957,2,6,4,7,3,6,3,1.0,1,0,1,0,2,2,1
2118,5.506271447258434,5.215971667191078,5.541705931740245,4.970793056762082,5.435075800994347,6.1018583418309005,5.746836554044965,25961.816091954024,3,E01002170,4,3,6,3,6,8,5.56542383869992,5.105460779576362,5.64114652706098,5.056703550906121,5.434891652457321,6.138536670539953,5.635174945939945,34077.93670886076,5,3,5,6,6,8,6,1.0,2,-1,2,0,3,2,-2
2119,5.344870855331421,5.254854837417603,5.460298185348511,5.08745428276062,5.378587785720825,6.008407752990722,5.539675187110901,26642.208,1,E01002171,4,2,8,2,5,5,5.3165007061428495,5.118286006538956,5.622415825172707,5.093733401651735,5.416315112290559,6.0083618128741225,5.5816812391634345,34880.044444444444,2,3,5,7,5,5,5,1.0,1,-1,3,-1,3,0,0
2120,5.4110673201903134,5.4409711679429495,5.330405449139253,5.140255321073168,5.390368504378632,5.854917358806115,5.430300381347423,28167.221374045803,2,E01002172,7,1,9,3,2,3,5.38825145078032,5.347605249653124,5.500867457422491,5.174613031622481,5.194591353200886,5.85887746778253,5.489730683091569,36386.760273972606,3,7,3,8,1,2,3,1.0,1,0,2,-1,-2,0,0
2121,5.56241668317769,5.270824187510723,5.505817057313146,5.0277308265905125,5.51774800709776,6.082593716479637,5.6222667347740485,26546.97972972973,4,E01002173,5,3,7,5,6,6,5.5209024586374795,5.1709140293181886,5.616039161644284,5.07950666972569,5.378334951779199,6.180342704530746,5.848004157581027,34858.9126984127,4,4,5,7,4,8,9,1.0,0,-1,2,0,-1,2,3
2122,5.457496675311542,5.253356546652122,5.582124346592387,4.934721002813245,5.46215915386794,6.100181235641729,5.633731330027346,26774.131147540982,3,E01002174,4,4,5,4,6,6,5.49706279895675,5.091397164573132,5.693628003059978,5.077421653438622,5.445019938576389,6.202590051671149,5.828893603573383,35796.94366197183,4,3,6,7,6,8,8,1.0,1,-1,2,2,2,2,2
2123,5.524566151514775,5.212327255922205,5.582852698173843,4.949617147445679,5.476707982415912,6.089524792022064,5.674818913475806,26828.201680672268,3,E01002175,4,4,6,4,6,7,5.382370187355591,5.166234775706455,5.5716427747193755,4.975895717337325,5.338485737104674,5.992998505497838,5.606471976718387,35196.51351351351,3,4,4,5,3,5,5,1.0,0,0,0,-1,-1,-1,-2
2124,5.568188555656918,5.254617242586045,5.59846822231535,4.893793483575185,5.586592055502392,6.080960716520037,5.7508245214583384,27289.285714285714,4,E01002176,4,4,5,7,6,8,5.5634270503108665,5.09816941372434,5.754978330511796,4.935104146935886,5.523676158790302,6.103324320083274,5.978348001501614,35643.406015037595,5,3,7,4,8,7,9,1.0,1,-1,3,-1,1,1,1
2125,5.337418518709333,5.224740514594518,5.592003557119477,5.053539142180025,5.448241165514743,6.053236752413632,5.648116224267509,42361.752808988764,1,E01002177,4,4,7,4,5,7,5.3005327842174434,5.334692545426198,5.501369843116174,5.211991361063769,5.282169896313268,5.9882985771211805,5.647472960317237,54871.529914529914,2,7,3,9,2,5,6,1.0,1,3,-1,2,-2,0,-1
2126,5.50852593091818,5.233403010246081,5.626416122811472,5.02045584947635,5.584723904601529,6.2436789528936405,5.7837078224899425,31777.94017094017,3,E01002178,4,5,7,7,8,8,5.474755416656363,5.03227099776268,5.782119568051963,4.95105148286655,5.427463753470059,6.2716830023403825,5.888888046659273,41168.3275862069,4,2,7,4,6,9,9,1.0,1,-2,2,-3,-1,1,1
2127,5.294018363371128,5.281192890609183,5.495516608401043,5.159403880631052,5.353265162212093,5.84243551289163,5.266836743820004,50164.06341463415,1,E01002179,5,3,9,2,2,1,5.270057689059865,5.195483848809055,5.489538008516485,5.189929951891374,5.241401443070772,5.838738095817384,5.414827100397868,64849.63636363636,1,4,2,8,1,2,2,1.0,0,-1,-1,-1,-1,0,1
2128,5.533680643710791,5.380253359909457,5.514402469415315,4.985189786756226,5.378924270574959,5.9732273061862164,5.377504017964708,44049.58638743455,3,E01002180,7,3,6,2,4,2,5.362543178232093,5.2788581811545185,5.470095140369315,5.048567577412254,5.2198865183612755,5.890037051941219,5.509047283415208,57834.54385964912,2,6,2,6,1,3,3,1.0,-1,-1,-1,0,-1,-1,1
2129,5.513900136190747,5.316359750808231,5.423840664051197,5.09519835565456,5.410705472426439,5.968694283848717,5.3748350206506315,49817.920634920636,3,E01002181,5,2,8,3,4,2,5.345187434917543,5.3093273255883195,5.432300601935968,5.160577039020818,5.2888266482004305,5.891920811374013,5.405887587477522,64106.21951219512,2,6,2,8,2,3,2,1.0,-1,1,0,0,-1,-1,0
2130,5.663061096243663,5.244919477260276,5.6282134872593295,4.916847798105788,5.478339464697119,6.2158835097535015,5.627993711870011,51393.260273972606,5,E01002182,4,5,5,4,8,6,5.54233133206602,5.0914469398436,5.699170542545006,4.961680045675059,5.410520213549255,6.174578629947099,5.687316420039193,66545.79016393442,5,3,6,4,5,8,7,1.0,0,-1,1,-1,1,0,1
2131,5.6435750471918205,5.189675942399448,5.6117074399962465,4.925959238432403,5.4744779095613865,6.098379079560588,5.701078178291034,43206.0,5,E01002183,3,5,5,4,6,7,5.615322709083557,5.102200291774891,5.763182589742873,4.904961271639223,5.4354309894420485,6.083504796911169,5.677812104754977,56451.525925925926,5,3,7,3,6,7,6,1.0,0,0,2,-2,2,1,-1
2132,5.567414361419099,5.404336036154718,5.459202695976604,4.882474311373451,5.512647634202784,6.037260557665969,5.612153632171227,36995.53787878788,4,E01002184,7,2,4,5,5,6,5.593802348348021,5.327852938011403,5.571329984956115,4.97817725443658,5.371586844211317,6.061817070910039,5.5949813245817,47517.7786259542,5,7,4,5,4,6,5,1.0,1,0,2,1,-1,1,-1
2133,5.580837667965498,5.489086015302627,5.410231648898516,4.8928715019929605,5.490128298274806,6.0579482258343305,5.517995285206154,49050.54918032787,4,E01002185,8,1,5,5,6,4,5.36971742692201,5.414422211439713,5.368264865184176,5.085461112900057,5.392887249373008,5.96037018817404,5.494832094164862,63477.536231884056,2,8,1,7,5,4,3,1.0,-2,0,0,2,0,-2,-1
2134,5.821405775643684,5.289027047318381,5.533101167227771,4.760943565014246,5.618550009018666,5.966778007713524,5.609598389348468,50284.73648648649,7,E01002186,5,3,2,8,4,6,5.691783361672038,5.388340120816099,5.45586450719043,4.93091663734689,5.414106174068556,5.97233137702415,5.608590250515806,64903.82872928177,6,8,2,4,5,5,5,1.0,-1,3,-1,2,-3,1,-1
2135,5.9347067922353745,5.3943072575330735,5.415367830991745,4.706159336566925,5.7055405873060225,5.995571562051773,5.5225141453742985,49024.73,8,E01002187,7,2,1,9,4,4,5.784404071284012,5.496237499053489,5.356235942930123,4.844867387847721,5.453772082575051,5.929714323769153,5.5517370135571475,63503.07042253521,7,9,1,2,6,4,4,1.0,-1,2,-1,1,-3,0,0
2136,6.223454316457112,5.267117351009732,5.582001655442374,4.545478351910909,5.819122485887437,6.206550183750334,5.801249707312811,49535.29523809524,9,E01002188,5,4,0,9,8,8,6.07696120103999,5.233891266674252,5.624462162429963,4.713294524643289,5.6362476468685285,6.181284981756354,5.830339617465609,64035.69849246231,9,5,5,0,9,8,8,1.0,0,0,1,0,0,0,0
2137,6.044496568851173,5.283549463842064,5.612641353160143,4.671970197930932,5.69047436863184,6.122332401573658,5.680611625313759,51780.52734375,9,E01002189,5,5,1,9,7,7,5.986957578974612,5.169803419095628,5.627626117538004,4.806223717244232,5.576595636413378,6.106395062278299,5.76808771271916,66901.3419117647,9,4,5,1,9,7,8,1.0,0,-1,0,0,0,0,1
2138,5.885851871378068,5.551784791420621,5.337206008316446,4.78554799212249,5.589354234956517,5.919225042763772,5.4866727558832205,48415.26615969582,7,E01002190,9,1,3,7,3,4,5.833751872289095,5.51300318635625,5.322324565417475,4.862425628754733,5.487751033666322,5.9602778378150445,5.473423450970821,62682.712230215824,8,9,0,2,7,4,3,1.0,1,0,-1,-1,0,1,-1
2139,5.723102382522948,5.297992548409929,5.554850199755202,4.763891800921014,5.588070634197681,6.108397745071573,5.514600646622638,56956.57978723404,6,E01002191,5,4,2,7,6,4,5.67281065078882,5.2791163348234615,5.512516789711439,4.901357506903318,5.421510539375818,6.103774313743298,5.828059637202666,73450.58173076923,6,6,3,3,6,7,8,1.0,0,1,-1,1,-1,1,4
2140,5.935875114467409,5.336080146056634,5.609631057138796,4.699553816406815,5.6701078078261125,6.118697506410104,5.590232345792982,53687.65740740741,8,E01002192,6,5,1,8,7,6,5.760212757085499,5.3942871261061285,5.526109100433818,4.89678608743768,5.467509750211448,6.000468427151964,5.622045282209129,69233.1447368421,7,8,3,3,7,5,5,1.0,-1,2,-2,2,-1,-2,-1
2141,5.829735645010501,5.347103822080395,5.59459248449229,4.746958483623553,5.598922097230259,6.173046149785006,5.680240705797944,54201.6835443038,7,E01002193,6,4,2,7,7,7,5.768266678583331,5.275950812711948,5.640247449642274,4.909641134302791,5.479189507118085,6.17220862464207,5.781724203650544,69964.62195121951,7,6,5,3,7,8,8,1.0,0,0,1,1,0,1,1
2142,6.011931222332411,5.317443599878263,5.643858564294074,4.656661725241291,5.716280623900989,6.235118717201485,5.695060591067165,54572.96280991736,8,E01002194,5,5,1,9,8,7,5.966435211971714,5.360448118034267,5.603512275169085,4.819653829271324,5.569540761005928,6.154751013512392,5.883418551049971,70355.40585774058,9,7,5,2,9,8,9,1.0,1,2,0,1,0,0,2
2143,5.591672569657294,5.369758205137391,5.547503633775573,4.89168728031398,5.540125949371264,6.087887310175504,5.5670619494673135,54866.9806763285,4,E01002195,6,4,5,6,6,5,5.5253946822088675,5.350877980305913,5.532126448696775,5.0109531306401855,5.396664187120265,6.130313912174732,5.704397232747385,70694.81974248927,4,7,3,6,5,7,7,1.0,0,1,-1,1,-1,1,2
2144,5.841416329855011,5.247086287963958,5.673829151051385,4.791624790855816,5.600957485891524,6.2623854492391855,5.676811532605262,55224.767857142855,7,E01002196,4,6,3,7,8,7,5.669865475459532,5.301175681704825,5.652905827218836,4.9100998822938315,5.489149164747108,6.237839265303179,5.8448345397006385,71101.93181818182,6,6,5,3,7,9,9,1.0,-1,2,-1,0,0,1,2
2145,5.49628366175152,5.463591443640845,5.573274138427916,4.990607094197046,5.453525199776604,6.050902650469825,5.403443847383771,41665.95238095238,3,E01002197,8,4,6,4,5,2,5.427674940262718,5.202057225950833,5.720976750055949,4.995660890107867,5.545405914043558,6.160620774345836,5.568716974093996,53986.75862068965,3,4,7,5,8,8,4,1.0,0,-4,3,-1,4,3,2
2146,5.036301882475015,5.582721906220353,5.485532224578345,5.255297125585927,5.225122054151241,5.805081257084072,5.297190689400539,38503.87248322148,0,E01002198,9,3,9,0,2,1,4.959638135213601,5.378171832153671,5.59842931440002,5.297601014375687,5.245742330425664,5.746210852735921,5.3608457838234145,49915.49342105263,0,7,4,9,2,1,1,1.0,0,-2,1,0,2,-1,0
2147,5.333727748544367,5.3003427144643425,5.586689220892416,5.027244210243225,5.448351168417716,6.039928917412285,5.611833478953387,29806.054054054053,1,E01002199,5,4,7,4,5,6,5.354465516753819,5.27211303503617,5.711074837394382,5.07471081070278,5.422069714380347,6.113939409670622,5.7250405653663305,38242.53043478261,2,6,6,7,6,7,7,1.0,1,1,2,0,2,2,1
2148,5.160182176681047,5.508377409383153,5.442814915367727,5.1868224418565125,5.319397986604926,5.81130661589376,5.3543353013778,39176.89887640449,0,E01002200,8,2,9,1,2,2,5.382919992215535,5.363135978315004,5.678968050070768,5.136301146456476,5.437420948017278,5.926615050558508,5.474181970195658,50691.83431952663,3,7,6,8,6,4,3,1.0,3,-1,4,-1,5,2,1
2149,5.381311494496561,5.261995960627833,5.489106395552235,5.079558643602556,5.35147427551208,5.98108446790326,5.569306727378599,37936.3870967742,2,E01002201,5,3,8,2,4,5,5.430222572220696,5.323044935862224,5.637720973403366,5.070125296380785,5.451352313712791,6.007748443109018,5.5990071711716825,49533.18518518518,3,7,5,7,6,5,5,1.0,1,2,2,-1,4,1,0
2150,5.144247939640826,5.400553479113362,5.473589847033674,5.204496162858876,5.246145372363654,5.769745049151507,5.345516218380495,35304.625,0,E01002202,7,2,9,0,1,2,5.188519581550975,5.318292075743055,5.466722909645115,5.184700630705453,5.236662383036763,5.7326647139450895,5.270208227794801,45680.21524663677,0,6,2,8,1,1,0,1.0,0,-1,0,-1,1,0,-2
2151,5.183919384584322,5.51699284537808,5.361928200983739,5.179056513440478,5.294504523932279,5.761375439036024,5.371560987535414,39952.67032967033,0,E01002203,8,1,9,1,1,2,5.151182622473857,5.358852290260005,5.528668400599872,5.220942550504268,5.2850924579020075,5.821805972133191,5.364170828446519,51846.97969543147,0,7,3,9,2,2,1,1.0,0,-1,2,0,1,1,-1
2152,5.56985788145465,5.344411106166725,5.593366239599125,4.988896849626553,5.505309853011263,5.982801741468692,5.527422038380971,57323.77844311377,4,E01002204,6,4,6,5,4,5,5.603990479863645,5.162353386355854,5.610727113007493,5.085824164660168,5.482640587327852,6.018434895241814,5.6337925894853935,73921.4135021097,5,4,5,7,7,6,6,1.0,1,-2,1,1,2,2,1
2153,5.73857252036824,5.2112340045576335,5.733004273486738,4.890460119527929,5.598184793937106,6.1541953968400716,5.758443272414327,57040.57142857143,6,E01002206,4,6,5,7,7,8,5.671717339974863,5.1014044902942794,5.735554198865537,5.036708392037285,5.521734518475003,6.117797953994186,5.798991148560136,73438.74074074074,6,3,7,6,8,7,8,1.0,0,-1,1,1,1,0,0
2154,5.651107868151878,5.121832814679217,5.8276342349265935,4.775494615533459,5.603503645356022,6.227610972390246,5.706191633174669,59918.34328358209,5,E01002207,2,8,2,7,8,7,5.659751939146142,5.0889932756361205,5.776184657686635,4.865106841451244,5.537374642334487,6.200763031056053,5.836840900935624,77714.01315789473,6,3,7,3,8,8,9,1.0,1,1,-1,1,1,0,2
2155,5.8087867223299465,5.304763087859521,5.500053293429888,4.733645961070672,5.598937502274146,6.170966970614898,5.716406647975628,55706.942307692305,7,E01002208,5,3,2,7,7,7,5.722732038759604,5.424706021460091,5.525434835654933,4.8478995474373425,5.45282275793029,6.175168389227332,5.766108987534919,71722.35975609756,7,8,3,2,6,8,8,1.0,0,3,0,0,-1,1,1
2156,5.590476724429008,5.262627446957124,5.624074155245072,4.873334622994447,5.4917550270374,6.035511708870912,5.629952258941454,56219.24102564102,4,E01002209,5,5,4,5,5,6,5.489836065159287,5.3116595234981805,5.578185115304104,4.97572213660839,5.3940244641414905,6.019604882528616,5.587783996448961,72254.02790697674,4,6,4,5,5,6,5,1.0,0,1,-1,1,0,1,-1
2157,5.648828498191303,5.35567561040322,5.609208106994629,4.7928132737676306,5.499532613489363,6.067168893085586,5.622864115569326,59715.65277777778,5,E01002210,6,5,3,5,6,6,5.36899428195264,5.292767679834941,5.548930993999344,5.095609890409262,5.288001157433154,5.994580780167177,5.68715922731951,77388.7469879518,2,6,4,7,2,5,7,1.0,-3,0,-1,4,-3,-1,1
2158,5.543287973146181,5.43507220508816,5.526290554184097,4.983498431540824,5.436039544440605,6.015002455797282,5.496366767195968,58165.56756756757,4,E01002211,7,3,6,3,5,4,5.454048007972969,5.367399185157019,5.6024301387061755,4.9927369168967255,5.457219644026323,6.057990751975824,5.613498466073974,75115.62809917355,3,7,4,5,7,6,5,1.0,-1,0,1,-1,4,1,1
2159,5.527439443619697,5.456819841494927,5.46160695710025,5.113326288186586,5.361383943112342,5.884350897191645,5.389355856638688,59880.857142857145,3,E01002212,8,2,8,2,3,2,5.578199097322761,5.366207454182686,5.509119071544857,5.027599357136893,5.365714968891319,5.940418176694748,5.4945238746634315,77769.42660550459,5,7,3,6,4,4,3,1.0,2,-1,1,-2,2,1,1
2160,5.3205717032955535,5.425905576957169,5.50895821150913,5.202655223749018,5.309232674619203,5.845513695029802,5.323233251289655,58275.17741935484,1,E01002213,7,3,9,1,2,1,5.346592833694903,5.255750174082599,5.55443756615074,5.064269974972438,5.359103528041284,5.950814668414663,5.533588127025123,75229.26699029126,2,5,4,7,4,4,4,1.0,1,-2,1,-2,3,2,3
2161,5.21379569039416,5.482821434291441,5.461237903851182,5.055873264127703,5.303844600471098,5.949968540846412,5.347628361253596,60134.91044776119,0,E01002214,8,2,7,1,4,2,5.3915939787765605,5.277816647058957,5.662987922693228,5.006751147183505,5.387626071254928,6.002310169207585,5.5046163983159255,77834.08441558441,3,6,6,5,5,5,3,1.0,3,-2,4,-2,4,1,1
2162,5.454916648326382,5.475263219687246,5.505984290953605,5.055987418659272,5.329098955277474,6.078845000074756,5.553521766777961,62916.596774193546,3,E01002215,8,3,7,1,6,5,5.483148451451655,5.360020269880762,5.485369680644749,5.03892516673028,5.366481515911076,6.010830192299156,5.601639632578497,82031.78321678322,4,7,2,6,4,5,5,1.0,1,-1,-1,-1,3,-1,0
2163,5.612245197508745,5.32523606385395,5.661906849047181,4.869348149390737,5.484249247107536,6.1377272712197275,5.65441613440301,59962.68789808917,4,E01002216,6,5,4,5,7,7,5.616313611974522,5.203283844553694,5.774035169153797,4.904653313208599,5.526745049320922,6.142441283683388,5.862216988388373,77431.1530612245,5,4,7,3,8,8,9,1.0,1,-2,2,-1,3,1,2
2164,5.049238281291828,5.5120911859629445,5.325068026258235,5.228535796466627,5.240421250201108,5.726153257646058,5.165015873156096,57504.81578947369,0,E01002217,8,1,9,0,1,0,5.332874790710561,5.300157990525751,5.528962315881953,5.064658221076517,5.322887990404578,5.928346203530536,5.47479452455745,74190.83823529411,2,6,3,7,3,4,3,1.0,2,-2,2,-2,3,3,3
2165,5.623307011217834,5.363707455532197,5.559453517980548,4.974272887838826,5.470042020864459,6.0624213044914494,5.48565899387393,62772.30903790087,5,E01002218,6,4,6,4,6,4,5.715947881418997,5.179566977535867,5.686979981617154,4.9909530665862,5.563646297804348,6.131197798314519,5.755712237033545,81764.98429319372,7,4,6,5,8,8,8,1.0,2,-2,2,-1,4,2,4
2166,5.31677813150666,5.250159928292939,5.644023260383895,5.073001254688609,5.321997357137276,5.892217042771253,5.305905806295799,61677.13636363636,1,E01002219,4,5,8,1,3,1,5.388022897657284,5.08305762523462,5.752710237975948,4.991774719608717,5.321294244655893,5.961453822033464,5.489303593793191,80169.04958677686,3,2,7,5,3,4,3,1.0,2,-2,2,-3,2,1,2
2167,5.487966061496048,5.304040380519071,5.546253485645321,4.962855949676294,5.4873114781414,6.124575048899479,5.684662639665946,63877.74820143885,3,E01002220,5,4,6,5,7,7,5.676596669589772,5.224399379321507,5.731895056091437,4.914620652920058,5.568985975089193,6.235506201992516,5.769430545197816,83208.7731092437,6,5,7,4,9,9,8,1.0,3,0,3,-2,4,2,1
2168,5.335469236373902,5.295919272422791,5.539443487167358,5.109499786376953,5.351109517097473,5.885637815475464,5.40038871383667,63243.008,1,E01002221,5,3,8,2,3,2,5.24878837261349,5.19935198687017,5.602801248431206,5.099447792395949,5.352967945858836,5.876091133803129,5.488580298610032,82384.265625,1,4,5,7,4,3,3,1.0,0,-1,2,-1,2,0,1
2169,5.665196055836148,5.25293653011322,5.668166655964321,4.8965439173910354,5.540190829171075,6.234011446105109,5.717315981123183,63770.02222222222,5,E01002222,4,5,5,6,8,7,5.569115208495747,5.200502572276376,5.760949652845209,4.998665259101174,5.481007168509743,6.21595841104334,5.71336851011623,83068.47272727273,5,4,7,5,7,8,7,1.0,0,0,2,0,1,0,0
2170,5.239611492573636,5.494401351919452,5.522575681649365,5.172596227775499,5.372176524504875,6.009137901287635,5.52667891632006,62741.58252427184,1,E01002223,8,3,9,2,5,5,5.246899863621136,5.301795012242085,5.699864166276949,5.031192977149208,5.315430946178265,6.064678537953007,5.656567367347511,81685.47747747747,1,6,6,6,3,6,6,1.0,0,-2,3,-3,1,1,1
2171,5.392149656448725,5.510583709995702,5.317263721295123,5.14532732963562,5.255903498181757,5.863228134389193,5.356183169023046,63355.53773584906,2,E01002224,8,1,9,0,2,2,5.455256865949047,5.398144740231183,5.493633104830372,5.144458025085683,5.316761968087177,5.989984283641893,5.475296775905454,82571.24489795919,3,8,3,8,3,5,3,1.0,1,0,2,-1,3,3,1
2172,6.108942708344135,5.392643231211356,5.210013948308611,4.741033179088704,5.656832898994094,5.829883455362134,5.440677123741039,44215.01699029126,9,E01002225,7,0,2,8,2,3,6.044764262023303,5.403453583625867,5.2471972449506215,4.790188311387023,5.506511697094504,5.883886814689179,5.506557326808536,57270.05995203837,9,8,0,1,8,3,3,1.0,0,1,0,-1,0,1,0
2173,5.742317454959199,5.406568381559608,5.444812446575,4.79935798899241,5.5198069061944395,5.929413849750926,5.486410768987122,42090.90201729107,6,E01002226,7,2,3,6,3,4,5.738605024183498,5.297391433926189,5.495079595551771,4.920582343199674,5.467031594234355,5.9411627229522255,5.570512254448498,54380.68823529412,7,6,3,4,7,4,4,1.0,1,-1,1,1,1,1,0
2174,5.8393029892083375,5.442003493598013,5.3913125139294245,4.770882805188497,5.550154680194277,6.018684586611661,5.434296736572728,44140.24848484848,7,E01002227,7,1,2,6,5,3,5.716443053700707,5.4354336735877125,5.404906355521896,4.906875650313768,5.4072990864515305,6.010706931352615,5.491744875907898,57059.443181818184,7,8,1,3,5,5,3,1.0,0,1,0,1,-1,0,0
2175,5.876567998690585,5.476382844118892,5.385326999001922,4.803749005664842,5.549931029395578,5.979728733645324,5.501392404404644,42866.87447698745,7,E01002228,8,1,3,6,4,4,5.776825845742426,5.372506955591571,5.419071943319144,4.83362929660733,5.431185415312021,6.038908471580313,5.65184699887989,55513.56722689076,7,7,1,2,6,6,6,1.0,0,-1,0,-1,0,2,2
2176,5.74363229803538,5.471608471777652,5.365880600673216,4.898853263966305,5.497674932739614,5.929912535596914,5.464446638344791,41656.023346303504,6,E01002229,8,1,5,5,3,3,5.811036983761219,5.312477596309207,5.527980756322179,4.780030464907305,5.523169008416867,6.077048123429675,5.573475752948621,54000.550458715596,8,6,3,1,8,7,5,1.0,2,-2,2,-4,3,4,2
2177,5.701746548657642,5.466749725541519,5.417184874649447,4.88075091826354,5.496033134260727,6.018013719488813,5.543335226817905,43315.17277486911,5,E01002230,8,2,4,5,5,5,5.438295415469578,5.3508782317398715,5.341387667983928,5.040147022595481,5.402332655336491,5.902893008378448,5.54635580948421,56027.386243386245,3,7,1,6,5,3,4,1.0,-2,-1,-1,2,0,-2,-1
2178,5.592404422486664,5.275400244506302,5.573021020099616,4.954492074668787,5.47066080418362,6.11639212043422,5.802341793752779,43588.85350318471,4,E01002231,5,4,6,4,7,8,5.642326005144057,5.046466750257156,5.712634817447538,4.914035555583979,5.5021434515909435,6.228510947009317,5.968859274402942,56413.464052287585,6,2,6,3,7,9,9,1.0,2,-3,2,-3,3,2,1
2179,5.363007823936641,5.331701734103262,5.516729075461626,4.980924452655017,5.460214382968843,6.067285731434822,5.5345693891867995,45329.5390625,2,E01002232,6,3,6,4,6,5,5.5085013917655,5.179597457578359,5.689939565895018,4.978208694576232,5.432955393121262,6.062551591021956,5.592928506126088,58655.31404958678,4,4,6,5,6,6,5,1.0,2,-2,3,-1,2,0,0
2180,5.5806226806276165,5.259615289937159,5.539570158454263,4.884541849421847,5.469497006410246,6.077821380773168,5.571206147503701,44500.00636942675,4,E01002233,4,3,5,4,6,5,5.569688295686482,5.043127687561591,5.705827346700707,4.974485409970315,5.473987400926502,6.059570306184276,5.598249915419825,57547.682119205296,5,2,6,5,7,6,5,1.0,1,-2,3,0,3,0,0
2181,5.298540505744119,5.392760233114694,5.496775705395764,5.0552761682117255,5.358384574642618,6.031995369277838,5.4830543094008934,45499.48091603054,1,E01002234,7,3,7,2,5,4,5.282245198142863,5.297906143643032,5.52985991495792,5.111548310128327,5.25577322010682,5.880798736465311,5.37107852797642,58891.92523364486,1,6,3,7,2,3,1,1.0,0,-1,0,0,0,-2,-3
2182,5.225013150888331,5.5163227810579185,5.392251551151276,5.1552149945614385,5.235646106448828,5.8682806959339215,5.426429653868956,43964.78431372549,0,E01002235,8,1,9,0,2,3,5.317375646054166,5.280644048764867,5.545049146541114,5.135290256981711,5.250297073021676,6.037100990999092,5.48537003993988,56891.28155339806,2,6,3,8,2,6,3,1.0,2,-2,2,-1,2,4,0
2183,5.48426794337335,5.272214077343451,5.485233244494857,5.052483658924281,5.351924326932319,5.979715610218939,5.311420783818325,46245.457943925234,3,E01002236,5,3,7,2,4,1,5.434321576118469,5.176402042388916,5.625149702072144,4.983498197555542,5.291115947723389,5.913308364868164,5.441761815071106,59549.688,3,4,5,5,2,3,2,1.0,0,-1,2,-2,0,-1,1
2184,5.850688684614081,5.2044520842401605,5.724972165258307,4.780933804261057,5.545550731608742,6.212400122692711,5.574681422584935,55358.063157894736,7,E01002237,4,6,2,6,8,5,5.739210902943331,5.134353552145116,5.739721250534058,4.8474429214701935,5.2829972168978525,6.212363021513995,5.765400460187126,71344.56470588235,7,3,7,2,2,8,8,1.0,0,-1,1,0,-4,0,3
2185,5.600181140190314,5.24618385744489,5.637540590664572,4.8663702956901105,5.494654460386797,6.13528456372663,5.384683561719154,53191.48760330579,4,E01002238,4,5,4,5,7,2,5.556932642478351,5.244954756064009,5.662252137827319,4.992847191270932,5.339961977892144,6.087815155354581,5.614012523214947,68707.41085271318,5,5,6,5,3,7,5,1.0,1,1,1,1,-2,0,3
2186,5.832897488788892,5.435599152118929,5.4854928748582,4.8358044367964546,5.589003759045755,6.202071757085862,5.750574866930644,54709.18817204301,7,E01002239,7,3,4,7,8,8,5.571866892632984,5.3010949623017085,5.491502433731442,4.98350107783363,5.482987022967565,6.065664106323606,5.626759611424946,70803.90476190476,5,6,2,5,7,6,6,1.0,-2,-1,-1,1,0,-2,-2
2187,5.830386314475746,5.274632696519818,5.651557857530159,4.805381503021508,5.527026791321604,6.219991620172534,5.4579711347295525,55171.89473684211,7,E01002240,5,5,3,6,8,3,5.700469553955203,5.215870415292135,5.633205782107221,4.914349642226367,5.3981712746426345,6.128346309429261,5.6070947530792985,71299.39024390244,7,5,5,3,5,7,5,1.0,0,0,0,0,-1,-1,2
2188,5.376585209811175,5.4691864879043015,5.519517613340307,4.9752787996221475,5.432164542763322,6.032797548505995,5.484390802736636,56972.99259259259,2,E01002241,8,3,6,3,5,4,5.3933817192689695,5.3010579801317474,5.583474048927648,5.03945173345395,5.373942892942855,6.167115102952986,5.662630840023952,73330.96268656716,3,6,4,6,4,8,6,1.0,1,-2,1,0,1,3,2
2189,5.6101265564376925,5.375381232779703,5.637590461307102,4.965921381373464,5.540098647276561,6.179819367550038,5.587096563091984,53010.11111111111,4,E01002242,6,5,6,6,7,6,5.561721449479078,5.216746646624345,5.666726268254793,5.092666434171872,5.4691628744969005,6.214610925087562,5.606686892417761,68509.08333333333,5,5,6,7,7,8,5,1.0,1,-1,1,1,1,1,-1
2190,5.239071579968057,5.379446627890191,5.444852195134977,5.136192245454323,5.316268770433053,5.8052242456412895,5.201110995397335,153674.5975609756,1,E01002243,7,2,8,1,2,0,5.17967975942582,5.3907903482259245,5.410354048476935,5.330872391172024,5.168991529879793,5.7654816239609,5.320441614160884,193892.35751295337,0,8,1,9,0,1,1,1.0,-1,1,-1,1,-1,-1,1
2191,5.313372386745149,5.495040418911565,5.3156674303160125,5.084985188911298,5.303028858512457,5.854567570920371,5.237566441114695,154140.35582822087,1,E01002244,8,1,8,1,2,1,5.328388070095481,5.479696656927208,5.431500972350898,5.134701159648124,5.205743678732414,5.8940361028461785,5.42223220822439,194455.31791907514,2,9,2,8,1,3,2,1.0,1,1,1,0,0,1,1
2192,5.319174492642993,5.43744779981318,5.478160105290867,5.0345702930575325,5.291868653325808,5.930928619134994,5.278972736426762,154103.7142857143,1,E01002245,7,2,7,1,3,1,5.256476149055528,5.356415219928907,5.495479383824034,5.07828570522877,5.233039383562455,5.9519711636608434,5.403743081951734,194430.70186335404,1,7,3,7,1,4,2,1.0,0,0,1,0,0,1,1
2193,5.178404337281634,5.517004290963434,5.348344963826951,5.15903810710664,5.275165096969362,5.805890772752701,5.133591209247613,153999.03184713377,0,E01002246,8,1,9,1,2,0,5.1225233828579935,5.498645343898255,5.30053742137956,5.317863043443657,5.126909970501323,5.734812526055324,5.333287299415211,194401.0987654321,0,9,0,9,0,1,1,1.0,0,1,-1,0,-1,-1,1
2194,5.236914296807914,5.4225484009446765,5.41609835953548,5.089559350342586,5.282342470103297,5.922092311135653,5.213732566504643,156237.95862068966,0,E01002247,7,2,8,1,3,0,5.129529148140209,5.415706026474101,5.445199196770687,5.235336266108007,5.1625406414070385,5.824116041196272,5.3696712751516555,196859.0,0,8,2,9,0,2,1,1.0,0,1,0,1,-1,-1,1
2195,5.240712562644923,5.487933797416864,5.2862078889652535,5.170747933012468,5.278610586568162,5.6793120139174995,5.268826508411655,168488.86574074073,1,E01002248,8,0,9,1,0,1,5.158281970424812,5.479439114823061,5.266939575431728,5.30171554829894,5.156973550800516,5.694778627708178,5.315818602798366,212145.83193277312,0,9,0,9,0,0,1,1.0,-1,1,0,0,-1,0,0
2196,5.131245096342279,5.58673205506911,5.2004381932249855,5.317347165641435,5.154636404929905,5.577560941013721,5.113462270946678,161969.29357798165,0,E01002249,9,0,9,0,0,0,5.228320541534018,5.393098026302689,5.453971711879081,5.181650972112696,5.213238259579273,5.8412173977980375,5.423861975788225,203206.2730496454,1,8,2,8,1,2,2,1.0,1,-1,2,-1,1,2,2
2197,5.287679479627187,5.665383792275866,5.1916666136586604,5.198542182081439,5.276006322776156,5.6794561887609545,5.113347352431913,157782.62561576354,1,E01002250,9,0,9,1,0,0,5.247592912529999,5.574906223225144,5.163583477713027,5.305869259361951,5.162618626963417,5.719037837015008,5.288935239022633,198902.0754716981,1,9,0,9,0,0,0,1.0,0,0,0,0,-1,0,0
2198,5.468816477586241,5.320614426451571,5.5909346324556015,5.0571399988497,5.388872126446051,6.045427790459464,5.440550036290112,171817.75735294117,3,E01002251,6,4,8,3,5,3,5.352271661058173,5.43246066570282,5.480079508327938,5.055329831330092,5.368647221918707,5.985394447833508,5.469321734421737,216629.4825174825,2,8,2,6,4,5,3,1.0,-1,2,-2,-2,1,0,0
2199,5.424281850130207,5.5718240902341645,5.127996837831216,5.05952433471022,5.193970301308228,5.741389435660503,5.125456822703251,656213.2601880878,2,E01002252,9,0,8,0,1,0,5.365333255235251,5.616067598005394,5.090896238754322,5.12297621756405,5.2261645182386625,5.8256168071325725,5.2780063461947755,833510.0194805195,2,9,0,8,1,2,0,1.0,0,0,0,0,1,1,0
2200,5.8735992223566225,5.389286238930442,5.4447581746361475,4.850397269075567,5.497223951599815,6.026412565924905,5.479752043810758,541337.0763636364,7,E01002253,7,2,4,5,5,4,5.702176360856919,5.440236225960747,5.342103034257889,4.904994852959164,5.458515234409817,5.9981434307401145,5.564110654687124,689932.3174603175,7,8,1,3,7,5,4,1.0,0,1,-1,-1,2,0,0
2201,5.665147335720465,5.395312414893621,5.5231304017803335,4.9262001222699,5.464602874804147,5.991245158110993,5.573746570554967,544788.552742616,5,E01002254,7,3,5,4,4,5,5.529383188825313,5.371107574885453,5.492029946994006,4.931700594541503,5.464541853927985,6.08319475204964,5.628530103016675,693780.8089430894,4,7,3,4,7,7,6,1.0,-1,0,0,-1,3,3,1
2202,5.311263605526515,5.47490596635001,5.371199328558785,5.206137097222465,5.222556764738901,5.733252882276263,5.1664484473637176,548642.2628571428,1,E01002255,8,1,9,0,1,0,5.227066445681784,5.493398234248161,5.352505896654394,5.167948282427258,5.2255669674939575,5.892269598113166,5.452946812742287,698529.4652777778,1,9,1,8,1,3,2,1.0,0,1,0,-1,1,2,2
2203,5.480181260477929,5.3867198051441285,5.446692658322198,5.077137465987887,5.344835386389778,6.007687405461357,5.37858071852298,548222.130952381,3,E01002256,7,2,8,2,5,2,5.249291875205198,5.466047938053425,5.340541619520921,5.083966401252118,5.310514486098027,6.013759259339217,5.541203146452432,703317.510989011,1,9,1,7,3,5,4,1.0,-2,2,-1,-1,1,0,2
2204,5.961063423847182,5.353563960321349,5.631522742871246,4.8070625180033,5.539237401604113,6.151315958791189,5.754651938628287,547300.8280542986,8,E01002257,6,5,3,6,7,8,5.899656090353217,5.3768155846212595,5.664914361600365,4.82625458549176,5.573936051023858,6.204549199768475,5.83619470681463,696945.9642857143,8,7,6,2,9,8,9,1.0,0,1,1,-1,3,1,1
2205,5.426511356678414,5.5203875972869545,5.365597467726849,5.053661598550512,5.336262894691305,5.935330305708216,5.25801220295277,539508.5382978723,2,E01002258,8,1,7,2,3,1,5.139223492301707,5.57150047470909,5.275935051222556,5.25614163344604,5.262599924766341,5.914751251712116,5.450090137111047,687360.5807860262,0,9,0,9,2,3,2,1.0,-2,1,-1,2,0,0,1
2206,5.649774876945222,5.646988329598722,4.978888363047031,5.058263746077705,5.219000332825922,5.667135700516637,5.103502234535902,553834.66367713,5,E01002259,9,0,8,0,0,0,5.71625419805556,5.642211121855471,5.049876045867703,5.033049345799035,5.211346283261572,5.7265869032110635,5.263798558738091,708575.487964989,7,9,0,6,1,1,0,1.0,2,0,0,-2,1,1,0
2207,5.195807452755745,5.596717549092842,5.138341658645206,5.253077600339447,5.248395518221036,5.681559494047454,5.081951583274687,329520.8080808081,0,E01002260,9,0,9,0,0,0,5.33198494537204,5.582322568285699,5.277315068478678,5.167611887057622,5.217479610559987,5.758052738858204,5.341846767009473,400782.6274509804,2,9,0,8,1,1,1,1.0,2,0,0,-1,1,1,1
2208,5.068143329450062,5.3902605303696225,5.494370625132606,5.148654895169394,5.244946685575304,5.807646627227466,5.132303461432457,544600.619047619,0,E01002261,7,3,9,0,2,0,4.983231972598429,5.496896023270469,5.385972048501548,5.310773099743345,5.137511701703821,5.749139487368506,5.314161261672494,693656.2704402516,0,9,1,9,0,1,1,1.0,0,2,-2,0,0,-1,1
2209,5.28655833077718,5.432904002178146,5.506150657872119,5.076823945505073,5.307864405304553,5.963236740554672,5.461028962968344,530827.5361445784,1,E01002262,7,3,8,1,4,3,5.15613379213545,5.54461500512229,5.413586157560348,5.15712641676267,5.218225244018766,5.831526950995127,5.547441307703654,666847.8888888889,0,9,1,8,1,2,4,1.0,-1,2,-2,0,0,-2,1
2210,5.360528674236564,5.636387422472931,5.179540869247082,5.163521435648896,5.181739081892856,5.689356168480806,5.077858408107314,542910.6744186047,2,E01002263,9,0,9,0,0,0,5.251137092028777,5.601002709514598,5.159309103404205,5.229126886062816,5.21267239635971,5.831982341514626,5.459678524641821,691672.6243654822,1,9,0,9,1,2,3,1.0,-1,0,0,0,1,2,3
2211,5.405339205229247,5.556015060470627,5.309569460493666,5.0957896100866185,5.259854535798769,5.835525518423086,5.202977726767371,543464.8528528529,2,E01002264,9,1,8,0,2,0,5.22676322869728,5.566077988571916,5.275729245203404,5.148211145693539,5.33296894807757,5.777920690782231,5.294252274226557,692377.245398773,1,9,0,8,3,1,0,1.0,-1,0,-1,0,3,-1,0
2212,5.2437008093762145,5.733029262353015,5.156750489947616,5.262964149957062,5.149193779755664,5.702649163943465,5.205024846779403,547466.1290322581,1,E01002265,9,0,9,0,0,0,5.281647343436877,5.721714052557945,5.269993009169896,5.1854187170664465,5.211984942356746,5.857783649365107,5.357107618451119,696244.2083333334,1,9,0,8,1,2,1,1.0,0,0,0,-1,1,2,1
2213,5.325678695221336,5.536426488842283,5.255085724957135,5.077909711064125,5.219469160449748,5.687299599452895,5.2485880018497,415372.61734693876,1,E01002266,9,0,8,0,0,1,5.307320481691605,5.536504539465293,5.35300888526134,5.091878020457733,5.272853354918651,5.8364361322843115,5.4083859125773115,529973.8564102564,2,9,1,7,2,2,2,1.0,1,0,1,-1,2,2,1
2214,5.147943160336489,5.643262266353437,5.194622167356455,5.344712562621779,5.090541302018864,5.631039409880426,4.998820144659395,543785.1719745223,0,E01002267,9,0,9,0,0,0,5.000718555667183,5.711261600255966,5.161413661458275,5.478026037866419,5.048577934503555,5.613677843050524,5.4027025306766685,692678.0227272727,0,9,0,9,0,0,2,1.0,0,0,0,0,0,0,2
2215,5.640223245665501,5.514789760952264,5.321688039202086,4.9832984774325375,5.440154587159134,5.964888348825661,5.4180100188009055,539337.9953051644,5,E01002268,8,1,6,4,4,3,5.6171009744387215,5.476496669294921,5.451624840652387,4.935743412205593,5.476180360724889,6.017404599510944,5.52641958152692,687451.829015544,5,9,2,4,7,5,4,1.0,0,1,1,-2,3,1,1
2216,5.407558748091774,5.517418970093416,5.236961750235137,5.081814978771283,5.241173717710707,5.818617635759814,5.1825897086169075,538461.6973180077,2,E01002269,8,0,8,0,2,0,5.500716352269717,5.505553400468247,5.305570608208536,4.9641671957757305,5.359731903442969,5.927940244134138,5.481137251081737,686427.6761133603,4,9,0,5,4,4,3,1.0,2,1,0,-3,4,2,3
2217,6.0863081627334195,5.29861272210317,5.5409269490778845,4.675929261359158,5.633573239212794,6.159732858866255,5.627997512848961,540122.3311258279,9,E01002270,5,3,1,8,7,6,5.922899059823289,5.2728405809894054,5.546206189185074,4.832471293272431,5.5681559691314435,6.164988126951394,5.83081206791999,688399.4398625429,8,6,3,2,9,8,8,1.0,-1,1,0,1,1,1,2
2218,5.870629287617547,5.306407517194748,5.547741168311664,4.817812793595451,5.590712188822883,6.1239121292318615,5.591307600906917,539370.5464285715,7,E01002271,5,4,3,7,7,6,5.818656911758276,5.3702313955013565,5.515007009873023,4.825051254492539,5.5602398505577675,6.160532636825855,5.860434289161976,687463.8923076923,8,7,3,2,8,8,9,1.0,1,2,-1,-1,1,1,3
2219,5.509448360072242,5.183635904391607,5.6301173435317144,4.9893549382686615,5.385413650671641,6.067285947004954,5.477745870749156,534383.9722222222,3,E01002272,3,5,6,2,6,4,5.379723999303641,5.2473414736924715,5.554758821566081,5.077470714898453,5.298451403981631,6.0611414897073175,5.628776134903898,681429.4484536082,2,5,4,7,3,6,6,1.0,-1,2,-1,1,1,0,2
2220,5.737300311659907,5.38776981347316,5.441700989061648,4.892095950272706,5.435836092845814,6.056964107461877,5.487313950383985,544984.5810810811,6,E01002273,7,2,5,3,6,4,5.58585802511293,5.406898053324952,5.436377514381798,4.988207201568448,5.454356654566162,6.079271494125833,5.746609589883259,695317.6275510204,5,8,2,5,6,7,8,1.0,-1,1,0,0,3,1,4
2221,5.623489947045952,5.265852263845536,5.553736952432977,4.859398198022716,5.383422264968771,6.086732396995443,5.5187726997593956,538858.2907488986,5,E01002274,5,4,4,2,6,4,5.525852799415588,5.335386744490615,5.466587721764505,4.991312706792677,5.349190796280767,6.106048967387225,5.723624161771826,686839.2612612613,4,7,2,5,4,7,7,1.0,-1,2,-2,1,2,1,3
2222,5.612057726545985,5.318743996352077,5.420093085392412,4.888870653857189,5.435860721940497,6.038479316665466,5.5118924149547714,547737.751004016,4,E01002275,5,2,5,3,5,4,5.649601024792607,5.347308669771467,5.375216722488403,4.917803328288229,5.437763564568713,6.115712673144233,5.782447520503424,697124.6165413534,6,7,1,4,6,7,8,1.0,2,2,-1,-1,3,2,4
2223,5.727578696393702,5.5933243159666075,5.009262069095746,4.939864405201896,5.228089204997981,5.734730917953519,5.1755302573748745,594160.2754158964,6,E01002276,9,0,6,0,1,0,5.598796264185169,5.640778281097489,4.988300222691482,5.134644902576276,5.144451555924687,5.687259431776962,5.267528214832631,741325.1544715447,5,9,0,8,0,0,0,1.0,-1,0,0,2,0,-1,0
2224,5.526543737971593,5.620717375619071,5.069893007808261,5.081176440299504,5.233337923080202,5.724008669550456,5.274502120320759,532170.7904761905,3,E01002277,9,0,8,0,1,1,5.360565595812612,5.726773647905945,5.010528969300258,5.2473050355911255,5.040297243889276,5.688420710625587,5.3060721224778655,678901.4837662338,2,9,0,9,0,0,1,1.0,-1,0,0,1,0,-1,0
2225,5.42874320538458,5.45026182343146,5.333975136636973,5.0335606572156895,5.276767786391481,5.881399283152141,5.332976830219794,531653.0,2,E01002278,8,1,7,1,3,1,5.341182520476783,5.495696179750489,5.361400622420195,5.111758964817699,5.208933761933955,5.84511071588935,5.509177378038081,678221.9390243902,2,9,1,7,1,2,3,1.0,0,1,0,0,0,-1,2
2226,5.664231277614659,5.479185526081593,5.436791329025533,4.886383264740078,5.355498032073754,5.951397855846868,5.536369767492217,532712.4682080925,5,E01002279,8,2,5,2,4,5,5.3774615534093995,5.4727909651813125,5.2912983894348145,5.136888393503151,5.1378458533066,5.849561932860621,5.582767852884254,679552.2715231788,2,9,0,8,0,2,5,1.0,-3,1,-2,3,-2,-2,0
2227,5.36936840057373,5.435046778678894,5.428606712341309,5.115003222465515,5.204502064704895,5.828471570968628,5.26269596862793,528894.424,2,E01002280,7,2,8,0,2,1,5.1038498227376055,5.45927917526429,5.308433929121638,5.128978846063576,5.0730386048435685,5.850003012691635,5.440972172112828,675025.6546184738,0,8,0,8,0,2,2,1.0,-2,1,-2,0,0,0,1
2228,5.70737418643931,5.475227534452224,5.322150540861854,4.908764623065683,5.456814041749679,5.818707951887406,5.342245726661886,532838.8288770054,6,E01002281,8,1,5,4,2,2,5.504338260547656,5.473355513783128,5.22779845687705,5.1051204909741035,5.172913253027509,5.788578506366748,5.447833760803294,679791.3661971831,4,9,0,7,0,1,2,1.0,-2,1,-1,2,-4,-1,0
2229,5.375132942434602,5.490658284995356,5.3457529632916,5.067176259797195,5.221645959492387,5.7882206557419495,5.278480350090365,529001.6453201971,2,E01002282,8,1,8,0,1,1,5.1821147308117,5.480471677314944,5.351039064221266,5.150609407192324,5.135285703728838,5.827098568474375,5.412460521953862,675142.8682926829,0,9,1,8,0,2,2,1.0,-2,1,0,0,0,1,1
2230,5.503191836351572,5.550355767787889,5.314402248970298,5.061259824869245,5.309855897066205,5.840197399605152,5.434592812560325,532491.3313953489,3,E01002283,9,1,8,1,2,3,5.349485450166307,5.5719520204616355,5.18630575160591,5.222803192305495,5.174132994938175,5.758550231032747,5.3391881885751,679290.7055393585,2,9,0,9,0,1,1,1.0,-1,0,-1,1,-1,-1,-2
2231,5.46832945301202,5.521821421299254,5.364794491580799,4.960685890257073,5.306794090134105,5.931348460713072,5.4272455986607016,529176.062200957,3,E01002284,8,1,6,1,3,3,5.355116554160617,5.535630583170041,5.249054571882409,5.1323466650882175,5.2096797026211945,5.977028483775125,5.496026860540779,675508.3631840796,2,9,0,8,1,5,3,1.0,-1,1,-1,2,0,2,0
2232,5.42685765965941,5.560542242176036,5.374702328957882,5.064712636966996,5.3438974643116675,5.907248637397882,5.430179454348414,551598.0609137056,2,E01002285,9,1,8,2,3,3,5.220675057268398,5.486354263708553,5.358463725941704,5.195656367801727,5.318532980062107,5.913215449787079,5.5747493307858225,702115.4759358289,1,9,1,9,3,3,5,1.0,-1,0,0,1,1,0,2
2233,5.323708901318108,5.495709450506583,5.457744650724457,5.035353820498397,5.331637041597832,5.919643109891473,5.265795429305332,552183.0975609756,1,E01002286,8,2,7,1,3,1,5.177295767456476,5.513460585676088,5.407277853211011,5.210294241554166,5.222424500559005,5.919932485358116,5.636954004047839,702748.0920245398,0,9,1,9,1,4,6,1.0,-1,1,-1,2,0,1,5
2234,5.206660746711574,5.4883258163112485,5.508752215398501,5.189936410074365,5.291703383400016,5.921829625351788,5.44722988507519,550086.5821917808,0,E01002287,8,3,9,1,3,3,5.207798110587256,5.4330704501697,5.5584772399493625,5.221957240785871,5.293747816767011,5.942816873959132,5.5932972473757605,700491.0428571429,1,8,4,9,2,4,5,1.0,1,0,1,0,1,1,2
2235,5.277179931470861,5.699539491643456,5.277899395732979,5.193258591971472,5.243224652649845,5.800572577571369,5.456284575437376,552011.9581151833,1,E01002288,9,0,9,0,1,3,5.21317819403667,5.5029107490006615,5.333648419847675,5.184624473838245,5.228440104746351,5.8795935628460905,5.641321895169277,702791.1225490196,1,9,1,8,1,3,6,1.0,0,0,1,-1,1,2,3
2236,5.406854276684509,5.394660188548866,5.4919559517125975,5.0658252465313875,5.306075664087274,5.9890675777676465,5.378758410612742,549341.1954022988,2,E01002289,7,3,8,1,4,2,5.248903527945101,5.331960217681473,5.43438112093303,5.18891934720342,5.335141117701274,6.008454813928661,5.501810143093863,699368.6706586826,1,7,2,8,3,5,3,1.0,-1,0,-1,0,2,1,1
2237,5.443834460853191,5.351444840431213,5.488228065244267,4.952167568581827,5.37162273050694,6.027977012516407,5.577700365125463,550775.3033707865,2,E01002290,6,3,6,2,5,5,5.22118191986798,5.403155741207103,5.435803172422603,5.0657017517854825,5.339468350384962,6.047094747981923,5.7007995710015935,701133.679144385,1,8,2,7,3,6,7,1.0,-1,2,-1,1,1,1,2
2238,5.44330576479992,5.362055276598886,5.506347073015766,4.959709582484771,5.3795287169028665,5.936505641892691,5.486020033047578,551889.4088785046,2,E01002291,6,3,6,2,3,4,5.369178289667182,5.216905815885701,5.513284827591082,5.029590553099956,5.367088170773393,6.000570066478274,5.569341842734485,702556.6880733945,2,5,3,6,4,5,4,1.0,0,-1,0,0,2,2,0
2239,5.4686928481506785,5.559149995982218,5.316855189611586,4.946038063910367,5.30442340211045,5.858864907738116,5.283100146612675,549566.7805755396,3,E01002292,9,1,6,1,2,1,5.385166084955609,5.462049693815292,5.3287358246152365,5.005346531432773,5.339164378151061,5.961300293604533,5.551743406625021,699610.0079365079,3,9,1,5,3,4,4,1.0,0,0,0,-1,2,2,3
2240,5.266859512444777,5.5986354261074425,5.17903200410447,5.146309369979201,5.2213986099890946,5.668997575330605,5.0924780821864495,539860.0943396227,1,E01002293,9,0,9,0,0,0,5.307155092465713,5.502673452900302,5.283430455741795,5.160200109130226,5.234261769578204,5.719048353933519,5.274423296275776,687895.8686635945,2,9,0,8,1,1,0,1.0,1,0,0,-1,1,1,0
2241,5.593043998120323,5.412007105728937,5.3308759975054905,5.001093744758576,5.353545660537387,5.871265924166119,5.333962237078046,538470.9166666666,4,E01002294,7,1,7,2,2,1,5.545994890899193,5.4308551201006265,5.448091775905795,4.9893929071542695,5.372374288434905,5.982883521211826,5.510880043351554,686455.4674796748,5,8,2,5,4,5,3,1.0,1,1,1,-2,2,3,2
2242,5.587024310247494,5.4796835034271405,5.415363590574004,4.999672964622414,5.3775650516885225,5.927098920436505,5.454433869794419,539770.3989071038,4,E01002295,8,2,7,2,3,3,5.467759480637111,5.386499992917093,5.518964905417367,5.044291944316264,5.4196504193745305,5.9663342706273115,5.579767493719466,687964.4325842697,4,8,3,6,6,4,5,1.0,0,0,1,-1,4,1,2
2243,5.754504909328691,5.5960351429016715,4.957565605932114,4.96254535872629,5.286284062057296,5.645680318648819,5.127368305285642,534820.2495921697,6,E01002296,9,0,6,1,0,0,5.869034954077968,5.539939038982841,5.0722787717725755,4.932281520751773,5.236495521237327,5.783575182601458,5.21972717801802,682512.5880217786,8,9,0,4,1,1,0,1.0,2,0,0,-2,0,1,0
2244,5.500249634038156,5.506227046696107,5.430776555146744,5.072605424852513,5.455831589983471,5.9489535093307495,5.468217754541938,533219.7313432836,3,E01002297,8,2,8,4,4,4,5.349470751499062,5.485424309524138,5.260326792944723,5.097830897836543,5.301091014449276,5.912568087008462,5.33259142601668,680348.7611940298,2,9,0,7,3,3,1,1.0,-1,1,-2,-1,-1,-1,-3
2245,5.303425535821078,5.482850342988968,5.285745408451348,5.060444190313942,5.3328162640856025,5.7894565933629085,5.288812821371513,534318.754385965,1,E01002298,8,0,8,1,1,1,5.326291567501538,5.410479933182823,5.322718404831096,5.140196664448091,5.306439697423721,5.802898122665079,5.302350352792179,680924.8021390374,2,8,0,8,3,1,1,1.0,1,0,0,0,2,0,0
2246,5.585086285325996,5.56083866075856,5.334915244727709,4.893565864483845,5.38505376473502,6.022408260844061,5.455044492646372,535371.7261410789,4,E01002299,9,1,5,2,5,3,5.603921881781684,5.482591394318475,5.306932435035706,5.0167929352654355,5.340745601124234,5.983139124976264,5.513317830297682,683186.1777777778,5,9,0,6,3,5,3,1.0,1,0,-1,1,1,0,0
2247,5.608299218325976,5.4355001710800535,5.449477961338848,4.9363063355366075,5.447561208470409,6.0066054009821315,5.418312281251429,539183.5219123506,4,E01002300,7,2,6,4,5,3,5.542753155930454,5.413741053347607,5.490968059823216,5.046902267329664,5.392614739008218,6.072021304364185,5.577287779754424,687161.032128514,5,8,2,6,5,7,5,1.0,1,1,0,0,1,2,2
2248,5.442132751380696,5.379319240766413,5.5281901555902815,4.952909398078918,5.376301968798918,6.021764145177953,5.56856071878882,531039.805882353,2,E01002301,7,3,6,2,5,5,5.182038013342839,5.5651244479379836,5.324771325299694,5.2460733059864895,5.233887457543878,5.87680969116794,5.597281866012865,677579.4394904459,0,9,1,9,1,3,5,1.0,-2,2,-2,3,-1,-2,0
2249,5.348029237985611,5.360535297791163,5.542196750640869,4.951632580492231,5.400917142629623,5.965009964836968,5.4767796993255615,532942.2666666667,1,E01002302,6,3,6,3,4,4,5.062803310249488,5.493351355897194,5.3874615886448565,5.149125923036904,5.159574016850656,5.869707800955048,5.519338077275541,680099.6439790576,0,9,1,8,0,3,4,1.0,-1,3,-2,2,-3,-1,0
2250,5.398903699124113,5.480515334961262,5.449524122096123,4.926483626568571,5.360272918863499,5.961298234412011,5.433666435708391,533076.7829787234,2,E01002303,8,2,5,2,4,3,5.396403366353089,5.595866853024536,5.296385596840929,5.0183951859866385,5.270903560506317,5.950325148446219,5.519865021561131,680153.9783549784,3,9,0,6,2,4,4,1.0,1,1,-2,1,0,0,1
2251,5.951279024701369,5.54549827471114,5.041803527924053,4.802087834006862,5.474791804322026,5.722217271620767,5.2793372208612,543173.0684210527,8,E01002304,9,0,3,4,1,1,5.933267933213049,5.578241748114427,5.039337588888076,4.914493977816568,5.341857202351093,5.697207250528866,5.26208238883151,695373.9270833334,9,9,0,4,4,0,0,1.0,1,0,0,1,0,-1,-1
2252,5.33733114096672,5.546680116762309,5.184618366363386,5.09561094029309,5.223815881498328,5.699525881575667,5.207743479780955,529763.894977169,1,E01002305,9,0,8,0,0,0,5.28650596788374,5.6647383030188285,4.983469041727357,5.325289851528103,5.007954005467689,5.5398805015167945,5.1827529401092205,675805.7245762711,1,9,0,9,0,0,0,1.0,0,0,0,1,0,0,0
2253,5.127471598825957,5.70834666929747,5.214677926113731,5.117776737715069,5.1931242616553055,5.7083252279382,5.2766144739954095,530911.7368421053,0,E01002306,9,0,8,0,0,1,4.973982240145023,5.693921608420519,5.162775278091431,5.26921314230332,5.18247765646531,5.691538526461675,5.304029818910819,677433.8846153846,0,9,0,9,1,0,1,1.0,0,0,0,1,1,0,0
2254,5.337971707752772,5.454115980012077,5.434147267682212,5.0107791636671335,5.303453098024641,5.9767238787242345,5.620152932405472,531147.7571428572,1,E01002307,8,2,7,1,4,6,5.119461888031994,5.445059874074922,5.3660755912177,5.082091722557013,5.244021772480697,5.853220505680111,5.607506035900802,677744.3237410072,0,8,1,7,1,2,5,1.0,-1,0,-1,0,0,-2,-1
2255,5.11579616622227,5.619192401083504,5.236684854437665,5.141021197162023,5.195288858035716,5.7052802726989835,5.193462886461398,534618.5365853659,0,E01002308,9,0,9,0,0,0,5.017494090605248,5.669462203979492,5.09682584119542,5.431770119682585,5.085951578345283,5.587443907796754,5.184053056014865,681809.64495114,0,9,0,9,0,0,0,1.0,0,0,0,0,0,0,0
2256,5.089698745182583,5.4999571023668565,5.254166438920158,5.155551843643188,5.233212688991002,5.74394953591483,5.154878836359297,531363.0057142858,0,E01002309,8,0,9,0,1,0,5.091408385526414,5.525178386861046,5.305656449106715,5.218991033182848,5.138421167463264,5.7943836778602344,5.408578853479168,678218.77852349,0,9,0,9,0,1,2,1.0,0,1,0,0,0,0,2
2257,5.030530435252564,5.674343291377522,5.179447451187054,5.2943311673808475,5.118656835006794,5.6607787247103545,5.056187642182355,535709.3560209424,0,E01002310,9,0,9,0,0,0,5.049612181691023,5.641751880256029,5.1694887446669435,5.340706225198049,5.049286593038302,5.647956347236266,5.199885881290986,682694.2548076923,0,9,0,9,0,0,0,1.0,0,0,0,0,0,0,0
2258,5.4244656880349575,5.572414843276078,5.175271226329054,5.027769569746792,5.280708738810111,5.782954744897035,5.229210830151254,533657.7903930132,2,E01002311,9,0,7,1,1,1,5.399001366751534,5.615503854167705,5.123722470049955,5.163679439194349,5.115625810623169,5.705510310737454,5.364984551254584,680487.306122449,3,9,0,8,0,0,1,1.0,1,0,0,1,-1,-1,0
2259,5.652418003566023,5.490822476465345,5.220784594471328,4.874317965645721,5.34219339216389,5.8235786012981245,5.378777708408338,529285.0,5,E01002312,8,0,4,2,2,2,5.477963462952645,5.578757192498895,5.15959430445907,5.1278785191556455,5.25120646274218,5.753079920686702,5.363469590422928,675481.5645161291,4,9,0,8,2,1,1,1.0,-1,1,0,4,0,-1,-1
2260,5.403860082180042,5.607030054618573,5.203702598957006,5.0538535217933465,5.234936355370019,5.723459041177346,5.158479660602626,529675.6354679803,2,E01002313,9,0,7,0,1,0,5.320417574473789,5.643695578597108,5.157844155065475,5.214048294427758,5.116742034112254,5.81179720245748,5.380335936897911,675957.9907834101,2,9,0,9,0,2,1,1.0,0,0,0,2,0,1,1
2261,5.217950859539945,5.574803298627827,5.294050470204421,5.165154359710049,5.114346401792177,5.806320175318651,5.175756274814337,529479.3873239437,0,E01002314,9,0,9,0,2,0,5.004061699783715,5.651276048952646,5.153610959540319,5.315991929847828,5.013935078669639,5.732659977717991,5.373320489904306,675727.2481751825,0,9,0,9,0,1,1,1.0,0,0,0,0,0,-1,1
2262,5.007192615226463,5.602403727284184,5.167058071383724,5.289942232767741,5.1049731925681785,5.600253568755256,5.109812650857148,529731.2666666667,0,E01002315,9,0,9,0,0,0,4.956703512441544,5.641019498545026,5.179044551319546,5.426815074587625,4.970455251988911,5.620872236433483,5.320856921256534,676017.2380952381,0,9,0,9,0,0,1,1.0,0,0,0,0,0,0,1
2263,4.9674070155934285,5.698450127714558,5.04387145607095,5.375936519942786,5.141455372697429,5.538547992706299,4.928491349283018,530642.9736842106,0,E01002316,9,0,9,0,0,0,4.79628139320347,5.712753465606107,5.02660157945421,5.497840940952301,4.844610890580548,5.48960583905379,5.073717130555047,677139.6736111111,0,9,0,9,0,0,0,1.0,0,0,0,0,0,0,0
2264,5.609869847442898,5.353398836203638,5.614561388335252,4.877615434869292,5.441447648905256,6.069158025199386,5.6569009408127835,544224.5888324874,4,E01002317,6,5,4,4,6,7,5.549082092304325,5.324314939915834,5.6238452321919965,4.928318190814263,5.444748046410144,6.084844641949064,5.623445125680473,693155.1306532663,5,7,5,4,6,7,6,1.0,1,1,0,0,2,1,-1
2265,5.3771889209747314,5.388769856270621,5.519457101821899,5.039418375667403,5.316856477190466,5.988951802253723,5.561543891535086,552705.0735294118,2,E01002318,7,3,7,1,4,5,5.306052201036094,5.293740424557009,5.5507353915684465,5.1231244413749035,5.398331217143847,6.004503098087034,5.468745781027752,703582.7463768116,2,6,4,8,5,5,3,1.0,0,-1,1,1,4,1,-2
2266,5.168079005978095,5.467520648840243,5.387014237030473,5.110496322313945,5.289200965689604,5.776914224422798,5.273486935903156,356127.4285714286,0,E01002319,8,1,8,1,1,1,5.2226628207704096,5.435413370862532,5.365420266201622,5.148413830967041,5.256617492465882,5.843723376972253,5.479772592275337,431787.9377990431,1,8,1,8,2,2,3,1.0,1,0,0,0,1,1,2
2267,5.279125416372705,5.30177468765439,5.63995005577568,5.109588743194821,5.398300918068473,5.952672489046112,5.523941912050322,544316.5275590551,1,E01002320,5,5,8,3,4,4,5.2762405333980436,5.376280591372521,5.573078143981196,5.14080778245003,5.342007184220899,6.047569915171592,5.573412273199327,693382.1209677419,1,7,4,8,4,6,5,1.0,0,2,-1,0,1,2,1
2268,5.58566419470544,5.380659707387289,5.434109527924481,4.904835948757097,5.368511151799969,6.0183108722462375,5.508521222133263,546478.3725490196,4,E01002321,7,2,5,2,5,4,5.613422656638755,5.322630291597711,5.501485372583072,4.984847911530071,5.426211841818359,6.023241364707549,5.552783855133587,696689.7256944445,5,7,3,5,6,6,4,1.0,1,0,1,0,4,1,0
2269,5.08861844463042,5.554162042207986,5.412553360184512,5.256313452758942,5.279817889014401,5.766663230566615,5.138878184628774,337920.6024096386,0,E01002322,9,2,9,1,1,0,5.207881539128721,5.4794775187037885,5.473602202255279,5.216215943917632,5.346834251191467,5.843241475522518,5.33605466876179,394983.3046875,1,9,2,9,4,2,1,1.0,1,0,0,0,3,1,1
2270,5.197939465664051,5.413998730977377,5.507655254999796,5.062178520803099,5.348391854321515,5.992531730510571,5.297892467180888,247944.8,0,E01002323,7,3,8,2,4,1,5.393498664279636,5.215884706956877,5.641345912604023,5.025612421172986,5.4577455400562975,6.043457233648506,5.424383984195242,318250.1798561151,3,5,5,6,7,6,2,1.0,3,-2,2,-2,5,2,1
2271,5.274811604528717,5.556792621179061,5.293835650068341,5.108193787661466,5.2269151232459325,5.768997540618434,5.208700256636648,543998.5515151515,1,E01002324,9,0,8,0,1,0,5.235041860636178,5.497912663143951,5.417746997498846,5.1390251385701164,5.329766405867292,5.8856840226557345,5.266066421161998,692953.1168831169,1,9,1,8,3,3,0,1.0,0,0,1,0,3,2,0
2272,5.197807439537936,5.569082201220269,5.406600638877514,5.1223096972288085,5.217646367328111,5.8219775197117825,5.284578327522722,430917.1046511628,0,E01002325,9,1,8,0,2,1,5.009187759250723,5.652120402423284,5.272854183950732,5.2607475134634205,5.081313346662829,5.755447140303991,5.23762640324972,556448.5537634408,0,9,0,9,0,1,0,1.0,0,0,-1,1,0,-1,-1
2273,5.151606053246392,5.477338292863634,5.445583273569743,5.140831056170994,5.228601343896654,5.796520241631402,5.206679684321085,539444.3733333333,0,E01002326,8,2,9,0,1,0,5.069297698625909,5.532410403705378,5.3866146676865965,5.217874207685697,5.182925299925951,5.74040842371365,5.386377472709454,687657.6343612334,0,9,1,9,1,1,1,1.0,0,1,-1,0,1,0,1
2274,5.304158157036628,5.46304757727517,5.414117864620539,5.044780159438098,5.3413679489382995,6.000974584508826,5.43026445530079,541025.6111111111,1,E01002327,8,2,7,2,5,3,5.272420634631238,5.452964895690968,5.478991743006738,5.1614308240366915,5.30349230298809,5.935626693800384,5.536455858766643,689381.7385620915,1,8,2,8,3,4,4,1.0,0,0,0,1,1,-1,1
2275,5.142858768618384,5.474295801894609,5.382415028505547,5.183691516172054,5.274758694476859,5.772850185632706,5.214152606420739,210481.88372093023,0,E01002328,8,1,9,1,1,0,5.1801375123891935,5.406432234839107,5.431364187363828,5.158751782406582,5.224992745378044,5.837752485543154,5.35592590088255,261234.70786516854,0,8,2,8,1,2,1,1.0,0,0,1,-1,0,1,1
2276,5.199877402840591,5.47095371455681,5.363044294496862,5.160839848983579,5.32233463787451,5.821178964870732,5.260447189284534,153948.99512195121,0,E01002329,8,1,9,1,2,1,5.2240036963312715,5.524672699195367,5.44885109199418,5.219990460960953,5.147609468411516,5.876200862504818,5.438166499137878,194330.08796296295,1,9,2,9,0,3,2,1.0,1,1,1,0,-1,1,1
2277,5.284765780407147,5.531151211174735,5.337218965057039,4.988824241352777,5.331848363806731,5.849172915855464,5.30263795295771,153939.0583941606,1,E01002330,9,1,6,1,2,1,5.261172100420921,5.551906893330235,5.409620548448255,5.184735012631262,5.236105145946626,5.909322711729234,5.437335624810188,194333.11290322582,1,9,1,8,1,3,2,1.0,0,0,0,2,0,1,1
2278,5.265342543033954,5.614902311335496,5.312305600916753,5.141689969542248,5.266011030947576,5.765199064557018,5.161387731468743,536156.3224043716,1,E01002331,9,1,9,1,1,0,5.131661980292376,5.596497800770928,5.21819750140695,5.305742903316722,5.129834217884961,5.686108181055855,5.215951600495507,683730.8705882353,0,9,0,9,0,0,0,1.0,-1,0,-1,0,-1,-1,0
2279,5.3504547528448825,5.394391185286417,5.428770181760623,5.029123446844906,5.345497397329077,5.937827439666483,5.490194500526252,541408.260115607,1,E01002332,7,2,7,2,3,4,5.164348167816394,5.536628162800358,5.303136562938012,5.2778816096068635,5.214484074999233,5.843592258879376,5.5098801518454765,689806.4568527918,0,9,0,9,1,2,3,1.0,-1,2,-2,2,-1,-1,-1
2280,5.349542319326472,5.352678626103509,5.520206383296421,4.957340623203077,5.452521904966885,6.0480740590203075,5.485874982704794,541376.0676691729,1,E01002333,6,3,6,4,5,4,5.444881719455385,5.384540533810331,5.484333391775165,4.985169910548026,5.340859764500668,6.032524930803399,5.615857621033986,689813.3070175438,3,8,2,5,3,6,5,1.0,2,2,-1,-1,-1,1,1
2281,5.70101899202959,5.476202812091804,5.440488800222491,4.849385729910415,5.51554270695757,6.040208391937209,5.413110254355419,502100.8765432099,5,E01002334,8,2,4,5,5,3,5.6294555172196095,5.522477899376506,5.344956885777777,4.926329668066905,5.3322680064805255,6.023431023075792,5.558005425513303,634723.1289398281,6,9,1,4,3,6,4,1.0,1,1,-1,0,-2,1,1
2282,5.239803895144395,5.427146825991886,5.406096448361034,5.134506073636069,5.357474426148643,5.932974461098792,5.28721193864312,528291.4577464788,1,E01002335,7,1,8,2,3,1,5.191132363863289,5.486905287019908,5.385510569438338,5.256643059663475,5.260577934794128,5.886599516496062,5.462498186156154,675001.796875,1,9,1,9,2,3,3,1.0,0,2,0,1,0,0,2
2283,5.362099214281355,5.484780485289438,5.498309507369995,4.995211258615766,5.421395793642317,6.039055731637137,5.3842406715665545,530522.36,2,E01002336,8,3,6,3,5,2,5.331095815356312,5.462777497989884,5.51531784521426,5.060386208888612,5.351911163069511,6.012592118945929,5.593536393889964,681965.2786885246,2,9,3,7,4,5,5,1.0,0,1,0,1,1,0,3
2284,6.0747283405407675,5.390279955014001,5.482190284123954,4.634836917197236,5.640168747152806,6.05947852999062,5.595532697853365,520521.83987915405,9,E01002337,7,2,0,8,6,6,6.000351343810648,5.420689857594101,5.420385668986937,4.813448028535943,5.483731433058711,6.107096325656224,5.770441287301581,663810.7668161435,9,8,1,2,7,7,8,1.0,0,1,-1,2,-1,1,2
2285,5.293825737386942,5.402245312929153,5.447252307832241,5.113091530650854,5.293479759246111,5.903638468682766,5.3597790949046615,197464.25,1,E01002338,7,2,8,1,3,2,5.226461578499187,5.394680028611964,5.3666672083464535,5.23071342300285,5.251125081696293,5.885822920636698,5.5191200720992954,247636.60227272726,1,8,1,9,2,3,4,1.0,0,1,-1,1,1,0,2
2286,5.718073571127568,5.31116949028946,5.606291351135838,4.782163669047743,5.5844583169124915,6.166232125040446,5.481886499806454,156748.1100478469,6,E01002339,5,4,2,7,7,4,5.592870203348307,5.319663769350602,5.473338007926941,4.964009312482981,5.407021524814459,6.101211930696781,5.82079164741131,195491.36057692306,5,6,2,5,5,7,8,1.0,-1,1,-2,3,-2,0,4
2287,5.4104688648591965,5.34660874333298,5.5865090928579635,5.028141309294784,5.381167626171782,5.976482910022401,5.392155454869856,153460.55263157896,2,E01002340,6,4,7,2,4,2,5.331107118615398,5.338577426142162,5.540595273176829,5.082109381755193,5.223134281458678,5.982213940885332,5.626778552929561,193674.32407407407,2,7,3,7,1,5,6,1.0,0,1,-1,0,-1,1,4
2288,5.418138716192472,5.445351876673245,5.378662882816224,4.9703423813695,5.3529559175173445,5.936850041151047,5.4409797085183005,533684.0357142857,2,E01002341,7,1,6,2,3,3,5.297161059876893,5.482637490962912,5.297927932505227,5.092599064294546,5.277178566880021,5.861114551684608,5.537390417847897,680661.4417177914,1,9,0,7,2,2,4,1.0,-1,2,-1,1,0,-1,1
2289,5.411433952854526,5.393922678885922,5.437459076604536,5.0446061118956536,5.348342570181816,5.883301459589312,5.470103293080483,542978.8838709678,2,E01002342,7,2,7,2,3,4,5.425122096974363,5.247738097303657,5.426258346726818,5.174638414254752,5.375825173111372,5.873407440159911,5.404089440581619,691942.6182795699,3,5,2,8,4,3,2,1.0,1,-2,0,1,2,0,-2
2290,5.423158881900547,5.606238807643856,5.321533712717864,5.04936060336259,5.343944442164791,5.827874189024573,5.340946758115614,549638.3243243244,2,E01002343,9,1,7,2,2,2,5.405564415243875,5.4391424967124395,5.393751152848775,5.021452178469802,5.423011274464362,5.913641278722645,5.403491545039995,700238.7433628319,3,8,1,6,6,3,2,1.0,1,-1,0,-1,4,1,0
2291,5.186361509673085,5.918369514560001,4.653679110249239,5.325613467842704,4.8762510187554104,5.380672709160068,4.7758689392282285,375576.54027664766,0,E01002344,9,0,9,0,0,0,5.28607305957681,5.8789299680769185,4.6855400229673485,5.356182698920564,4.956194397250754,5.484267299064851,4.972081044389611,484112.9421128799,1,9,0,9,0,0,0,1.0,1,0,0,0,0,0,0
2292,5.290239110210825,5.558114875391655,5.244003378195206,5.096506093964359,5.199210290981428,5.681200279197112,5.169546828052114,528534.4162436548,1,E01002345,9,0,8,0,0,0,5.174839985521534,5.470084012309207,5.223955702178086,5.23293410826333,5.123832676984087,5.737080172647404,5.365726179714445,666010.1097046414,0,9,0,9,0,1,1,1.0,-1,0,0,1,0,1,1
2293,5.3130066352231164,5.560024814094816,5.406163045338222,5.113498760121209,5.31962902205331,5.8959014943667825,5.400965131180627,520152.59285714285,1,E01002346,9,1,8,1,3,2,5.30893719854026,5.386847666214252,5.462765997853772,5.165282865228324,5.24848538431628,5.935668435590021,5.404491949903554,647778.0137931034,2,8,2,8,2,4,2,1.0,1,-1,1,0,1,1,0
2294,5.314350077980443,5.637443252299962,5.261691139716851,5.171620545418639,5.302736571744869,5.823929832954156,5.372924740377226,375899.42763157893,1,E01002347,9,0,9,1,2,2,5.413610582227831,5.353440481346923,5.459185769031574,5.011798076041333,5.400358205491846,5.86231761474114,5.447138523126577,493094.48051948054,3,7,2,6,5,2,2,1.0,2,-2,2,-3,4,0,0
2295,5.572345860633153,5.704867574004529,4.9878614636687635,5.042043631132838,5.1211229214157825,5.554281449815934,4.992906156470196,550763.7937336814,4,E01002348,9,0,7,0,0,0,5.675310522737638,5.663086374320894,4.966542245076855,5.105625657128616,5.193358399218797,5.64595897432784,5.103033062997558,700978.072769953,6,9,0,7,1,0,0,1.0,2,0,0,0,1,0,0
2296,5.404714039600257,5.6413364829439105,5.330234117941423,4.964285405476888,5.267384781259479,5.786338911634503,5.292347097396851,551715.303030303,2,E01002349,9,1,6,1,1,1,5.372194547109653,5.389386941114238,5.310092813610413,5.113548378252612,5.380363255584796,5.818424975933806,5.317272829885927,702336.1295336788,2,8,0,7,4,2,1,1.0,0,-1,-1,1,3,1,0
2297,5.153886500128072,5.424186901458632,5.263448362101876,5.269689907959852,5.1931198688479965,5.657834862645768,5.138324951673571,153247.15165876778,0,E01002350,7,0,9,0,0,0,5.147933654310579,5.540446613072219,5.3416778453718425,5.328989367349453,5.179517078738642,5.709657719349974,5.339181309627696,194169.34123222748,0,9,1,9,1,0,1,1.0,0,2,1,0,1,0,1
2298,5.318080742108195,5.260165012980762,5.61394770678721,5.047537595817917,5.320574612993943,5.952455994329955,5.253367259314186,382288.9802631579,1,E01002351,4,5,7,1,4,1,5.270631438313108,5.3334043069319295,5.525140516685717,5.055014112501434,5.348935949441159,5.9288086645530935,5.34643366987055,490216.4303030303,1,7,3,6,4,4,1,1.0,0,3,-2,-1,3,0,0
2299,5.505401058686085,5.3347653266711115,5.52742048165737,5.031031826214913,5.397498514713385,5.982302089837881,5.411223051486871,536108.7897435897,3,E01002352,6,3,7,3,4,3,5.438199655837323,5.431580453752035,5.495909590318979,5.083605028060545,5.3602158937109525,5.92084918970085,5.457648304571588,683645.048192771,3,8,3,7,4,4,3,1.0,0,2,0,0,1,0,0
2300,5.478264134737753,5.329484405056123,5.5327862760713025,4.97536881556434,5.4236917010238095,5.927147127928272,5.40083980608371,152635.51612903227,3,E01002353,6,3,6,3,3,2,5.450779335267508,5.344114698136031,5.490528982966693,5.088859594579953,5.342106157274388,5.905753563144314,5.669274769612213,192612.28358208956,3,7,2,7,4,3,6,1.0,0,1,-1,1,1,0,4
2301,5.783072816146599,5.248106741643214,5.717796269353929,4.730310032655905,5.61622416973114,6.250909574739226,5.682464890427642,438171.521978022,6,E01002354,4,6,2,8,8,7,5.616038242181142,5.3290768567721045,5.549454470475514,5.013812038103739,5.486060468355815,6.102802001635234,5.691932527224223,541450.0466666666,5,7,4,6,7,7,7,1.0,-1,3,-2,4,-1,-1,0
2302,5.73001659382655,5.246901586735048,5.923433885894008,4.756906031230309,5.5822893121389034,6.331244355473438,5.907705355622915,535523.4022346368,6,E01002355,4,8,2,7,9,9,5.577576965444228,5.253235369570115,5.754391720715691,4.964668456947102,5.473006528966567,6.219115518121159,5.870824338408077,682758.4,5,5,7,5,7,9,9,1.0,-1,1,-1,3,0,0,0
2303,4.976522963322126,5.443553598110492,5.378384010149882,5.284223442811232,5.11072734777744,5.600944196719389,5.0868742048740385,152899.50384615385,0,E01002356,7,1,9,0,0,0,4.996015776409192,5.3591286555658115,5.383293823356485,5.3654932890938465,5.072922466845995,5.553317299496369,5.237233165051607,192943.1348314607,0,7,1,9,0,0,0,1.0,0,0,0,0,0,0,0
2304,5.128102251956629,5.378660034994747,5.372235662022303,5.207540480203407,5.181985464206962,5.794089327024859,5.106398454239202,239354.5988372093,0,E01002358,7,1,9,0,1,0,5.171665683487393,5.42061486465252,5.419445224945119,5.2313892675551354,5.187600087645827,5.789820847921813,5.347752669789144,290380.88741721853,0,8,1,9,1,1,1,1.0,0,1,0,0,1,0,1
2305,5.564302731962765,5.211455644053571,5.629957882797017,4.9705980499001114,5.4246240486116974,6.1031571696786315,5.5619394235751205,550567.125,4,E01002359,4,5,6,3,6,5,5.36707322650096,5.288116385831552,5.551360054051175,5.048802387188463,5.379015570177751,6.042584264979643,5.680256352705114,700901.75,2,6,4,6,4,6,7,1.0,-2,2,-1,0,1,0,2
2306,5.607636213302612,5.39723781726577,5.5072057713161815,5.014060522751374,5.421238811449571,5.976076433875344,5.540616702491587,550258.9863636363,4,E01002360,7,3,7,3,4,5,5.593748290430415,5.378179944645275,5.50327821969986,5.000265353918076,5.464876780184833,6.026425452665849,5.6242344298145985,700502.2818181819,5,7,3,5,7,6,6,1.0,1,0,0,-2,4,2,1
2307,5.3425416081471555,5.3339036048803115,5.471004127559805,5.027009831783467,5.269870136465345,5.86321244831372,5.3533830373807065,551395.0601503759,1,E01002361,6,2,7,1,2,2,5.320022804811856,5.319371549094596,5.433884753167422,5.137798829361121,5.28618123265509,5.889451409050812,5.417959663510738,701898.2578397213,2,6,2,8,2,3,2,1.0,1,0,0,1,1,1,0
2308,5.637947196656085,5.3259076488778945,5.537057979309813,4.882267215150468,5.480115475806784,6.104907772642501,5.651707209805225,549219.6702127659,5,E01002362,6,3,4,5,6,7,5.559729192131444,5.289269467404014,5.5572367479926665,4.92656962055909,5.45689612940738,6.0857539829454925,5.676692143239473,699220.7157894737,5,6,4,4,7,7,6,1.0,0,0,1,0,2,1,-1
2309,5.417441149792039,5.360959380506033,5.415713716702289,5.04000329324998,5.325022049697049,5.993543716798346,5.445039425269667,551036.126506024,2,E01002363,6,2,7,1,4,3,5.454309478127883,5.401554218830507,5.458676250434361,5.038572739969733,5.442388465068092,5.977204110724794,5.514392095109437,701490.3190184049,3,8,2,6,6,5,3,1.0,1,2,0,-1,5,1,0
2310,5.490665975071135,5.272413719268072,5.638168121141101,4.900861253814091,5.452709856487456,6.10947437986495,5.462783766171289,552136.4444444445,3,E01002364,5,5,5,4,6,3,5.4975077390670775,5.227369548797608,5.587042030334473,5.045962500572204,5.466141986846924,6.079937126159668,5.558904013633728,702705.36,4,5,4,6,7,7,4,1.0,1,0,-1,1,3,1,1
2311,5.166307243807562,5.346584758881865,5.52797891559272,5.1117637167716845,5.311896457754332,5.931917194662423,5.402457596926854,543149.3965517242,0,E01002365,6,3,8,1,3,2,5.165832960927808,5.422255090765051,5.491549990198633,5.241444421244097,5.248051989185917,5.894582368232109,5.557899476171614,691906.6576576576,0,8,3,9,2,3,4,1.0,0,2,0,1,1,0,2
2312,5.273147321583932,5.456936946040706,5.412016570568085,5.03651799130858,5.247240854982744,5.8990895664482785,5.419201125178421,545073.3859649122,1,E01002366,8,2,7,0,3,3,5.242278913656871,5.421729036590509,5.5429479845783165,5.1307847248880485,5.2979045562576825,5.977318866211071,5.609688568533513,693590.2105263158,1,8,3,8,3,5,5,1.0,0,0,1,1,3,2,2
2313,5.592000769337578,5.242550070856659,5.604150309249269,4.955311813264945,5.4258000721953845,6.083961109600157,5.615497228685119,548704.8685446009,4,E01002367,4,4,6,3,6,6,5.50060022282369,5.303447501173297,5.563559910626087,5.019751391364533,5.410469291858303,6.071795265651444,5.631890626786982,698702.9757281553,4,6,4,6,5,7,6,1.0,0,2,0,0,2,1,0
2314,4.8894467313524705,5.868714402427136,4.909446577287056,5.384748169737803,4.881713890693557,5.383528255073117,4.841932118778497,173435.9295774648,0,E01002368,9,0,9,0,0,0,4.960047795912799,5.7084087775735295,5.001652473561904,5.419257881220649,4.860829312661115,5.5596744817845964,5.157263903056874,219238.02588235293,0,9,0,9,0,0,0,1.0,0,0,0,0,0,0,0
2315,5.1266149667205,5.528858898808717,5.268950099036807,5.237935319779411,5.2918188439475164,5.719711241898714,5.194490432739258,172597.43386243386,0,E01002369,8,0,9,1,1,0,5.123708194790624,5.405060251114777,5.354112883299095,5.199509037133739,5.1432532941438875,5.84556718952748,5.458002736555279,218004.44751381216,0,8,1,9,0,2,3,1.0,0,0,1,0,-1,1,3
2316,5.197410431933099,5.842044917612128,4.897926751598852,5.231556450300095,4.971311737062284,5.514939742227287,5.056054234938977,249427.15300546447,0,E01002370,9,0,9,0,0,0,5.184010660938217,5.694490277114973,4.929889967195169,5.302873984115102,4.970670149319078,5.620819561387268,5.16020298493307,312845.8145896657,0,9,0,9,0,0,0,1.0,0,0,0,0,0,0,0
2317,5.166827404437288,5.537785468941525,5.298320576316952,5.170558679906815,5.2169961898438055,5.833302043262541,5.252658004587796,176765.792746114,0,E01002371,9,0,9,0,2,1,5.137210781938337,5.442146211422136,5.364114125961153,5.172780319974928,5.133602588047535,5.842418648926495,5.549551741830234,224967.81280788177,0,8,1,8,0,2,4,1.0,0,-1,1,-1,0,0,3
2318,5.190171639612116,5.501905460299159,5.398064408565592,5.183533290412528,5.2893972989240305,5.801928998502485,5.303555756990163,544156.6871165644,0,E01002372,8,1,9,1,1,1,5.024443496357311,5.506272299306376,5.309724512633744,5.272139230808178,5.102055298698532,5.845464116209871,5.542775816850729,693134.7342657342,0,9,0,9,0,2,4,1.0,0,1,-1,0,-1,1,3
2319,5.17239914145521,5.594840185616606,5.284658683243618,5.184597655009198,5.20679053760344,5.766772063829565,5.164633797061059,205187.78494623656,0,E01002373,9,0,9,0,1,0,5.09241804157395,5.55608662567943,5.197809366576643,5.299764802656978,5.141753455242479,5.7664998453783705,5.44880549519895,276224.8975903614,0,9,0,9,0,1,2,1.0,0,0,0,0,0,0,2
2320,5.241881513879413,5.502972364425659,5.321232521817798,5.233710907044864,5.18109088852292,5.814519936130161,5.350956584726061,537951.0,1,E01002374,8,1,9,0,2,2,5.0971087038517,5.475083927065134,5.3184252545237545,5.296155735105276,5.047932819277048,5.83759279102087,5.534502650052309,687862.75625,0,9,0,9,0,2,4,1.0,-1,1,-1,0,0,0,2
2321,5.190311308999418,5.666083007131904,5.069045168712801,5.25417641185979,5.157708924247305,5.601232560195586,4.98107867356439,172113.51982378855,0,E01002375,9,0,9,0,0,0,5.187395924871618,5.642404639720917,5.104748231714422,5.31978130069646,5.086297153342854,5.759217525612224,5.244382148981094,217342.93636363637,0,9,0,9,0,1,0,1.0,0,0,0,0,0,1,0
2322,5.901574307017857,5.201775913621172,5.741022452896024,4.579650978247325,5.7137806077062345,6.272014813658632,5.791150307213819,534535.7160493827,8,E01002376,3,7,0,9,8,8,5.713723424133981,5.215461695270174,5.6375204909379315,4.876393249080439,5.566504609053302,6.238816394927396,5.806421995922259,681632.1401273885,7,5,5,3,9,9,8,1.0,-1,2,-2,3,0,1,0
2323,5.405081299133599,5.413033307529986,5.3443492986261845,5.09763465821743,5.275097060482949,5.809776075184345,5.304052888881415,537195.4296875,2,E01002377,7,1,8,1,2,1,5.269966023691585,5.425688197550255,5.383134587427204,5.19710369904836,5.178204727530033,5.818216136332309,5.499771599465988,684802.3146067415,1,8,1,9,1,2,3,1.0,-1,1,0,1,0,0,2
2324,5.395881488602212,5.454629600048065,5.459236619954414,5.1684695501276785,5.246044496272472,5.865674852056706,5.313885165021775,539835.4202127659,2,E01002378,8,2,9,0,2,1,5.129180602881373,5.5811770515782495,5.394974241451341,5.355871085001498,5.1387350571398835,5.785408953014685,5.451408108278197,687990.418367347,0,9,1,9,0,1,2,1.0,-2,1,-1,0,0,-1,1
2325,5.722739125138338,5.309580779285683,5.671309070965267,4.764013414866073,5.512164718254022,6.069973815380214,5.653823242313536,534796.4096916299,6,E01002379,5,6,2,5,6,7,5.574271540336421,5.3595476726005815,5.538397991598533,5.025522391784367,5.360351035747622,6.057154023588584,5.67147791855441,681894.448275862,5,7,3,6,4,6,6,1.0,-1,2,-3,4,-1,0,-1
2326,5.606199145317078,5.372696775086919,5.457939119812865,5.021427708382932,5.441493687422379,5.961027703670241,5.490066649010463,533945.9068322981,4,E01002380,6,2,7,4,4,4,5.4770389109441675,5.392077338205625,5.518454179371873,5.00399511236034,5.3404282053856,6.0424711165362845,5.678602105134154,680967.4863013698,4,8,3,5,3,6,6,1.0,0,2,1,-2,-1,2,2
2327,5.837665243281259,5.341521345078945,5.537352265583144,4.782087201045619,5.52818713337183,6.114877618021435,5.568213115135829,535986.7361111111,7,E01002381,6,3,2,6,7,5,5.834872971640693,5.30314314895206,5.60805176364051,4.815352017791183,5.4938395782753275,6.245718152434738,5.78011517877932,683780.3185185185,8,6,5,2,7,9,8,1.0,1,0,2,0,1,2,3
2328,5.643444065993789,5.214499402180904,5.620000956422191,4.873082563701996,5.465926450524626,6.117876246824103,5.545761298998601,535275.2881355932,5,E01002382,4,5,4,4,7,5,5.645264375571049,5.27388254367944,5.593783764405684,4.909904758135478,5.36854584867304,6.12210774566188,5.74613300742525,682528.7515151515,6,6,4,3,4,7,8,1.0,1,2,-1,-1,0,0,3
2329,5.410765850916505,5.390051773438851,5.44954847296079,5.01659403120478,5.378304476539294,5.9439728533228235,5.5272490208347635,535285.0260416666,2,E01002383,7,2,7,2,4,5,5.315101594802661,5.374834766143407,5.439726243263636,5.166080122727614,5.274516525635352,5.9101287206014,5.552056919611418,682765.6871794872,2,7,2,8,2,3,4,1.0,0,0,0,1,0,-1,-1
2330,5.575960184219614,5.361654738632347,5.504782333509939,4.989833985824766,5.310069623299279,5.996620301679307,5.526997541871603,546760.6650831354,4,E01002384,6,3,6,1,4,5,5.498695637792202,5.349934560911996,5.488519387879395,5.058272214945902,5.371149338524917,6.092146157043908,5.577241602789592,696343.3940886699,4,7,2,6,4,7,5,1.0,0,1,-1,0,3,3,0
2331,5.773169239995412,5.653357706952524,4.800522827305341,5.062381872971444,5.053373732113287,5.547540203648545,4.848241770482002,585082.0616966581,6,E01002385,9,0,8,0,0,0,5.855568506654813,5.741833991380541,4.790728212370109,5.082308432272433,5.097469600291571,5.56270645525586,5.032860465634909,747050.7464503043,8,9,0,7,0,0,0,1.0,2,0,0,-1,0,0,0
2332,5.413172779961183,5.313846430193216,5.480282181436835,4.9950820599222014,5.352490504726176,5.918935864410676,5.392368228857268,547814.0722021661,2,E01002386,5,2,6,2,3,2,5.373581743484471,5.335760486410746,5.475547897124047,5.076164798931864,5.309237186005498,5.899476693351928,5.452334725816096,697548.7201365188,2,7,2,7,3,3,2,1.0,0,2,0,1,1,0,0
2333,5.6717642335004586,5.32636813618416,5.38648531381474,4.872483525165292,5.404494498496832,5.990620017051697,5.541490183874618,561093.2697674419,5,E01002387,6,1,4,3,4,5,5.569962912950761,5.360878468782474,5.375612660554739,4.949879873104584,5.355943373533395,6.011947789558998,5.655756875796196,710132.2512820513,5,7,1,4,4,5,6,1.0,0,1,0,0,1,1,1
2334,5.808340197684718,5.278922876306608,5.671664982449775,4.787617475963106,5.568747021403968,6.216469456167782,5.833741570804634,547273.4852941176,7,E01002388,5,6,3,7,8,9,5.6733939510403255,5.213174864740083,5.555977632060196,4.891741239663326,5.549506291476163,6.259921594099565,5.823412604042978,696987.6909090909,6,5,4,3,8,9,8,1.0,-1,0,-2,0,1,1,-1
2335,5.792680772251908,5.441440794778907,5.364675182163915,4.893405465776705,5.410639090282861,5.893787507628119,5.423817615445242,548369.7056856187,7,E01002389,7,1,5,3,3,3,5.808696020882705,5.422286217377104,5.358181549351791,4.90364119924348,5.459043207250793,6.022556975792194,5.536197256219798,698203.9965517242,8,8,1,3,7,6,4,1.0,1,1,0,-2,4,3,1
2336,5.838773506659049,5.218267100828665,5.657117890302466,4.839603251881069,5.5420692004854715,6.149775474790543,5.792278340884617,547920.9947089948,7,E01002390,4,5,4,6,7,8,5.774665410319964,5.172339307765166,5.7051389631297855,4.939421239826414,5.540333708127339,6.2241089757945804,6.0135236076182785,697692.8125,7,4,6,4,8,9,9,1.0,0,0,1,0,2,2,1
2337,5.574361605428348,5.7970881835122245,4.806843706834491,5.080145789367381,5.078708825352665,5.562753246087685,5.000219417158043,669474.965379494,4,E01002391,9,0,8,0,0,0,5.689336161262223,5.761590041220188,4.838832497995879,5.0535198062924405,5.128834735469094,5.615053265355527,5.058792461641133,859580.0491071428,6,9,0,6,0,0,0,1.0,2,0,0,-2,0,0,0
2338,5.647648024180579,5.564496100264251,5.323823550390819,4.9707587383411544,5.495844275232345,5.865367562682541,5.339342638929054,434812.6296296296,5,E01002392,9,1,6,5,2,2,5.68658678809171,5.425420781291982,5.4153632177877675,4.964661560361347,5.490385316667103,6.006927053764383,5.465272723051606,555142.3915343916,6,8,1,5,7,5,3,1.0,1,-1,0,-1,2,3,1
2339,5.524474724728793,5.52031091891508,5.418503363502217,4.977588329723175,5.401130562797587,5.890657787017006,5.41021440819623,434641.7807486631,3,E01002393,8,2,6,3,3,3,5.529276210774658,5.433878726215773,5.505648705267137,5.051566928304652,5.438501713096454,5.914036182947056,5.453717299046055,554959.5698924732,4,8,3,6,6,3,2,1.0,1,0,1,0,3,0,-1
2340,5.157385585234337,5.500145663920137,5.418636882428041,5.131109641999314,5.311468789257954,5.91542275910525,5.402263881004963,439868.206185567,0,E01002394,8,2,8,1,3,2,5.123917988936106,5.434533699353536,5.473649912410313,5.137839187516106,5.146543351809184,5.771431729528639,5.391089811589983,562157.7888888889,0,8,2,8,0,1,2,1.0,0,0,0,0,-1,-2,0
2341,5.162309951252407,5.512461459997929,5.394307052246248,5.156937652164036,5.236123410138217,5.828802258077294,5.434289375940959,437172.1212121212,0,E01002395,8,1,9,0,2,3,5.119766877622021,5.392286037912174,5.422147597585406,5.312182307243347,5.228541756162838,5.648936193816516,5.159997431599364,556747.7959183673,0,8,1,9,1,0,0,1.0,0,0,0,0,1,-2,-3
2342,5.57352731660404,5.490719449731101,5.366391171396306,4.949579314320489,5.373571925458655,5.8812818643266125,5.3524649396406865,439493.7610619469,4,E01002396,8,1,6,2,3,2,5.529175361362072,5.331053938887535,5.39734504310363,5.008205803162461,5.31383062229244,5.925977216401232,5.479609837772649,561532.256880734,4,7,1,5,3,4,3,1.0,0,-1,0,-1,1,1,1
2343,5.022844504836379,5.4481289118331,5.4726887815045995,5.223355140907086,5.186190659636694,5.673919595629964,5.171169139691536,463387.5364238411,0,E01002397,8,2,9,0,0,0,4.970187791780619,5.273878432959745,5.439729438470223,5.228177211346121,5.1274774771365195,5.733426286702853,5.256695786314912,586090.7134670487,0,6,2,9,0,1,0,1.0,0,-2,0,0,0,1,0
2344,5.285556280388023,5.319625647562854,5.490054114809576,5.029288758646767,5.3374572025155125,5.971834522373271,5.511876610090148,438739.43396226416,1,E01002398,5,3,7,2,4,4,5.265168204165922,5.270936598872194,5.503411982319142,5.123014943434461,5.24518341475194,5.887617911442672,5.4619987471268905,560667.2673267326,1,6,3,8,2,3,3,1.0,0,1,0,1,0,-1,-1
2345,5.128575396731617,5.401655068242453,5.451194386172101,5.108284958009797,5.207831414734445,5.92056423086461,5.434734123509105,439135.9268292683,0,E01002399,7,2,8,0,3,3,5.201682009734213,5.335733288899064,5.48127600364387,5.212133978493512,5.1558061903342605,5.7746282909065485,5.324902042746544,561165.1015625,1,7,2,9,0,1,1,1.0,1,0,0,1,0,-2,-2
2346,5.559064962838648,5.556711808531529,5.243312507551887,4.945194307991136,5.338825961305059,5.875262950418695,5.385367831998495,705812.4098939929,4,E01002400,9,0,6,2,2,2,5.591313127034939,5.51474301378179,5.224171384891368,5.026550503250975,5.31354937827365,5.960317587260134,5.447244034790844,895371.0248447205,5,9,0,6,3,4,2,1.0,1,0,0,0,1,2,0
2347,5.400432927170019,5.484697194620111,5.377449201441359,5.094969968686159,5.354505775303676,5.905738094757343,5.385621965616599,704771.5229885058,2,E01002401,8,1,8,2,3,2,5.240929498722416,5.509783832814681,5.298753137363813,5.259419277076322,5.190025845123211,5.854410076640663,5.416528756081746,893910.6596858639,1,9,0,9,1,2,2,1.0,-1,1,-1,1,-1,-1,0
2348,5.474113900184632,5.382752275466919,5.402692974090576,4.965969903945923,5.408847162246704,6.067450775146485,5.554473888397217,705289.6,3,E01002402,7,1,6,3,6,5,5.328064828179777,5.34509246237576,5.350595321506262,5.048808801919222,5.301445021294057,6.0347448121756315,5.452598803676665,894567.3828125,2,7,1,6,3,6,2,1.0,-1,0,0,0,0,0,-3
2349,5.489514157405266,5.3759401193031895,5.478508391747108,4.972985091576209,5.380675215904529,6.149887627821702,5.574786595197824,705039.0461538462,3,E01002403,6,2,6,2,7,5,5.333034006598728,5.199731576676462,5.497055700401854,5.032735494227191,5.254929157643536,6.100294583763173,5.586112278738832,894204.1176470588,2,4,3,6,2,7,5,1.0,-1,-2,1,0,0,0,0
2350,5.4634830142512465,5.527728035955718,5.319858332836267,5.01728763219082,5.314924615802187,5.918890099091963,5.252574760986097,704806.3878787879,3,E01002404,8,1,7,1,3,1,5.345617096068451,5.522015135591201,5.238447085928522,5.109625693842851,5.189949980756855,5.923415131331807,5.480107118411618,893962.6629834254,2,9,0,7,1,4,3,1.0,-1,1,-1,0,0,1,2
2351,5.573753970973897,5.560226848102966,5.1704450272164255,4.997677600046374,5.38840951166063,5.84574146765583,5.3036602600565494,704860.1037735849,4,E01002405,9,0,7,3,2,1,5.602964215933994,5.507949719496813,5.219838284768199,5.051927660313828,5.243418809361932,5.915295129703685,5.435919888776626,894044.8909952607,5,9,0,6,1,3,2,1.0,1,0,0,-1,-2,1,1
2352,5.373521750044619,5.54909484126629,5.204639616685036,5.0711087421474295,5.273986621799632,5.745027303950399,5.200760767245904,610717.4743589744,2,E01002406,9,0,8,1,1,0,5.199102701343057,5.558321119941232,5.1639725928524145,5.32246991414081,5.070691936596265,5.642240058786515,5.1965479624135416,760298.9866920152,1,9,0,9,0,0,0,1.0,-1,0,0,1,-1,-1,0
2353,5.256270532912397,5.424363332606377,5.355749537082429,5.135111688553018,5.279771048971948,5.744279755430019,5.158964723729072,204365.57021276595,1,E01002407,7,1,8,1,1,0,5.135455358976101,5.357142267366832,5.322874167474244,5.254131047795507,5.116962101170208,5.685532009252444,5.257245951616614,263862.769874477,0,7,0,9,0,0,0,1.0,-1,0,-1,1,-1,-1,0
2354,5.413441500493458,5.489192447492054,5.366700398921966,5.08847793000085,5.266788795164653,5.779983662707465,5.273200949600764,706720.0642857143,2,E01002408,8,1,8,1,1,1,5.311411096978543,5.367514201064608,5.359300565363756,5.058969972738579,5.192785441875458,5.816166737186375,5.436296507493774,896567.3134328359,2,7,1,6,1,2,2,1.0,0,-1,0,-2,0,1,1
2355,5.373706016869381,5.535764230530837,5.381825073834123,5.057777607852015,5.263922466080764,5.8814540550626555,5.41705215963824,705973.5172413794,2,E01002409,9,1,8,1,3,3,5.259472533508584,5.337692693427757,5.378162102198895,5.077279742117281,5.28550315859877,5.965306056870355,5.505931473072664,895515.2530864198,1,7,1,7,2,4,3,1.0,-1,-2,0,-1,1,1,0
2356,5.394719821243471,5.553820884170164,5.279462838518446,5.106991276072995,5.324183807280904,5.713189886387996,5.231128504310829,706890.536231884,2,E01002410,9,0,8,1,0,1,5.243632872031766,5.420236182004603,5.253903062062492,5.219887628305427,5.16212515487421,5.749491694712743,5.445548862869563,896774.5065502183,1,8,0,9,0,1,2,1.0,-1,-1,0,1,-1,1,1
2357,5.775277891084162,5.499671268837615,5.329790000516082,4.885830911666311,5.477581195182201,5.912242690930192,5.4163524368046465,701632.2408376964,6,E01002411,8,1,5,4,3,3,5.459279154065395,5.586226018755717,5.23912801180344,5.097423380639356,5.219818990824004,5.890291116123116,5.587438079467507,890063.0742358079,3,9,0,7,1,3,5,1.0,-3,1,-1,2,-3,0,2
2358,5.663581138849258,5.47502883474032,5.298201086123784,4.92643918633461,5.423826694488525,5.852477688789367,5.374655414422353,704589.3533333334,5,E01002412,8,0,5,3,2,2,5.547810476183315,5.357612340346627,5.360229853846601,5.0217087551015585,5.325748304238066,5.868687827805966,5.532764379528985,895852.8792270531,5,7,1,6,3,3,4,1.0,0,-1,1,1,0,1,2
2359,5.484689428256108,5.543174222799448,5.276051605053437,5.065292642666743,5.298338781258999,5.773488956842667,5.312225885268969,702153.4564102564,3,E01002413,9,0,8,1,1,1,5.259090292390693,5.551573744526616,5.1385383940247635,5.221183510053725,5.091564130530786,5.721708643373359,5.3591463540596935,890705.8994708995,1,9,0,9,0,1,1,1.0,-2,0,0,1,-1,0,0
2360,5.864394897069687,5.514343531467976,5.304563408096631,4.8753667042041435,5.5144035797088575,5.872096625658182,5.453395141622959,701114.7115384615,7,E01002414,8,0,4,5,2,3,5.8650427618116705,5.397188988496673,5.370342392966433,4.89160702925808,5.465690723567639,5.915568184177831,5.5985797497461425,888661.8113207547,8,8,1,3,7,3,5,1.0,1,0,1,-1,2,1,2
2361,5.404762170909238,5.323176888294578,5.606150192485738,5.036626566511057,5.460685222462099,6.17711340518164,5.5118538924260685,60727.163538873996,2,E01002415,6,4,7,4,7,4,5.448199631931545,5.166070356025352,5.673923291601576,5.0163980921109514,5.455818135459144,6.200148312895148,5.652742690868206,78844.03603603604,3,4,6,6,6,8,6,1.0,1,-2,2,-1,2,1,2
2362,5.2319533818260915,5.5103840774664,5.382040394751053,5.204712498121421,5.3858047903583035,5.928853511810303,5.345774179064362,61457.882681564246,0,E01002416,8,1,9,2,3,2,5.344535792539568,5.3168618945300885,5.612369398175157,5.093041301983868,5.399294364270825,6.074853580615242,5.662030502019195,79838.01522842639,2,6,5,7,5,7,6,1.0,2,-2,4,-2,3,4,4
2363,5.621122198524298,5.41336032030759,5.462389417268612,4.88666033744812,5.502028991778691,6.074741509225634,5.5784882919655905,57932.93518518518,5,E01002417,7,2,5,5,6,5,5.478887873266655,5.332438088752128,5.535656590719481,5.027251925707784,5.361982346961857,6.002201350039036,5.5970675774983,75401.24324324324,4,7,3,6,4,5,5,1.0,-1,0,1,1,-1,-1,0
2364,5.507804147899151,5.532063098996877,5.415998873114586,4.973530089110136,5.378019008040428,5.952945452928543,5.5146445944905285,60995.33125,3,E01002418,9,2,6,2,4,4,5.454107872323494,5.3986186436835055,5.483220166553652,5.008896093837099,5.304555883297342,6.02909310153454,5.69885727987124,79206.33526011561,3,8,2,6,3,6,7,1.0,0,-1,0,0,1,2,3
2365,5.425974927743276,5.507776095867157,5.432731204032898,5.037741825580597,5.426086533864339,6.028066047032675,5.525162773132324,61351.82,2,E01002419,8,2,7,3,5,4,5.381293054163104,5.400437617443017,5.551520736965202,5.046184814187902,5.331542159678668,6.039313014442398,5.639371838795363,79711.26627218934,2,8,4,6,3,6,6,1.0,0,0,2,-1,0,1,2
2366,5.510931922777279,5.596956502746892,5.3641732318981274,4.970555830646205,5.368132324637593,6.001413019927773,5.532106511496209,59971.68243243243,3,E01002420,9,1,6,2,5,5,5.498947495833422,5.43263211617103,5.503231073037172,4.970838459638449,5.3387556335864925,5.9800427831136265,5.554279558933699,82853.73717948717,4,8,3,5,3,5,4,1.0,1,-1,2,-1,1,0,-1
2367,5.514936885433997,5.514398709742609,5.4286057899098195,5.012164061654827,5.422051562520558,5.976678048779151,5.482564313682968,61275.94610778443,3,E01002421,8,2,7,3,4,4,5.556117246495211,5.393696292836398,5.583271277779564,4.9321356336063245,5.448140113111486,6.076905982379607,5.639126585129111,79598.14438502674,5,8,4,4,6,7,6,1.0,2,0,2,-3,3,3,2
2368,5.334875127792358,5.362125670433044,5.473894261360169,5.016675734519959,5.2911640052795414,5.941233057022095,5.480676203727723,647375.984,1,E01002422,6,2,7,1,4,4,5.113596565963686,5.3323735682539235,5.506619111512059,5.157618162243865,5.130638872006143,5.86827126953953,5.517456275548121,826379.1550387597,0,7,3,8,0,3,4,1.0,-1,1,1,1,-1,-1,0
2369,5.643280290067196,5.406146156100126,5.3668744432238435,4.947497069262541,5.49417573098953,5.9272599289050465,5.431803602438706,701880.6875,5,E01002423,7,1,6,5,3,3,5.422829195244671,5.416813248913038,5.3805596643386915,5.0520664497053245,5.264247364649489,5.883614402927765,5.574437130531764,890064.2602739726,3,8,1,6,2,3,5,1.0,-2,1,0,0,-3,0,2
2370,5.404647221167882,5.392505686907541,5.5293793479601545,5.0926420631862825,5.512579421202342,5.872089699620292,5.413212164526894,434847.13095238095,2,E01002424,7,3,8,5,2,3,5.347168265978495,5.4003271484375,5.461906150182088,5.204761096636454,5.301326899528504,5.894957269032796,5.510950096448263,555136.8866666667,2,8,2,9,3,3,3,1.0,0,1,-1,1,-2,1,0
2371,5.415979860810673,5.582280435982873,5.305867239306955,5.032333718327915,5.37170706356273,5.855838788256926,5.438900048592512,700306.4352941177,2,E01002425,9,0,7,2,2,3,5.298983571809881,5.526799275594599,5.3210817505331605,5.156126095266903,5.19431021494024,5.870230544314665,5.566441048594082,886105.8882352941,1,9,0,8,1,3,4,1.0,-1,0,0,1,-1,1,1
2372,5.396910123358992,5.478290850954845,5.527473892484393,5.013358941651825,5.430191482816424,5.928886408196356,5.380917539273886,576157.1127819549,2,E01002426,8,3,7,3,3,2,5.282372058684856,5.417856431905196,5.3758738928758945,5.171091764043066,5.182523553840286,5.878385176718484,5.545847103685515,736820.9121338913,1,8,1,8,1,3,4,1.0,-1,0,-2,1,-2,0,2
2373,5.342975395376032,5.391074817830866,5.588117298212919,5.062848755446347,5.366653795675798,5.988885430856184,5.499702367999337,702963.1,1,E01002427,7,4,8,2,4,4,5.144890888223371,5.340934106447165,5.438942485642665,5.137175512545317,5.197706772285757,5.954218797313357,5.614749569337345,891932.5339805825,0,7,2,8,1,4,5,1.0,-1,0,-2,0,-1,0,1
2374,5.488596845163058,5.578377132546412,5.1974089496756255,5.035668976502876,5.239418574391979,5.754000711114439,5.418034915238211,603430.493150685,3,E01002428,9,0,7,0,1,3,5.368809858957927,5.555505246118782,5.243807854216083,5.149518725139643,5.154675127634036,5.756673221494637,5.4705809861226795,780911.2287581699,2,9,0,8,0,1,3,1.0,-1,0,0,1,0,0,0
2375,5.770013557469591,5.57956485038108,5.14875339510593,5.014053853268319,5.355905891098875,5.863097893430831,5.444640467775629,699918.3244680851,6,E01002429,9,0,7,2,2,3,5.623269361467218,5.5685933906229295,5.194440672745058,5.045790211639213,5.303119025038715,5.907320040554257,5.536210307523833,887481.7336683417,6,9,0,6,3,3,4,1.0,0,0,0,-1,1,1,1
2376,5.964989611920754,5.402536467586398,5.499139540398602,4.743560175190058,5.645911543358602,6.118067543602845,5.684303286898831,690995.5470852018,8,E01002430,7,3,2,8,7,7,5.930866070695825,5.34257432254585,5.5681645150657175,4.848240345447987,5.591225089253606,6.168010112401602,5.8784812586801545,875256.4954954955,9,7,4,2,9,8,9,1.0,1,0,1,0,1,1,2
2377,5.786050964223928,5.266666212575189,5.629604181750067,4.767366315578593,5.599192042186343,6.227551037689735,5.654658151495045,55975.55172413793,6,E01002431,5,5,2,7,8,7,5.624883514251152,5.307317723322959,5.555037233951318,4.952278933385863,5.453518944065066,6.158689479758269,5.778106612880735,72284.86131386862,6,6,4,4,6,8,8,1.0,0,1,-1,2,-1,0,1
2378,5.903003518397991,5.118807471715487,5.765712420145671,4.716175692967879,5.66444159241823,6.246717546230707,5.753286269994883,56083.070512820515,8,E01002432,2,7,1,8,8,8,5.63380519308225,5.211513294114007,5.673624318055432,4.900179210335318,5.411620090104113,6.025265122904922,5.6768460616920935,72185.77777777778,6,5,6,3,5,6,6,1.0,-2,3,-1,2,-3,-2,-2
2379,5.820338377624066,5.378100136874364,5.509063747581211,4.749885040932259,5.621005972143504,6.06120392375301,5.591025792482252,275432.71816283924,7,E01002433,6,3,2,8,6,6,5.829694381969817,5.445033995105939,5.47682818507447,4.855756263522541,5.483132636722396,6.045096786583171,5.695820097975871,399071.23897058825,8,8,2,2,7,6,7,1.0,1,2,-1,0,-1,0,1
2380,5.97470521997003,5.397488537956686,5.49690645161797,4.738946543020361,5.6391134304158825,6.141070494932287,5.661090011456434,691600.9470588235,8,E01002434,7,3,2,8,7,7,5.934385685804414,5.345861992603395,5.592528831668016,4.763173174276584,5.522560952349407,6.22121295928955,5.840727422295547,876023.8243902439,9,7,4,1,8,9,9,1.0,1,0,1,-1,0,2,2
2381,5.773142784069746,5.4301673094431555,5.501983791742569,4.807780952942677,5.544373309306609,6.187403266857832,5.709179032154572,691636.8974358974,6,E01002435,7,3,3,6,8,7,5.745085934400558,5.426981119513512,5.497300522327423,4.922165281176567,5.38459504544735,6.187528073787689,5.833216126561165,876125.065,7,8,3,4,5,8,8,1.0,1,1,0,1,-1,0,1
2382,5.868691657718859,5.402114442485547,5.403404845399895,4.789243436052732,5.556017390146912,5.9538792289703,5.49931244232394,639012.1700404858,7,E01002436,7,1,3,6,4,4,5.729295107626146,5.4295786436527,5.440744757652283,4.968243260537425,5.44075835087607,5.9909550749486495,5.691226075253179,822698.375,7,8,2,5,6,5,7,1.0,0,1,1,2,0,1,3
2383,5.940802323763774,5.363370757669075,5.462654675522896,4.71882975809106,5.619585172770774,6.074468078134267,5.552696719017203,54954.643835616436,8,E01002437,6,2,1,8,6,5,5.815550811936922,5.408340363859017,5.529799868013257,4.864003259444905,5.4671327839387915,6.073422726069655,5.684708293910338,70768.64953271027,8,8,3,2,7,7,7,1.0,0,2,1,1,-1,1,2
2384,5.963211302562869,5.544845017026082,4.947149429675773,4.814704091428853,5.368433328269483,5.658683768279261,5.199587167024041,694647.1966426858,8,E01002438,9,0,3,2,0,0,6.0294405796589,5.46880232890447,5.0767707574061856,4.780455144246419,5.399184094636868,5.666956895131332,5.321168152185587,880857.864102564,9,9,0,1,5,0,1,1.0,1,0,0,-2,3,0,1
2385,5.65495306240039,5.452458954928966,5.330912135692125,4.90480375289917,5.4090105201421155,5.919541965441757,5.394760391149628,689520.5505617978,5,E01002439,8,1,5,3,3,2,5.696192296806741,5.36185522125539,5.450135286303534,4.852515001803781,5.441846504303569,5.944574295034731,5.49918001803799,873273.4492753623,6,7,2,2,6,4,3,1.0,1,-1,1,-3,3,1,1
2386,5.810750602737186,5.53232408086146,5.187737590215337,4.884095062421062,5.469113430638951,5.835361609778066,5.410901197767633,688810.0748031496,7,E01002440,9,0,5,4,2,3,5.715484615099633,5.500642707792379,5.302944607653861,4.855657343137062,5.390495284128997,5.938495971388736,5.467053995294086,872903.5593220339,7,9,0,2,5,4,3,1.0,0,0,0,-3,1,2,0
2387,5.86419103778569,5.640025313132632,4.880568093325184,4.9140928779028155,5.376220146955642,5.558586163436417,5.150347995969047,692178.5592920354,7,E01002441,9,0,5,2,0,0,5.9055802611123145,5.549804728643029,5.0090459967609,4.944511053045239,5.352480069725915,5.6813766703141475,5.219453837228032,878157.9579646018,8,9,0,4,4,0,0,1.0,1,0,0,-1,2,0,0
2388,5.770480802531616,5.567953603058916,5.1387857226182785,4.871799390436867,5.428332605669575,5.8275855642309935,5.398547652679654,693872.8387096775,6,E01002442,9,0,4,3,2,2,5.798179724194982,5.458005002490035,5.319630439217026,4.8267197678755,5.501329330710678,5.906587985721794,5.482967182322666,879206.4324324324,8,8,0,2,7,3,3,1.0,2,-1,0,-2,4,1,1
2389,5.2841696384352,5.789076162451436,4.96350671206003,5.191456078787258,5.155935528445337,5.5796338825374265,5.128440634749743,211188.24319066148,1,E01002443,9,0,9,0,0,0,5.308989552238531,5.76081987849453,4.993465531708901,5.300711542472505,5.019089324223367,5.666324350917549,5.234913660350599,269864.9052631579,2,9,0,9,0,0,0,1.0,1,0,0,0,0,0,0
2390,5.169470792158234,5.894950270652771,4.709157267537896,5.332043694984117,5.002753225669095,5.43942178007189,4.96241376733754,566876.2729245794,0,E01002444,9,0,9,0,0,0,5.295758888088321,5.818989437150758,4.832929905865697,5.304589422758189,4.95839780005182,5.561384642420963,5.09940283293546,687306.9726141079,1,9,0,9,0,0,0,1.0,1,0,0,0,0,0,0
2391,5.582036567013166,5.531665720437703,5.361706923323068,4.896088260656212,5.423410658250775,5.900137328265006,5.409017307019373,705652.7777777778,4,E01002445,9,1,5,3,3,3,5.38851197714305,5.518216906331521,5.29798473442457,5.079631349658439,5.278673214148421,5.877030622893275,5.276573474894571,895126.861878453,3,9,0,7,2,3,0,1.0,-1,0,-1,2,-1,0,-3
2392,5.392328661680222,5.7845978582727495,4.891491764372793,5.197132966436189,5.166947021155522,5.529481215518096,5.059263402840187,412307.2672413793,2,E01002446,9,0,9,0,0,0,5.486099023548211,5.6569800247153275,5.008055975948598,5.181970687882758,5.101957397506064,5.6532725552655165,5.198492572134602,508811.3233438486,4,9,0,8,0,0,0,1.0,2,0,0,-1,0,0,0
2393,5.314522961234304,5.745098809091961,4.946482170880537,5.182593430062676,5.129877816842224,5.6319161491171394,5.123529929595235,210450.3346303502,1,E01002447,9,0,9,0,0,0,5.28004561858099,5.7505164472783195,4.975208309634787,5.267986859649908,5.054402878049944,5.678080054775613,5.245407339979391,268471.3868852459,1,9,0,9,0,0,0,1.0,0,0,0,0,0,0,0
2394,5.522072539314047,5.603459711198683,5.10846578262069,5.029397811208453,5.376139859874527,5.68961261735334,5.220483867378978,209761.0357142857,3,E01002448,9,0,7,2,0,0,5.442822691578193,5.537917668387394,5.209397710409741,5.134133685755249,5.237778424416613,5.787190762942269,5.426334424306883,267449.1241610738,3,9,0,8,1,1,2,1.0,0,0,0,1,-1,1,2
2395,5.311253474780491,5.576665613310678,5.236506734575544,5.0757859522955755,5.340231852531433,5.7874882711683,5.237204721995762,209788.08571428573,1,E01002449,9,0,8,2,1,1,5.263213901770742,5.647209316178372,5.205673206479926,5.2548889404849,5.108111970675619,5.783159023209622,5.340513627152694,267484.46315789473,1,9,0,9,0,1,1,1.0,0,0,0,1,-2,0,0
2396,5.241386667374642,5.479959953215815,5.455962576212421,5.208917886018753,5.265083530256825,5.826363109773205,5.437127431554179,698378.9516129033,1,E01002450,8,2,9,1,2,3,4.958413436792899,5.544461545736893,5.390024561812912,5.423954016056614,5.0675050236176755,5.726416758869005,5.463452551675879,885755.5869565217,0,9,1,9,0,1,3,1.0,-1,1,-1,0,-1,-1,0
2397,5.402356964673182,5.400645500929781,5.545122841531916,5.00160824975302,5.351756074631861,5.962941417398379,5.61862880777019,697720.1472868217,2,E01002451,7,4,7,2,4,6,5.268861363100451,5.3877268447432405,5.564755894416987,5.093778158343116,5.222252650778423,5.974961534026981,5.685663389605145,884340.3488372093,1,8,4,7,1,5,7,1.0,-1,1,0,0,-1,1,1
2398,5.344613356770997,5.702622297553905,5.341298015750184,5.179333445629642,5.287309761297599,5.863058183353079,5.496578735095767,695872.2128279883,1,E01002452,9,1,9,1,2,4,5.376489719941248,5.540013523244146,5.323153694470723,5.228809551813116,5.216005436816618,5.867465249341519,5.497092169908742,881873.5472636815,2,9,0,9,1,3,3,1.0,1,0,-1,0,0,1,-1
2399,5.367173231927689,5.570794890829399,5.467333698003306,5.127558394340472,5.353030854025803,5.9915559237959695,5.636273885850852,698330.615819209,2,E01002453,9,2,8,2,4,6,5.28133840100807,5.336035183298658,5.623258792866043,5.1502667365715515,5.233692601410269,6.056936148314448,5.774740787974575,885252.298245614,1,7,5,8,1,6,8,1.0,-1,-2,3,0,-1,2,2
2400,5.256633293337938,5.695018772187272,5.137180179115234,5.191790959699367,5.217048274792306,5.723794895943588,5.372781617854669,686739.8455284553,1,E01002454,9,0,9,0,1,2,5.254681134142007,5.602748608671103,5.117119676059055,5.262510833871324,5.090882096503608,5.678399934801449,5.30753257512227,874763.4432989691,1,9,0,9,0,0,1,1.0,0,0,0,0,0,-1,-1
2401,5.375595488951574,5.489496294538773,5.363931488634935,5.072676491974598,5.362941801844545,5.869440886511732,5.262220439033129,705913.9203980099,2,E01002455,8,1,8,2,2,1,5.273399919124659,5.448262342091264,5.376569214125572,5.1452792929898346,5.207122968922695,5.791202399531022,5.456050997884403,895361.2906403941,1,8,1,8,1,1,2,1.0,-1,0,0,0,-1,-1,1
2402,5.706653970844892,5.459557359924122,5.460319137086674,4.941417790797292,5.491096059886777,6.044252979512117,5.6320347688636,700616.7602040817,5,E01002456,8,2,6,5,5,6,5.578850066538939,5.397464908889888,5.486601522288372,4.92932502264829,5.358074793496082,6.01130285213903,5.808978160632026,888032.3659793815,5,8,2,4,4,5,8,1.0,0,0,0,-2,-1,0,2
2403,5.395180399670745,5.479181173172864,5.418153231794184,5.11968210068616,5.350743265766086,5.869397248282577,5.359868404540149,704569.7121212122,2,E01002457,8,2,8,2,2,2,5.296371052596743,5.47593793332182,5.3673860853081505,5.104908646337244,5.179608352136928,5.852405562306082,5.511016011238098,893866.1125827815,1,9,1,7,1,2,3,1.0,-1,1,-1,-1,-1,0,1
2404,5.957225576674123,5.580561199483343,5.166527946919494,4.808012578308777,5.4478850221012625,5.86468916840196,5.4112191708934425,695136.7361563517,8,E01002458,9,0,3,4,2,3,6.005441343418161,5.466470508852103,5.303656590269694,4.850172271093817,5.480829596112613,6.035849880439836,5.628827735018811,880802.9897610921,9,9,0,2,7,6,6,1.0,1,0,0,-1,3,4,3
2405,5.849377896146076,5.474366668375527,5.401599793317842,4.894901870518196,5.506608495479677,6.021739115366121,5.543913944756112,694951.9804878049,7,E01002459,8,1,5,5,5,5,5.757588459618726,5.3645216891514,5.524199306066312,4.971080792609172,5.460758584827634,6.174151756056589,5.792389975121273,880586.2512562814,7,7,3,5,7,8,8,1.0,0,-1,2,0,2,3,3
2406,5.892117295635345,5.3811545900013895,5.46494271385071,4.7595540355873975,5.556828005673134,5.980799476849978,5.571827055656747,695444.9589041095,7,E01002460,7,2,2,6,4,5,5.785251985741345,5.374244350686295,5.466478605851478,4.846702169346553,5.4579227906401435,6.080115648153435,5.766647701622338,881180.0286738351,7,7,2,2,7,7,8,1.0,0,0,0,0,1,3,3
2407,5.787967227914798,5.551825993465927,5.210003796988313,4.886141004052552,5.404718292959081,5.790066615965381,5.324230820877747,695834.8176100629,6,E01002461,9,0,5,3,1,1,5.8483647008736925,5.569475121987172,5.211481536046053,4.945648615941023,5.412177034295523,5.909742880326051,5.418520748615265,881683.6314102564,8,9,0,4,5,3,2,1.0,2,0,0,-1,2,2,1
2408,5.768858910799026,5.399188762903213,5.445023661851883,4.7768566793203355,5.583609074354172,6.042538492679596,5.5682909375429155,695653.34,6,E01002462,7,2,2,7,5,5,5.775820520459389,5.408667374022153,5.3456072868133075,4.909452954725343,5.530230708876434,6.0360700743538995,5.6377518566287295,881478.7193877551,7,8,1,3,8,6,6,1.0,1,1,-1,1,1,1,1
2409,5.834349482770889,5.487884051857456,5.375603305716669,4.8348211636466365,5.480909926276053,5.979106091683911,5.424890487905471,696173.0887096775,7,E01002463,8,1,4,5,4,3,5.900470091064624,5.450651377107131,5.432621309305213,4.8828042249254135,5.500973895579909,6.093004416355856,5.606154963872689,882066.9962825279,8,8,2,3,7,7,5,1.0,1,0,1,-1,2,3,2
2410,5.53918587206703,5.526622419226361,5.330299569485662,4.930832777743482,5.3502452313490805,5.905184947653275,5.3507579513218095,694155.0366132723,4,E01002464,8,1,5,2,3,2,5.490768704599547,5.560650129341385,5.208468967271083,5.090401474711965,5.242423113688682,5.83672548324159,5.380181394734429,879687.7038834952,4,9,0,7,1,2,1,1.0,0,1,-1,2,-1,-1,-1
2411,5.513178070592139,5.3480295023152244,5.541199906502363,5.024752688531431,5.362020763090855,6.014634210211008,5.479708703070725,692094.6580310881,3,E01002465,6,3,7,2,5,4,5.361289195611444,5.498977835749237,5.419758030506367,5.136527163321983,5.254934896885509,5.853425710973605,5.52986398549147,876759.5633802817,2,9,1,8,2,2,4,1.0,-1,3,-2,1,0,-3,0
2412,5.511269498546168,5.325429293906914,5.577085791893725,5.0174390420598804,5.521326558769874,6.190685862640165,5.671289075095698,267928.0141509434,3,E01002466,6,4,7,6,8,7,5.576727311368342,5.181744815574752,5.698603005320938,5.0005342529879675,5.5255259821812315,6.236851974769875,5.689583085753299,368907.2824074074,5,4,6,5,8,9,7,1.0,2,-2,2,-2,2,1,0
2413,5.523027481313524,5.411136965511897,5.334839100278289,5.0193532758584904,5.390333640508811,5.98298468936089,5.493012273777796,692627.8324022347,3,E01002467,7,1,7,3,4,4,5.413574307986668,5.444954633031573,5.3600906644548685,5.136883492469788,5.3013874646595545,5.919288564409529,5.513926764215742,877405.1657142857,3,8,1,8,3,4,3,1.0,0,1,0,1,0,0,-1
2414,5.43729674523952,5.380823597604153,5.565377285667494,4.975538709000046,5.466180467138104,6.1138484162442825,5.600214065289965,514875.9411764706,2,E01002468,7,4,6,4,7,6,5.519067411195664,5.207006162688845,5.678199894087655,5.001115064393907,5.501076480320521,6.191022631100246,5.7521789658637275,659017.2380952381,4,5,6,5,7,8,8,1.0,2,-2,2,-1,3,1,2
2415,5.514171857459872,5.317734928107729,5.5559294656211256,4.979050705830256,5.5038334890907885,6.18698439060473,5.695188870616987,691704.9362745098,3,E01002469,5,4,6,5,8,7,5.411696496286562,5.257989265556846,5.562551747475352,5.056374003312418,5.375566453805992,6.155704965548856,5.7727771412049025,876199.2321428572,3,5,4,6,4,8,8,1.0,0,0,0,0,-1,0,1
2416,5.532935168275881,5.370021094628914,5.558174980345683,4.904492719688607,5.437897684586108,5.992032908914077,5.494527871285252,691884.5979899497,3,E01002470,6,4,5,4,4,4,5.474684205970594,5.253538904445512,5.546923652291298,5.036807935684919,5.332363164850643,5.939405793590205,5.554565365293196,876429.1160714285,4,5,3,6,3,4,4,1.0,1,-1,-1,1,-1,0,0
2417,5.561030889486338,5.401372624682142,5.536632975974641,5.003288810129289,5.440288226325791,6.061714090310134,5.579316944270939,604952.2792207792,4,E01002471,7,3,7,4,6,5,5.431139461199442,5.259043651819229,5.509104574388928,5.06408916314443,5.322656119532056,6.030471816327837,5.5914296163453,768913.2722222222,3,5,3,7,3,6,5,1.0,-1,-2,0,0,-1,0,0
2418,6.172367364730475,5.203025510850942,5.571537734202619,4.53305403072879,5.700882049101703,6.012741380142716,5.726169459662348,688340.358490566,9,E01002472,4,4,0,9,5,8,6.032803626000127,5.438496988030929,5.451028799708886,4.741490783570688,5.594282687464847,5.967709480961667,5.659359065792229,871328.9746835442,9,8,2,1,9,4,6,1.0,0,4,-2,1,0,-1,-2
2419,6.378987587948956,5.348173326285428,5.449818932190143,4.519412334318514,5.798985435218407,6.082709962098056,5.565163100522662,688821.082010582,9,E01002473,6,2,0,9,6,5,6.185885491795565,5.425811579090138,5.186734874835189,4.802583701947596,5.631688934346144,5.84228674653937,5.5210174677883765,872891.8743455497,9,8,0,1,9,2,4,1.0,0,2,-2,1,0,-4,-1
2420,5.831842461325471,5.341107115709692,5.514591267831941,4.675628533040671,5.546683819969196,6.062481957868227,5.545461979127468,687706.4962406015,7,E01002474,6,3,1,6,6,5,5.804850260117896,5.379340386928472,5.463511510002882,4.862030907681114,5.452815747798834,5.956724769190738,5.487438857107234,869886.037593985,8,8,2,2,6,4,3,1.0,1,2,-1,1,0,-2,-2
2421,5.9905331995752125,5.426749134165609,5.396571024870261,4.662129279385265,5.608175265483367,5.964771642644181,5.558199824940445,687972.8632478632,8,E01002475,7,1,1,7,4,5,5.712893448044769,5.500041661642294,5.250842553535394,4.940393704017707,5.365458488042376,5.854533253728816,5.433725189107709,871066.6407079647,7,9,0,4,4,2,2,1.0,-1,2,-1,3,-3,-2,-3
2422,6.063575435453846,5.355693353376081,5.50879267492602,4.622469431354154,5.664276776775237,6.0564996196377665,5.702772137426561,687810.7419354839,9,E01002476,6,3,0,8,6,7,5.933529223067851,5.427038785023026,5.397121267982676,4.8434685793104055,5.415994245040266,6.03925753092464,5.691684560685218,870884.1518987342,9,8,1,2,5,6,7,1.0,0,2,-2,2,-3,0,0
2423,6.282048109998095,5.232819682106059,5.578484664572046,4.5701510202377404,5.8013727423992565,6.094024034890722,5.790534012495203,687690.4627659575,9,E01002477,4,4,0,9,6,8,5.988826705698381,5.345403926414356,5.470614862023738,4.7774867725651164,5.51859240085758,6.017350577471549,5.747167866132413,870677.514619883,9,7,2,1,8,5,8,1.0,0,3,-2,1,-1,-1,0
2424,5.914148117685076,5.264858628892656,5.609014708983716,4.717095739950383,5.605199763012417,6.07302445445569,5.714744450477174,687583.7512690355,8,E01002478,5,5,1,7,6,7,5.629264455939096,5.266922947906313,5.559423445709168,4.924597558521089,5.464810183123936,5.934062900997343,5.626041297874753,869632.3412698413,6,6,4,4,7,4,6,1.0,-2,1,-1,3,0,-2,-1
2425,5.657568150401665,5.5294580338737385,5.282740740732114,4.935222148345912,5.413932654714804,5.904692511404714,5.399600498687287,689106.6175115207,5,E01002479,9,0,6,3,3,2,5.614653929268441,5.49599786967766,5.296531972652528,5.10658680345954,5.277364233063489,5.93640243832658,5.5204057082897275,872835.6585365854,5,9,0,7,2,4,4,1.0,0,0,0,1,-1,1,2
2426,5.983084115473663,5.340862598927582,5.461849452818141,4.679675065857523,5.65896132237771,6.074984610080719,5.667481651639237,99628.46323529411,8,E01002480,6,2,1,8,6,7,5.882583641380853,5.409885068957725,5.4286827835697355,4.812725269839111,5.46715483326144,6.108067808972763,5.761886429697387,128493.68539325842,8,8,2,2,7,7,8,1.0,0,2,0,1,-1,1,1
2427,5.773923377195994,5.536494052520505,5.366720314379092,4.86281816109463,5.558190037254934,5.944592267274857,5.461656678054068,643067.2268518518,6,E01002481,9,1,4,6,4,3,5.710822176070235,5.472194145707523,5.382251250797807,5.031019248034619,5.379824534800258,6.000479523412782,5.5699273558223945,812329.2081447964,7,9,1,6,4,5,4,1.0,1,0,0,2,-2,1,1
2428,5.96437137315769,5.484437383047425,5.4584294663797515,4.7346198582413175,5.623542615682772,6.082267192330691,5.625650078353315,519488.8663366337,8,E01002482,8,2,2,8,6,6,5.6934425733631775,5.492100635823262,5.39434255141557,4.993600399709055,5.443289809472571,5.977684861089027,5.581242944549594,665451.270386266,6,9,1,5,6,5,5,1.0,-2,1,-1,3,-2,-1,-1
2429,5.572574046388943,5.400753058979859,5.480789732693427,4.905348787954704,5.451345595882167,5.9526952463178775,5.586619195027567,295926.8391959799,4,E01002483,7,2,5,4,4,6,5.515239190047895,5.314888485160791,5.525194793240005,5.012057225469133,5.365675209833423,6.010462897484292,5.714148801817021,400443.0234741784,4,6,3,6,4,5,7,1.0,0,-1,1,1,0,1,1
2430,5.818212714325003,5.393914635489587,5.590680025061783,4.735905901104415,5.586607525137817,6.176191959251352,5.628930203768672,686858.925170068,7,E01002484,7,4,2,7,7,6,5.662741368467158,5.426488232779336,5.473679770956506,4.980338680160629,5.416505110013735,6.081426983946687,5.593312696977095,869635.2097902098,6,8,2,5,5,7,5,1.0,-1,1,-2,3,-2,0,-1
2431,5.487889460956349,5.4155066567308765,5.495082966019125,4.934208043182598,5.408487003691056,6.018384132665746,5.559049740959616,687209.0235294118,3,E01002485,7,3,5,3,5,5,5.385929531948541,5.422167406928155,5.3917184811766425,5.086962893445005,5.304944415887197,5.919506860035722,5.503539421225107,870052.3118279569,3,8,1,7,3,4,3,1.0,0,1,-2,2,0,-1,-2
2432,5.245720779237572,5.718321684313698,4.998347591037399,5.251573810913811,5.157686381983611,5.644254610948036,5.14635156488126,204628.37116564417,1,E01002486,9,0,9,0,0,0,5.459995518455022,5.603299917148639,5.212837384622309,5.106814149059827,5.263202594503571,5.810442808006383,5.213366188580477,260187.42784810127,4,9,0,7,2,2,0,1.0,3,0,0,-2,2,2,0
2433,5.247047463128733,5.54786119904629,5.307515994522923,5.1866726496422935,5.211504891861317,5.832958208498105,5.3201837724493455,201531.7441860465,1,E01002487,9,0,9,0,2,1,5.159334038534472,5.399215731889971,5.444387628186133,5.149190831568934,5.285635531910004,5.8544932815336415,5.338364097379869,256328.6935483871,0,8,2,8,2,2,1,1.0,-1,-1,2,-1,2,0,0
2434,5.312703841460679,5.51838817710648,5.247299095827662,5.077809818490537,5.260055237901425,5.840509059900295,5.3445773510161985,201867.58083832337,1,E01002488,8,0,8,0,2,2,5.123807672171565,5.612526874793203,5.214687933698732,5.298777418526989,5.115876643978364,5.757809438203511,5.367311308258458,257292.6081871345,0,9,0,9,0,1,1,1.0,-1,1,0,1,0,-1,-1
2435,5.2636461795545095,5.522703907653397,5.32685914109735,5.129377900969748,5.2520599546385744,5.752450450962665,5.340891781975241,201428.46078431373,1,E01002489,8,1,8,0,1,2,5.134774712955251,5.48164481976453,5.317043794303381,5.276635797083879,5.109816314793434,5.782654947593432,5.381101024251024,256324.14285714287,0,9,0,9,0,1,1,1.0,-1,1,-1,1,0,0,-1
2436,5.316723377239414,5.57364373478463,5.204773189091101,5.192105291820154,5.34082806885727,5.749464118868355,5.2732695927464865,207389.13008130083,1,E01002490,9,0,9,2,1,1,5.281494168241052,5.462897753163194,5.29858910853338,5.280894775648375,5.232397302237256,5.784087319171567,5.312071918980956,263967.3976833977,1,9,0,9,1,1,1,1.0,0,0,0,0,-1,0,0
2437,5.224874806958575,5.386933267578598,5.325410702431848,5.164033682771431,5.2848158159921335,5.76778060428856,5.418520844259928,208374.86046511628,0,E01002491,7,1,9,1,1,3,5.102567719631508,5.3057583287114,5.379768406758543,5.30187457897624,5.1126021019748,5.786597435591651,5.5066630185627545,265729.0983606557,0,6,1,9,0,1,3,1.0,0,-1,0,0,-1,0,0
2438,5.262129496125614,5.581580585903591,5.290580087237888,5.19847319874109,5.290015689687791,5.805240626428642,5.348096429912093,208509.3137254902,1,E01002492,9,0,9,1,2,2,5.246469010839929,5.327226023573975,5.432046339228437,5.351315263267997,5.138992634686557,5.780090818871985,5.52529678144655,265777.020979021,1,7,2,9,0,1,4,1.0,0,-2,2,0,-1,-1,2
2439,5.226694218747251,5.627687656127654,5.178102335414371,5.336582818546811,5.203512295946345,5.685738396000218,5.156244632360098,208929.9009009009,0,E01002493,9,0,9,0,0,0,5.148856381768161,5.428795432581485,5.258473472687805,5.335478811588102,5.07011324109383,5.7342045573354925,5.246516305266074,266259.06796116504,0,8,0,9,0,1,0,1.0,0,-1,0,0,0,1,0
2440,5.390421474933624,5.5047333111763,5.252908174991608,5.030792526721954,5.34277424955368,5.818315180778503,5.328630403995514,548954.848,2,E01002494,8,0,7,2,2,1,5.317142041131793,5.573957258291205,5.22213457248829,5.1139776794998735,5.200874563107274,5.748881519086076,5.311221245875575,698032.0411522634,2,9,0,7,1,1,1,1.0,0,1,0,0,-1,-1,0
2441,5.419334957752322,5.507080456306195,5.255195126157676,5.097860297546011,5.413109338342263,5.878041463532472,5.372929304691371,171244.87684729064,2,E01002495,8,0,8,3,2,2,5.443248948385549,5.47424280597258,5.436089882092882,5.046135312827059,5.391525508359421,5.932908275330713,5.464502878429354,219950.13178294574,3,9,2,6,5,4,3,1.0,1,1,2,-2,2,2,1
2442,5.201416933398449,5.624498113241895,5.250591423980978,5.182791380348353,5.234717832108722,5.7844284814297,5.187039471501089,67533.37837837837,0,E01002496,9,0,9,0,1,0,5.226399342922335,5.4939945598619175,5.403676054470659,5.215735446386985,5.269681002186463,5.8228490109992235,5.319037435329066,88122.38643067847,1,9,1,9,2,2,1,1.0,1,0,1,0,2,1,1
2443,5.3161889096252795,5.492563349600057,5.304568520939077,5.120486930126452,5.338797560629954,5.838353038744162,5.229077507066362,78876.48091603053,1,E01002497,8,0,8,2,2,1,5.310599735471047,5.424044678859016,5.432207593063013,5.084976233688056,5.346646901272258,5.865758781673527,5.409614975712881,100011.79551820728,2,8,2,7,4,2,2,1.0,1,0,2,-1,2,0,1
2444,5.466937515296434,5.465348686042585,5.4989475027511,4.972858227397266,5.454209333971927,6.017059879867654,5.517117705784346,61243.94078947369,3,E01002498,8,3,6,4,5,4,5.54050397952931,5.338858311608334,5.680835923892539,4.916766406705715,5.47509690579152,6.125817607713226,5.787831116042681,79496.40268456376,5,7,6,4,7,7,8,1.0,2,-1,3,-2,3,2,4
2445,5.355258149904431,5.765585650254681,5.024460021000509,5.17089124597591,5.15366920431936,5.637479896984146,5.075963962164687,374607.4600484262,2,E01002499,9,0,9,0,0,0,5.53378142840494,5.688001162395245,5.062832888306641,5.096212480853244,5.183103959734847,5.745276689771714,5.212663117220731,478668.5487804878,4,9,0,7,1,1,0,1.0,2,0,0,-2,1,1,0
2446,5.615592018707649,5.307780506727579,5.543630481599928,4.958954336759928,5.532993558403495,6.067023270613664,5.608555621200508,439903.36363636365,4,E01002501,5,3,6,6,6,6,5.2104115035082845,5.434648583601187,5.353348696554029,5.23893834663941,5.162374929264859,5.869403665130203,5.4408274309055225,562059.8288288289,1,8,1,9,0,3,2,1.0,-3,3,-2,3,-6,-3,-4
2447,5.469111886662497,5.4610187352543145,5.403947905755379,4.931151711604964,5.36368572879845,5.9079391519788285,5.45322412588227,438069.54225352115,3,E01002502,8,1,5,2,3,3,5.2147291671228775,5.471977809913286,5.316148215577803,5.181672503930012,5.112024943337186,5.808096212285165,5.431396767383314,559661.2366412213,1,9,0,8,0,2,2,1.0,-2,1,-1,3,-2,-1,-1
2448,5.611010572627971,5.314386178004114,5.50876071578578,4.8648184396718674,5.420012063101718,6.0115957056221205,5.540628511654703,438307.5657894737,4,E01002503,5,3,4,3,5,5,5.302161537749427,5.39816381250109,5.361393391234534,5.14711331980569,5.034420893021992,5.839344278403691,5.507750522238868,559953.5428571429,2,8,1,8,0,2,3,1.0,-2,3,-2,4,-3,-3,-2
2449,5.730552368693882,5.403189680841234,5.3656667539808485,4.893181632889641,5.512127751244439,5.922735927369859,5.427535049120585,619165.2088888889,6,E01002504,7,1,5,5,3,3,5.656306373500407,5.413028348481291,5.394457760856662,5.032961103072854,5.363739722160273,5.9159553977599835,5.490547313440315,789899.3799126637,6,8,1,6,4,3,3,1.0,0,1,0,1,-1,0,0
2450,5.237607567223779,5.708332122749228,5.012853221531355,5.235563098400733,5.1105878506556595,5.639435440793682,5.136249304998039,439741.7887788779,0,E01002505,9,0,9,0,0,0,5.25582663070165,5.608162124723965,5.09181429936756,5.240276663214566,5.019743376953213,5.665084331971526,5.239560707592349,561888.5042979943,1,9,0,9,0,0,0,1.0,1,0,0,0,0,0,0
2451,5.323886299725645,5.361404568512247,5.493025479109391,5.054112327024804,5.352396921341463,5.8552680859654584,5.304886964537342,388121.52795031056,1,E01002506,6,3,7,2,2,1,4.981762493169436,5.307820862339389,5.34943575051523,5.269354790769597,5.0962210066856874,5.623556503044662,5.1853408544294295,502613.91397849465,0,6,1,9,0,0,0,1.0,-1,0,-2,2,-2,-2,-1
2452,5.234112672353003,5.61610179768118,5.031237342237365,5.152871196984537,5.134859467826186,5.628504097284832,5.117228118885165,354757.7121661721,0,E01002507,9,0,9,0,0,0,5.071096101933248,5.617292227619939,4.961877018300159,5.366333107559049,4.963426754008924,5.538754748185939,5.194795194937258,452206.44314868806,0,9,0,9,0,0,0,1.0,0,0,0,0,0,0,0
2453,5.577897364568527,5.380945520051197,5.469243465703427,4.963817948540205,5.460858357458961,5.9844967669962,5.48033936097355,454415.52123552124,4,E01002508,7,2,6,4,4,4,5.348286339344869,5.463663357359763,5.345015425263471,5.149631021586993,5.223773122743796,5.870408821651954,5.500312015300489,587515.6221374046,2,9,1,8,1,3,3,1.0,-2,2,-1,2,-3,-1,-1
2454,5.916458304268973,5.320165867805481,5.4904512064797535,4.730146504810878,5.625879695756095,6.064088394982474,5.675859636579241,699225.8171428571,8,E01002509,6,3,2,8,6,7,5.7830989751866255,5.450135362211358,5.42662967575921,4.879186552037638,5.504403921662185,6.071020697790479,5.835232235136486,886482.7037037037,7,8,2,3,8,7,8,1.0,-1,2,-1,1,0,1,1
2455,5.946858784774455,5.310695253494309,5.532225318071319,4.791669599893616,5.518297886703072,6.094297596594182,5.499043955308635,701991.7073170731,8,E01002511,5,3,3,5,6,4,5.738298303059169,5.373668306214469,5.372885404314314,4.884012029511588,5.420309211867196,6.0391518483843125,5.626209604399545,890670.3485714286,7,7,1,3,6,6,6,1.0,-1,2,-2,0,1,0,2
2456,5.719063578941065,5.589150477582075,5.204763353653155,4.901730623770886,5.371832635458999,5.8408241218782155,5.415961130710412,696606.6535433071,6,E01002512,9,0,5,2,2,3,5.750018174660966,5.537593157050457,5.180563241560408,4.987398023618028,5.294732924154464,5.8344981692572855,5.487625560227861,882695.4468085107,7,9,0,5,2,2,3,1.0,1,0,0,0,0,0,0
2457,5.704054298242593,5.542410187206822,5.2521592442920095,4.906828687893404,5.355607447782493,5.815865670991636,5.371595583516037,696835.4647302905,5,E01002513,9,0,5,2,2,2,5.630851061994379,5.588428833701394,5.238026061491532,5.045959512103687,5.278581261634827,5.809386237751354,5.409665864597668,882965.3818181818,6,9,0,6,2,2,2,1.0,1,0,0,1,0,0,0
2458,5.660022012144327,5.371415109187365,5.575534442067147,4.825637932866812,5.478785139322281,5.980558127164841,5.5474498748779295,697104.60625,5,E01002514,6,4,3,5,4,5,5.571923176865829,5.302437761582826,5.5190912698444565,4.978512969142512,5.374945390851874,5.922026054482711,5.561014848633817,883406.2736842105,5,6,3,5,4,4,4,1.0,0,0,-1,2,-1,0,-1
2459,5.664408542050255,5.514384987619188,5.3714947113284355,4.897332345997846,5.463719413898609,5.8944140513738,5.36292285433522,697660.2925925925,5,E01002515,8,1,5,4,3,2,5.400435577353386,5.487683598635948,5.310078757756377,5.11426060820279,5.28210881932141,5.810454518827673,5.46317467232273,884165.7561643836,3,9,0,7,2,2,3,1.0,-2,1,-1,2,-2,-1,1
2460,6.030199372194668,5.436454686251554,5.4757698627716715,4.640937062508282,5.664261074627147,6.048136240658276,5.582256586156427,697903.4705882353,8,E01002516,7,2,0,8,5,5,5.8888363355447435,5.366577058291632,5.41086440391777,4.82673223944735,5.453569673309642,5.989867714318362,5.613479318697591,884642.0330578513,8,7,1,2,6,5,5,1.0,0,0,-1,2,-2,0,0
2461,5.720104009816141,5.405464044122985,5.5351588003563155,4.808010228655555,5.483739460959579,6.051890241377281,5.5593872115467535,701413.9090909091,6,E01002518,7,3,3,5,5,5,5.7983405343417465,5.251026564630969,5.441520427835399,5.026382668264981,5.283741145298399,6.20457017832789,5.827769822087781,890015.0344827586,8,5,2,6,2,8,8,1.0,2,-2,-1,3,-3,3,3
2462,5.783784559445503,5.5337705233158205,5.304717108530876,4.821277059041536,5.4240157384138845,5.861181951180482,5.316249917103694,701910.5794871795,6,E01002519,9,0,3,3,2,1,5.551482760782473,5.606848282797526,5.113343926862037,5.049330039007853,5.105776011325084,5.746130553908826,5.243358104699211,890715.4671280277,5,9,0,6,0,1,0,1.0,-1,0,0,3,-3,-1,-1
2463,5.215228314833207,5.512540841536088,5.258927464918656,5.120316113558682,5.2037624168395995,5.700937072147022,5.13706882910295,699483.72,0,E01002520,8,0,8,0,0,0,5.288687342663289,5.491680856717746,5.224220150967122,5.177665914652831,5.173192024230957,5.762449942308569,5.370405860262199,886097.3371298405,1,9,0,8,0,1,1,1.0,1,1,0,0,0,1,1
2464,5.427372701962789,5.3648732288678485,5.408151076237361,5.0385336387157444,5.350514594316483,5.853789143562317,5.360403386751811,697911.2533333333,2,E01002521,6,1,7,2,2,2,5.375761335737565,5.384133713035022,5.374706722708309,5.105877243420657,5.2312823477913355,5.811138071032131,5.358381521701813,884507.0264705883,2,8,1,7,1,2,1,1.0,0,2,0,0,-1,0,-1
2465,5.544058907123012,5.345278741749189,5.463948024138239,4.949553703533784,5.478366208440475,6.045055991820707,5.4071863807794704,699003.1984732824,4,E01002523,6,2,6,4,5,3,5.577557820973434,5.366194767276133,5.379101487595265,5.065411897156182,5.312960416313231,5.982793295477319,5.454364113920317,886110.1732283465,5,7,1,7,3,5,2,1.0,1,1,-1,1,-1,0,-1
2466,5.800741007951933,5.455307372262545,5.463666240188563,4.785148177748528,5.525158892725115,6.004784882625687,5.512996346036965,703695.6869158879,7,E01002525,8,2,3,6,5,4,5.601795567831862,5.419716549029044,5.357803738992149,4.976933646639552,5.3264082528035575,5.926914978464809,5.55085693258758,892536.4862385321,5,8,1,5,3,4,4,1.0,-2,0,-1,2,-3,-1,0
2467,5.4465413834918195,5.582821647326152,5.3279573247207335,5.013269658112407,5.343368228988268,5.887537434326475,5.4668451251082155,455913.9054726368,3,E01002526,9,1,7,2,3,4,5.274742607800466,5.486030713567194,5.27782160718486,5.1037301443657785,5.252389879721515,5.905529762214085,5.468668739188392,598454.4528301887,1,9,0,7,2,3,3,1.0,-2,0,-1,0,0,0,-1
2468,5.559509462406559,5.630145586786732,5.021718934178352,5.050448719051577,5.249524630365833,5.6486041334367565,5.243437830959597,705522.8346774194,4,E01002527,9,0,7,0,0,1,5.532410338804295,5.580274908261607,5.060772238575461,5.141826711226779,5.189990288857724,5.674747314289949,5.172194034427744,895097.7756653993,4,9,0,8,1,0,0,1.0,0,0,0,1,1,0,-1
2469,5.3332739576049475,5.694931473939315,5.235774603097335,5.040436555509982,5.259519344827403,5.903296262284984,5.388768194551053,396445.33478260867,1,E01002528,9,0,7,0,3,2,5.262250652184358,5.598290795678491,5.192943628306861,5.0923699521803645,5.122916724767771,5.826958272908185,5.291243524701746,518135.84234234237,1,9,0,7,0,2,0,1.0,0,0,0,0,0,-1,-2
2470,5.60494377692782,5.305054295026785,5.547962453227638,4.865038544211344,5.41831940503106,5.997621447844346,5.4924509373117,703344.6200607903,4,E01002529,5,4,4,3,5,4,5.382974463430318,5.318542762236162,5.439782551066442,5.0780079479921945,5.257405845956369,5.910263642668724,5.48443253473802,892106.2840909091,3,6,2,7,2,3,3,1.0,-1,1,-2,3,-1,-2,-1
2471,5.5834179865686515,5.52981822992626,5.381916412554289,4.898305488887586,5.486556324833318,5.963375183155662,5.3591885591808115,706882.5947368421,4,E01002530,9,1,5,5,4,2,5.49837026909778,5.561900556087494,5.289542038817155,5.030358380392978,5.294425144948457,5.947958764277007,5.339472837197153,896975.3578947368,4,9,0,6,2,4,1,1.0,0,0,-1,1,-3,0,-1
2472,5.7587347266285915,5.395036171342051,5.528261703114177,4.785999598198159,5.553556709788566,6.000621948131295,5.544973480146985,703815.8662790698,6,E01002531,7,3,3,6,5,5,5.527949945680026,5.458911501128098,5.363803863525391,5.090447451191387,5.311618241770514,5.980439568388051,5.555226488360043,892761.3505747126,4,8,1,7,3,5,4,1.0,-2,1,-2,4,-3,0,-1
2473,5.280156585613536,5.723613025858539,5.099221012665836,5.108783061283801,5.141737852852775,5.735304476406081,5.194707372115047,588897.9647577093,1,E01002532,9,0,8,0,1,0,5.226542631343559,5.642265136153609,5.173910282717811,5.267343194837923,5.095243202315436,5.777784766974272,5.32171049118042,778555.4333333333,1,9,0,9,0,1,1,1.0,0,0,0,1,0,0,1
2474,5.794152326054043,5.538512395716261,5.023090661257163,4.917870879173279,5.434761674924829,5.681730550367713,5.278972801120802,693903.2720306513,7,E01002533,9,0,5,3,0,1,5.774439825933166,5.530282358083215,5.148301019099514,5.031893972506739,5.319684641841999,5.806951054820308,5.330118421664454,879730.9794238684,7,9,0,6,3,2,1,1.0,0,0,0,1,0,2,0
2475,5.8499170151077395,5.405516581708977,5.445791639867617,4.785620149778051,5.506507930969324,6.0050045355361386,5.4879007018914745,692519.4397759103,7,E01002534,7,2,3,5,5,4,5.663894337725777,5.35382690870693,5.485655848001469,4.870613195303547,5.424788807168861,6.019929734268629,5.676385616980536,877237.0173410404,6,7,2,3,6,6,6,1.0,-1,0,0,0,1,1,2
2476,5.769236841028737,5.312844175484873,5.631826235882698,4.792573974497857,5.556786365566715,6.008466811910752,5.659484659471819,692503.4354838709,6,E01002535,5,5,3,6,5,7,5.649193735960137,5.2228497723951985,5.543508247662616,4.901306351025899,5.440470387431456,6.013598959078498,5.677686946366423,877296.7670250896,6,5,3,3,6,5,6,1.0,0,0,-2,0,0,0,-1
2477,5.516645241083589,5.619502080311565,5.174178123474121,5.0699278138718515,5.3914842568103625,5.738120461409947,5.301983700608307,692975.4213836478,3,E01002536,9,0,8,3,1,1,5.452059718278738,5.597981107103956,5.19538531264106,5.161116368168003,5.31890458720071,5.78616306414971,5.340854010739169,877921.0714285715,3,9,0,8,3,1,1,1.0,0,0,0,0,0,0,0
2478,5.626814447641372,5.54351607978344,5.255195859670639,4.895830072164536,5.452973327040672,5.772575080990792,5.30202109515667,694278.62,5,E01002537,9,0,5,4,1,1,5.626916618574233,5.528997407073066,5.333161488884971,4.992749676344887,5.34767312994079,5.905533475535257,5.514903441308037,879719.4841269841,6,9,1,5,4,3,3,1.0,1,0,1,0,0,2,2
2479,5.578914800458703,5.52057605045886,5.2786657820063185,4.951537865252535,5.386121920810258,5.808287170800296,5.370725020889409,693082.7809917355,4,E01002538,8,0,6,2,2,2,5.4625064949104685,5.509480539490195,5.322236289805416,5.039467855815974,5.2769655199611885,5.7959316747760345,5.4478856303573195,879114.5791855204,4,9,0,6,2,1,2,1.0,0,1,0,0,0,-1,0
2480,5.810070316390235,5.382249453280232,5.474282877279981,4.7511639606834635,5.583389152984808,6.086087144247376,5.601332165817223,692807.7524752475,7,E01002539,7,2,2,7,6,6,5.754371563009188,5.387656993141361,5.494564903133056,4.962654936547373,5.477700398248785,6.086985997125214,5.660144153763266,877769.3970588235,7,8,3,4,7,7,6,1.0,0,1,1,2,0,1,0
2481,5.427137352858379,5.649288063596009,5.248139117174087,5.114409975185516,5.3617105894028,5.77249724242338,5.285546171437403,434939.66878980893,2,E01002540,9,0,8,2,1,1,5.426312075090156,5.583149339156176,5.244347280295438,5.162018458048503,5.337482944367424,5.791334723669385,5.297797111607102,555421.7936507936,3,9,0,8,3,1,0,1.0,1,0,0,0,1,0,-1
2482,5.507659431444395,5.572433877975569,5.322361753621233,4.982309439313521,5.36957892420095,5.859710023490661,5.364230376864792,436141.3899082569,3,E01002541,9,1,6,2,2,2,5.578181806600319,5.473510890636804,5.304082341913907,4.981084274233512,5.383039716842039,5.969607600625956,5.442770384392649,557030.141509434,5,9,0,5,5,5,2,1.0,2,0,-1,-1,3,3,0
2483,5.283932436870623,5.590919241875032,5.338423669338226,5.1160145635846295,5.246970200085942,5.811812059788764,5.23295228390754,435454.37974683545,1,E01002542,9,1,8,0,2,1,5.260634387667115,5.43757760846937,5.40948083432945,5.0438299799287645,5.316216487336803,5.875368949529287,5.285846414598259,556094.0202702703,1,8,1,6,3,3,0,1.0,0,-1,0,-2,3,1,-1
2484,5.5078655578652205,5.659437112256783,5.2344797030598125,5.073393052938033,5.340626470085715,5.841911946835161,5.260292618453097,436848.4081632653,3,E01002543,9,0,8,2,2,1,5.545647105776277,5.545709374255704,5.276810404053308,5.018493660410544,5.2686332607627815,5.874698468617031,5.3598340005802925,558496.1503759399,5,9,0,6,2,3,1,1.0,2,0,0,-2,0,1,0
2485,5.686198705807328,5.580314122140408,5.368195085786283,4.8622066378593445,5.407183941453695,5.930076355114579,5.433438920415938,440457.90625,5,E01002544,9,1,4,3,3,3,5.644018498173466,5.292890898386637,5.405368449952867,5.026585036736948,5.32980318069458,5.965238996788307,5.4557421763738,562830.2518518518,6,6,1,6,3,4,2,1.0,1,-3,0,2,0,1,-1
2486,5.497663996922664,5.6515759863914585,5.220300641579506,5.009410982712721,5.318082582492095,5.8136983804213695,5.252177855907342,439073.14743589744,3,E01002545,9,0,7,1,2,1,5.54611047794079,5.454834152227161,5.321639081527447,5.0524787478063296,5.260368851409561,5.864341126091179,5.402921741036163,560958.1724137932,5,8,0,6,2,2,2,1.0,2,-1,0,-1,1,0,1
2487,5.342879594844065,5.674958212140166,5.306976196942506,5.150236829563424,5.302883948072975,5.7815401620335045,5.210465245040846,439346.1975308642,1,E01002546,9,0,9,1,1,0,5.445264907723123,5.425214709883386,5.395818969742819,5.063614782961932,5.225010582669214,5.875724673271179,5.454896242103794,561369.3125,3,8,1,7,1,3,2,1.0,2,-1,1,-2,0,2,2
2488,5.327229614140557,5.4833201531504026,5.399412757060567,5.057880877471361,5.351506993418834,5.863051195613673,5.341153095003034,439003.7704918033,1,E01002547,8,1,8,2,2,2,5.281704415215386,5.370039736783063,5.453957598297684,5.1060368008083765,5.2057523153446335,5.884023604569612,5.439479695426093,560886.6814814815,1,7,2,7,1,3,2,1.0,0,-1,1,-1,-1,1,0
2489,5.3922003513955055,5.672156036534208,5.119248740216519,5.054556225525572,5.287465988004461,5.647505479924222,5.131421723898421,704880.539893617,2,E01002548,9,0,7,1,0,0,5.406531650113219,5.606203114355842,5.175004187398954,5.14809458411911,5.209557693310889,5.7274915112055815,5.121843536194386,894478.8740554156,3,9,0,8,1,1,0,1.0,1,0,0,1,0,1,0
2490,5.475621644886697,5.609169717151595,5.21032746303131,4.986457049104683,5.342416384902733,5.801901037762274,5.2653599883510855,706671.1369294606,3,E01002549,9,0,6,2,1,1,5.536150509326154,5.480884286887857,5.237485542720809,5.067574164121767,5.248932959030033,5.882873744117707,5.37284368391663,896467.4633204633,4,9,0,7,2,3,1,1.0,1,0,0,1,0,2,0
2491,5.577259094942184,5.621233705490354,5.363301585591029,5.014652802830651,5.403738091862391,5.931684285875351,5.284578593004317,702139.0079365079,4,E01002550,9,1,7,3,3,1,5.38862071954287,5.447015432211069,5.359911306087787,5.0885662317276,5.219642404409555,5.931670900491568,5.361883430297558,890544.7307692308,3,8,1,7,1,4,1,1.0,-1,-1,0,0,-2,1,0
2492,5.510469280853473,5.547564890018847,5.431983806468822,4.9740051964603404,5.348252202467943,5.986531412159955,5.446113647607269,705512.5608465609,3,E01002551,9,2,6,2,4,3,5.423204201640504,5.322132310481987,5.441324779481599,4.969081353057515,5.354998430820427,6.012443565961086,5.56709665963144,894626.9141414141,3,7,2,5,4,5,4,1.0,0,-2,0,-1,2,1,1
2493,5.422036400500764,5.49700151288763,5.40893025981619,4.990182957750686,5.446748145083164,5.9407042956098595,5.3992040797751,702539.4574468085,2,E01002552,8,1,6,4,4,2,5.368197015353611,5.371920537948609,5.28619434765407,5.081880576269967,5.250497410637991,5.879665524618966,5.373838413783482,891046.6571428571,2,7,0,7,2,3,1,1.0,0,-1,-1,1,-2,-1,-1
2494,5.590339203178883,5.477379011362791,5.417395444214344,4.9587049327790735,5.433129560947418,6.079645669460296,5.516504184156656,703000.06875,4,E01002553,8,2,6,3,6,4,5.384363150141041,5.379633979432902,5.375865593837325,5.06155678876646,5.309102152563204,5.997918774367897,5.394482843435494,891757.9681528662,3,8,1,7,3,5,2,1.0,-1,0,-1,1,0,-1,-2
2495,5.348966902952927,5.415044428752019,5.308861322036156,5.063335590729347,5.296141927425678,5.686360735159654,5.2294576578873855,702870.3630769231,1,E01002554,7,1,8,1,0,1,5.286454047154224,5.36232812224694,5.317165034157889,5.1588323260895965,5.177656236684547,5.677273746128031,5.2320471587528115,891448.5929919138,1,7,0,8,1,0,0,1.0,0,0,-1,0,0,0,-1
2496,5.368514593120094,5.503814128605095,5.315393206772503,5.003156868724136,5.36294950397165,5.82774010005298,5.333728238269016,217789.2027027027,2,E01002555,8,1,7,2,2,1,5.1953768184032345,5.469829421912508,5.299234227593897,5.220306171572267,5.200616362059645,5.782559092996156,5.456432129949184,279610.4137931034,1,9,0,9,1,1,2,1.0,-1,1,-1,2,-1,-1,1
2497,5.23747104551734,5.439227786490588,5.38925477353538,5.053330884716375,5.2643463844206275,5.923667498720371,5.3739437804958685,218549.0894308943,0,E01002556,7,1,7,1,3,2,5.228495792242197,5.4183010046298685,5.481238623765798,5.21222755908966,5.266684471643888,5.841821173521189,5.3695666982577395,280745.8230769231,1,8,2,9,2,2,1,1.0,1,1,1,2,1,-1,-1
2498,5.645127642849635,5.474104260649916,5.3937582686343,4.894193404458563,5.498760545734867,5.980385706563702,5.418530542754271,219491.0807174888,5,E01002557,8,1,5,5,4,3,5.570796207948164,5.329401866100621,5.435264392332598,4.963695252911326,5.4803515455939555,6.050700272099253,5.568626200753536,281844.4784688995,5,7,2,5,7,6,4,1.0,0,-1,1,0,2,2,1
2499,5.462866232269689,5.445997864949076,5.397006924528824,5.016016404252303,5.323676936249984,5.852643616575944,5.3982547000834815,218898.86315789472,3,E01002558,7,1,7,1,2,2,5.531461220608944,5.321264531053425,5.498183326858083,5.039316706680225,5.379832101780832,5.926292361254897,5.539360491853011,281161.7224880383,4,7,3,6,4,4,4,1.0,1,0,2,-1,3,2,2
2500,5.398766335481071,5.759213539436705,4.968560796956418,5.115216858316176,5.2346484720116795,5.5887366368038816,5.119817957232888,221665.55940594058,2,E01002559,9,0,8,0,0,0,5.581463972662316,5.636680446491867,5.064543076030543,5.081219626450148,5.229394209971193,5.788680116074985,5.269536249559434,284891.72295081965,5,9,0,7,1,1,0,1.0,3,0,0,-1,1,1,0
2501,5.535742992419375,5.495694451925287,5.429781996462333,4.901300132559817,5.46217880066502,5.9902109255631,5.484753652052446,220029.63157894736,4,E01002560,8,2,5,4,4,4,5.474040869085546,5.347468754186988,5.395690517629531,5.060195513587584,5.400215630225319,5.97971769322686,5.475716866273931,282963.7005347594,4,7,1,7,5,5,3,1.0,0,-1,-1,2,1,1,-1
2502,5.485295142446246,5.494667288235256,5.378153872489929,4.949674493925912,5.3541423729487825,5.889573747771127,5.328286339555468,222320.58571428573,3,E01002561,8,1,6,2,3,1,5.3037804790905545,5.413916553769793,5.332188529627664,5.332409984299114,5.231360124690192,5.786660598857062,5.302485953484263,285575.33928571426,2,8,1,9,1,1,1,1.0,-1,0,0,3,-1,-2,0
2503,5.547265324512673,5.457855628855402,5.396859009172664,5.033475458288992,5.3300909210183764,5.8708110148680275,5.355600540198427,183933.61452513965,4,E01002562,8,1,7,1,2,2,5.450839605724927,5.478085463486829,5.2544904119760085,5.112752282503739,5.157092310271217,5.793799917674759,5.367277266909775,232812.96116504853,3,9,0,7,0,1,1,1.0,-1,1,-1,0,-1,-1,-1
2504,5.698446103345568,5.291865678591149,5.5453989316369885,4.8594381892792535,5.410867508326735,6.084568664292309,5.595876425226158,189263.6168224299,5,E01002563,5,4,4,3,6,6,5.660509268126165,5.296990881878067,5.542633320230887,4.915500886411781,5.322206973554604,6.086390299626081,5.60591079704315,239168.89243027888,6,6,3,4,3,7,5,1.0,1,1,-1,0,0,1,-1
2505,5.5410495686034364,5.455919969826937,5.4484363459050655,4.986737373595436,5.411425098776817,5.8776006537179155,5.263424604510267,184979.234375,4,E01002564,8,2,6,3,2,1,5.4668678262581425,5.364515680198868,5.41281027905643,5.0526686403900385,5.2981201733152075,5.865697610502441,5.403485925247272,234251.05208333334,4,7,1,6,3,2,2,1.0,0,-1,-1,0,0,0,1
2506,5.12607195010552,5.534870317807564,5.22437002658844,5.232448024933155,5.127174613567499,5.58751069353177,5.178538144551791,188266.02692307692,0,E01002565,9,0,9,0,0,0,5.177996030048143,5.412274859915707,5.299188669946126,5.188565894727796,5.145959460623212,5.674048445067809,5.279967714626587,238477.72413793104,0,8,0,8,0,0,0,1.0,0,-1,0,-1,0,0,0
2507,5.170526619891675,5.612767460053427,5.128594113720788,5.317262451202549,5.1270901884949,5.492941570560834,5.172347010924802,184088.1081871345,0,E01002566,9,0,9,0,0,0,5.16168727903481,5.505349326420979,5.213180712044958,5.295942183287747,5.144805363000158,5.566575574874878,5.285220040757972,232931.18313253013,0,9,0,9,0,0,0,1.0,0,0,0,0,0,0,0
2508,5.663221595667991,5.2485904663550755,5.73281241064312,4.7737418944094365,5.480628949253499,6.091982498890212,5.3626722297748595,186489.0,5,E01002567,4,6,2,5,6,2,5.529217035212415,5.1295467767309635,5.663863833068956,4.902868590456374,5.36955159606663,5.9820341218447854,5.392448357656493,235971.8085106383,4,3,6,3,4,5,2,1.0,-1,-1,0,1,-1,-1,0
2509,5.149984202822861,5.568019553106659,5.291525728848516,5.260507599431641,5.318750217252848,5.650304402623858,5.2159393247292964,185671.41836734695,0,E01002568,9,0,9,1,0,0,5.188588569366854,5.428662543982462,5.33191640860115,5.163207234899982,5.193464015823563,5.685141790926067,5.305347279785505,234957.1568627451,0,8,1,8,1,0,1,1.0,0,-1,1,-1,0,0,1
2510,5.628411807797172,5.240047299861908,5.628375513987108,4.852078281749378,5.405147456580942,6.007076626474207,5.43155419067903,125746.06363636363,5,E01002569,4,5,4,3,5,3,5.503053410781478,5.221842968314262,5.60747706042174,4.955197303364965,5.294128109221678,5.923621043999325,5.491144693047432,153707.62343096235,4,5,5,4,2,4,3,1.0,-1,1,0,0,-1,-1,0
2511,5.8140994290343855,4.862866933606252,6.00787072221772,4.675043208258493,5.525210901468742,6.152483783850149,5.669445850268132,190047.80672268907,7,E01002570,0,9,1,6,7,7,5.833628827875311,4.801605234461382,6.060127120372678,4.737468559879902,5.555611995626087,6.133636181019554,5.777688586022243,241004.64462809917,8,0,9,0,8,8,8,1.0,1,0,0,-1,2,1,1
2512,5.868454571399424,5.315829172730446,5.502002914746602,4.715901596678628,5.608110187782182,5.959637348850568,5.615621902048588,85053.11111111111,7,E01002571,5,3,1,7,4,6,5.822420657532556,5.2496596447059085,5.538139207022531,4.907888481446675,5.430638766288757,5.978102486474174,5.589637891735349,109851.32857142857,8,5,3,3,6,5,5,1.0,1,0,0,2,-1,1,-1
2513,5.866459359071757,5.444200838474851,5.141127704789764,4.775905340517822,5.5520330745922895,5.727901480307705,5.353263957720054,110408.76644736843,7,E01002572,7,0,2,6,1,2,5.979221375010978,5.410151788059821,5.289493640388441,4.81911479529916,5.434581924381675,5.830122668167641,5.433500947249721,139669.0156739812,9,8,0,2,6,2,2,1.0,2,1,0,0,0,1,0
2514,6.350027889213306,4.763791389113305,6.165244694524163,4.3435595875618445,5.799368640720444,6.496753202988797,5.886645050656876,187735.8187919463,9,E01002573,0,9,0,9,9,9,6.110674886476426,4.718809789540816,6.081651392437163,4.517489169730621,5.650529914972734,6.4085050764538,5.971197831387422,238518.8843537415,9,0,9,0,9,9,9,1.0,0,0,0,0,0,0,0
2515,6.143610237935268,4.9678881901119825,5.984776088950831,4.563176411007523,5.696027687930186,6.396180920644638,5.882817747396067,189378.0366972477,9,E01002574,1,9,0,9,9,9,6.146804418203966,4.876546662933421,5.945772947005506,4.672119535365194,5.6278739987679245,6.3535518488794,5.882651374025165,240202.75471698114,9,0,9,0,9,9,9,1.0,0,-1,0,0,0,0,0
2516,5.845287911508275,5.0235957263529984,5.84337482918268,4.6969296815751616,5.572834780846519,6.153683533613709,5.671283546535448,177886.9367816092,7,E01002575,1,8,1,7,7,7,5.817657660197661,4.979963747752195,5.881184183793261,4.757619533235627,5.495071546190736,6.174737425897852,5.699740280305719,227916.6994219653,8,1,8,1,7,8,7,1.0,1,0,0,0,0,1,0
2517,5.854288266028887,5.153167408189656,5.702468115606425,4.6762425619878885,5.58492315698553,6.107330824122017,5.722193518538534,190884.36419753087,7,E01002576,3,6,1,7,6,8,5.819042329815613,5.151509707686545,5.723339261679814,4.73483598848869,5.446150694770375,6.152638825876959,5.846554503358644,242020.4540229885,8,4,7,0,6,8,9,1.0,1,1,1,-1,-1,2,1
2518,6.11105573334192,5.100683403642554,5.843261715612914,4.5746532215883855,5.696823032278764,6.314369703594007,5.810721275837798,186730.5197368421,9,E01002577,2,8,0,9,9,8,5.979216073776459,5.021397889910878,5.790744699798264,4.689600657749843,5.529972541582334,6.3422421408699945,5.933071666664177,238291.18881118883,9,2,8,0,8,9,9,1.0,0,0,0,0,-1,0,1
2519,5.961817302835097,5.214645138574303,5.692907225101366,4.638965241952774,5.62212615384968,6.158912028741399,5.705050343767218,184361.78899082568,8,E01002578,4,6,0,8,7,7,5.841464613977804,5.199748842053394,5.686843293336417,4.742228177078532,5.48572740168987,6.182605324939079,5.782500503963455,234064.15767634855,8,4,6,1,7,8,8,1.0,0,0,0,1,-1,1,1
2520,6.105655388629183,5.315488470361588,5.59973369063215,4.585571876865752,5.709602875912443,6.177251652200171,5.767306310699341,190942.9095744681,9,E01002579,5,4,0,9,7,8,5.911007313704004,5.323415121253656,5.657514690136423,4.726094095682611,5.527334850053398,6.147593454438812,5.749573887610922,242136.70408163266,8,7,6,0,8,8,8,1.0,-1,2,2,0,-1,1,0
2521,5.764705866575241,5.228418496639832,5.631938997818076,4.83001790487248,5.4542929737464245,6.068069257166075,5.492204863092174,183474.36956521738,6,E01002580,4,5,3,4,6,4,5.716792119761645,5.061280116186303,5.668824195861816,4.888164323265269,5.483952178793438,6.068905525288339,5.666828075707969,232201.60169491524,7,2,6,3,7,7,6,1.0,1,-2,1,0,3,1,2
2522,5.623922637104988,5.295194175839424,5.555919322371483,4.906237014383078,5.34895492196083,5.89063794016838,5.462398043274879,185242.125,5,E01002581,5,4,5,2,3,3,5.494506569727799,5.304928914169593,5.497905215602711,5.0525486856881825,5.244231222597368,5.87726973024614,5.432179499257562,234444.68711656443,4,6,3,6,1,3,2,1.0,-1,1,-1,1,-1,0,-1
2523,6.005020953775421,5.075194958748856,5.814324283987526,4.614710531583646,5.502124096319927,6.232435951387979,5.657636823692942,186683.86991869917,8,E01002582,2,7,0,5,8,7,5.785760915101464,5.058069227346733,5.830470747022487,4.655266208435172,5.369145826617284,6.245797466875902,5.753611633137091,236615.08208955225,7,2,8,0,4,9,8,1.0,-1,0,1,0,-1,1,1
2524,5.653844526681033,5.481706924871965,5.372795653343201,4.8922479271888735,5.494515913183039,5.861269085515629,5.428133474696766,209385.83181818182,5,E01002583,8,1,5,5,2,3,5.644424929187216,5.4638629154912355,5.347819342181601,5.053424031056207,5.295731568644786,5.928889516098746,5.514260181579097,267193.5905172414,6,9,1,6,2,4,3,1.0,1,1,0,1,-3,2,0
2525,5.166386608894054,5.599447108996221,5.298383920620649,5.101095135395344,5.244706416741396,5.738391248079447,5.239544176138365,209687.4294871795,0,E01002584,9,0,8,0,1,1,5.131516666169379,5.558001981419363,5.36567832178371,5.231764570163314,5.093080454571232,5.722162831361127,5.3502483808310926,267484.49044585985,0,9,1,9,0,1,1,1.0,0,0,1,1,0,0,0
2526,5.332600814324838,5.632922481607507,5.304087306246346,5.019105970123668,5.267285501515424,5.823058092299803,5.263599651095308,215780.85185185185,1,E01002585,9,0,7,1,2,1,5.114709454382251,5.6465144521461985,5.198615782988999,5.23735909333486,5.122983199393678,5.7524749918612175,5.295104599284555,275945.5089820359,0,9,0,9,0,1,0,1.0,-1,0,0,2,-1,-1,-1
2527,5.3681069158372425,5.597584041968855,5.35835079352061,5.065435665625113,5.304468311329998,5.803427508268407,5.348116088165808,215417.417989418,2,E01002586,9,1,8,1,1,2,5.220396142693894,5.4809094092146085,5.325425145637929,5.178399156575179,5.0758223076957965,5.748805685422907,5.395819221563007,275466.49253731343,1,9,1,8,0,1,2,1.0,-1,0,0,0,-1,0,0
2528,5.302191492915154,5.569668589234352,5.332372509837151,5.062249328494072,5.288155380487442,5.775732085108757,5.357517857551574,215442.41,1,E01002587,9,1,8,1,1,2,5.186385329564413,5.506977128452725,5.36475004196167,5.248585376739502,5.129747449556986,5.870824977027046,5.49758170498742,275599.06666666665,0,9,1,9,0,3,3,1.0,-1,0,0,1,-1,2,1
2529,5.307466077000908,5.615925539745374,5.282773879136932,5.145066347015038,5.311751871966244,5.725240375218767,5.200575965174129,215892.21348314607,1,E01002588,9,0,9,1,1,0,5.2132265738078525,5.583356000939194,5.379067728714067,5.166658132660146,5.114565736177016,5.78555932336924,5.253557248991363,276089.97959183675,1,9,1,8,0,1,0,1.0,0,0,1,-1,-1,0,0
2530,5.262525170013823,5.619757520398874,5.072329481100214,5.148853997732031,5.294864790878076,5.596581229190717,5.168231366694658,216971.2212643678,1,E01002589,9,0,9,1,0,0,5.2703812029162505,5.466797337056492,5.230842246520873,5.211423910853034,5.1510197184477855,5.733975854845381,5.302154522700451,277531.9380053908,1,9,0,9,0,1,1,1.0,0,0,0,0,-1,1,1
2531,5.36795778544444,5.451818828312856,5.412524851613075,5.0512312215829045,5.3970357157149405,5.910180076863031,5.4271783738766075,219661.45911949687,2,E01002590,8,2,7,3,3,3,5.2442829027587985,5.417388052116205,5.455643897439226,5.196750420111197,5.230496591991848,5.870327911259215,5.494053032663134,282449.1172839506,1,8,2,9,1,3,3,1.0,-1,0,0,2,-2,0,0
2532,5.494982231426709,5.468123014924561,5.4156647814905705,4.953784541543482,5.416730224205355,5.9816889563217535,5.5195991505543,229427.33004926107,3,E01002591,8,2,6,3,4,4,5.332188933466871,5.469924396524827,5.385479185730219,5.128030170376102,5.227703222384055,5.907968267798424,5.48532962364455,294939.3333333333,2,9,1,8,1,3,3,1.0,-1,1,-1,2,-2,-1,-1
2533,5.332426471154666,5.668960168292221,5.113254938542264,5.199790180308147,5.247932785923041,5.62815775084264,5.177957941721944,220518.35922330097,1,E01002592,9,0,9,0,0,0,5.356058105217037,5.56290870350976,5.240809114227508,5.226859246044797,5.198547271990865,5.753468735953689,5.250115518897883,283090.529739777,2,9,0,9,1,1,0,1.0,1,0,0,0,1,1,0
2534,5.407043515345751,5.458642541072069,5.347624326681162,5.104189344298788,5.359559896704439,5.867679736314914,5.451886367488217,223638.58874458875,2,E01002593,8,1,8,2,2,3,5.323954916477203,5.377118224620819,5.384436950683594,5.22570531797409,5.180584691524506,5.859119798660278,5.386583333015442,287465.044,2,7,1,9,1,2,1,1.0,0,-1,0,1,-1,0,-2
2535,5.551868118590592,5.402958338249458,5.513741766343094,4.968519302600986,5.500026473416969,6.043013363377029,5.602511127789815,229141.40375586855,4,E01002594,7,3,6,5,5,6,5.3334013521671295,5.304459796897296,5.540919002273987,5.140631251294037,5.275282075692868,5.980622260734953,5.686986621597717,294608.5086206897,2,6,3,8,2,5,7,1.0,-2,-1,0,2,-3,0,1
2536,5.599882646843239,5.370679974555969,5.4208428653669944,4.987165967623393,5.4392312014544455,5.980116917763227,5.57855862747004,218441.85802469135,4,E01002595,6,2,6,4,4,5,5.441234179796317,5.393563073415023,5.4101291459340315,5.182924172817132,5.250544124688858,5.9369933635760574,5.608467386319087,280648.74358974356,3,8,1,8,2,4,5,1.0,-1,2,-1,2,-2,0,0
2537,5.416246294975281,5.680754299257316,5.1381980266446385,5.1818904939040635,5.328384901183883,5.743528130007725,5.212843861455232,224000.49019607843,2,E01002596,9,0,9,1,1,0,5.367404479485054,5.603083915524668,5.1897738475304145,5.18083802523551,5.269430165941065,5.802711175633715,5.488525246644949,288093.1493506493,2,9,0,8,2,1,3,1.0,0,0,0,-1,1,0,3
2538,5.393992451473056,5.446008268451191,5.460967434638458,4.944817802668866,5.44120677353824,6.0086277230247775,5.502084385662179,223958.75392670158,2,E01002598,7,2,6,4,5,4,5.271377972552651,5.398058400656048,5.383212730759069,5.219858977669164,5.195940343957198,5.912595840504295,5.53788023496929,287946.8736842105,1,8,1,9,1,3,4,1.0,-1,1,-1,3,-3,-2,0
2539,5.465818429986636,5.317743695775667,5.4602945148944855,5.080121475458145,5.471783343950907,6.136347842216492,5.612387638290723,223489.01666666666,3,E01002599,5,2,8,4,7,6,5.24249629676342,5.228590130805969,5.502512726932764,5.391450025141239,5.261175165884197,6.076045125722885,5.664753162302077,287374.6796875,1,5,3,9,2,7,6,1.0,-2,0,1,1,-2,0,0
2540,5.540266097878381,5.262835156145713,5.538314989144854,4.942475485287124,5.444371470444494,6.24073877265985,5.7715397155542165,223803.05035971224,4,E01002600,5,3,6,4,8,8,5.305423173328374,5.157931743852244,5.525322678905205,5.112912240444413,5.231276521746744,6.160936129973239,5.754511633175332,287779.73825503356,2,4,3,7,1,8,8,1.0,-2,-1,0,1,-3,0,0
2541,5.592273809256092,5.580804845498454,5.163660280166134,4.991742241286462,5.4342737846797515,5.780135153762756,5.282329970309811,224661.39112903227,4,E01002601,9,0,6,3,1,1,5.538660776530597,5.538956509837022,5.135495997489767,5.141953234131455,5.1610520101608115,5.758333853796019,5.307753416663366,288967.0319148936,4,9,0,8,0,1,1,1.0,0,0,0,2,-3,0,0
2542,5.5781978906783385,5.384190228133075,5.547769607695858,4.830805706766855,5.546150903786178,6.115432458641255,5.760807617575721,224932.57522123895,4,E01002602,7,4,3,6,7,8,5.35631319116955,5.426195716069749,5.510980694747168,5.069091988003944,5.220019563170504,6.07600753957575,5.723262511009027,289333.7355371901,2,8,3,7,1,7,7,1.0,-2,1,-1,4,-5,0,-1
2543,5.494589877279499,5.511812264406228,5.389811808549905,5.04843502934975,5.361442344098151,5.924382931069482,5.526786005195183,222220.3417721519,3,E01002603,8,1,7,2,3,5,5.336830900510152,5.506937293211619,5.232368112405141,5.260045606295268,5.238028239409129,5.854951524734497,5.490974499384563,285809.75333333336,2,9,0,9,1,2,3,1.0,-1,1,-1,2,-1,-1,-2
2544,5.350370160225899,5.6949646380639845,5.067155363482813,5.179161803953109,5.3308773379172045,5.745226473962107,5.250521432199786,226927.11612903225,1,E01002604,9,0,9,1,1,1,5.266812216339773,5.550624972133967,5.158833242565221,5.200014246681522,5.121049792780353,5.6702233077473725,5.221281702118802,291767.9884393064,1,9,0,9,0,0,0,1.0,0,0,0,0,-1,-1,-1
2545,5.087165258719888,5.764026287995594,5.01627012415671,5.341450860802556,5.104956988297718,5.554621395930438,5.06302847576813,229424.1584507042,0,E01002605,9,0,9,0,0,0,4.991257484026888,5.600346463711856,5.057581663131714,5.428393638848506,4.989006113178722,5.528620971866211,5.094735988683129,294882.8832807571,0,9,0,9,0,0,0,1.0,0,0,0,0,0,0,0
2546,5.257757169723511,5.569356119155883,5.275846616744995,5.129481520652771,5.2224124822616576,5.750768444061279,5.370391332626343,231036.392,1,E01002606,9,0,8,0,1,2,5.203303103611387,5.44780803631092,5.320365272719284,5.19202315396276,5.129337893683335,5.713559854441676,5.383668948041982,297016.66896551725,1,8,0,8,0,0,1,1.0,0,-1,0,0,0,-1,-1
2547,5.210815140834222,5.493841585440514,5.404051852531922,5.065463298406357,5.284461719867511,5.879446564576565,5.331291386714349,230280.6794871795,0,E01002607,8,1,8,1,2,1,5.1173149948626495,5.309299201036977,5.45786422649316,5.188150310938338,5.132067110158701,5.842491483793849,5.275582329889314,295999.23451327434,0,6,2,8,0,2,0,1.0,0,-2,1,0,-1,0,-1
2548,5.3668322457026125,5.617568004212967,5.098043572004527,5.186295153751765,5.262065811108236,5.666914276064259,5.193200405329874,231381.73630136985,2,E01002608,9,0,9,1,0,0,5.294891491432318,5.591018862372277,5.106469313570317,5.2734011355662505,5.094010128670891,5.618595534523061,5.215810104504528,297399.0369127517,1,9,0,9,0,0,0,1.0,-1,0,0,0,-1,0,0
2549,5.422325561166476,5.46118169656679,5.378432680108694,4.933177044271757,5.309466385974565,5.92015246172857,5.372666147834096,231034.64804469273,2,E01002609,8,1,5,1,3,2,5.2496697586135,5.300559890472282,5.388616607014069,5.083220003688403,5.18790985568095,5.877235624076283,5.426509635596625,297409.70621468924,1,6,1,7,1,3,2,1.0,-1,-2,0,2,0,0,0
2550,5.233548474912884,5.731731085884137,4.9647579847597605,5.1875355060027095,5.110938472240245,5.618533118766229,5.088260294676495,211225.2324929972,0,E01002610,9,0,9,0,0,0,5.280773424659547,5.7856595601580185,4.916804597927974,5.289104244120874,5.028566819919515,5.58791549705384,5.179262405997562,270675.2652519894,1,9,0,9,0,0,0,1.0,1,0,0,0,0,0,0
2551,5.483924384589668,5.421268729476242,5.384355165936926,4.994294026950458,5.418354995615847,5.9232445847880735,5.480774546528722,229883.21171171172,3,E01002611,7,1,6,3,3,4,5.392309947840629,5.328731590701688,5.442715253080091,5.145343725239077,5.272423562022947,5.9296572179563585,5.542919256514119,295537.68951612903,3,7,2,8,2,4,4,1.0,0,0,1,2,-1,1,0
2552,5.5470994101747015,5.384844765264032,5.462150792193308,4.965632755850906,5.378948117142732,5.893041124427897,5.438556057766146,228496.74008810573,4,E01002612,7,2,6,2,3,3,5.375621690943435,5.323518019538742,5.4743000011186345,5.124689960801923,5.244312971561879,5.917887739233069,5.505319837514345,293756.2972972973,2,7,2,8,1,3,3,1.0,-2,0,0,2,-1,0,0
2553,5.570103692103036,5.4711095298392864,5.479988113988804,4.948007754132718,5.46434655898734,6.018569507176363,5.703338843357714,230208.92405063292,4,E01002613,8,2,6,4,5,7,5.424312211905315,5.335824877593168,5.590253495866326,5.063578855459857,5.331293895745733,6.01469893516249,5.657154416582387,295924.6560509554,3,7,4,7,3,5,6,1.0,-1,-1,2,1,-1,0,-1
2554,5.555033794471195,5.503679325750896,5.363753101655415,4.886908369404929,5.420690388338906,5.82254099547863,5.263953096100262,225216.99285714285,4,E01002614,8,1,5,3,2,1,5.420188295080306,5.364814989955713,5.301548580751351,5.123530365473835,5.268918157892024,5.800909026294735,5.344224759872923,289663.3404255319,3,7,0,8,2,1,1,1.0,-1,-1,-1,3,-1,-1,0
2555,5.50821060177527,5.610143667773197,5.195135477734239,4.963880155039461,5.389477432558411,5.740022467939477,5.187662811263611,229836.28618421053,3,E01002615,9,0,6,3,1,0,5.4350910663604735,5.515381317708029,5.258231675802771,5.1596633092680975,5.2532149236593675,5.823235128530816,5.271087057910749,295342.2,3,9,0,8,2,2,0,1.0,0,0,0,2,-1,1,0
2556,5.549563408579145,5.44927472114563,5.4162431846346175,5.012608336039952,5.50809910093035,5.9989239106859475,5.495771267073495,224692.19428571427,4,E01002616,8,2,7,5,5,4,5.387026876368851,5.310960380488603,5.452328254306127,5.111088116332968,5.29850314470826,6.001874970380591,5.592552616482689,288966.75132275134,3,6,2,7,3,5,5,1.0,-1,-2,0,0,-2,0,1
2557,5.830525459693028,5.474541287697279,5.346903701470448,4.833231751276896,5.612202494878035,5.999554230616643,5.521650032813732,231192.53461538462,7,E01002617,8,1,4,8,5,4,5.717886233147774,5.378759882832301,5.346989026506439,4.986333390228621,5.425601901898857,6.025672091782548,5.480192166248351,297220.5763358779,7,7,1,5,6,6,3,1.0,0,-1,0,1,-2,1,-1
2558,5.825791198437608,5.155440797017315,5.70956470459465,4.738312987830695,5.644684380433691,6.235571846248597,5.94114103842908,206816.25984251968,7,E01002618,3,6,2,8,8,9,5.604781584579404,5.136505848219414,5.5759509982181195,5.043976739675057,5.372606561965301,6.123334898668177,5.887428626292894,263591.00840336137,5,3,4,6,4,7,9,1.0,-2,0,-2,4,-4,-1,0
2559,5.4169908310427815,5.375238076303944,5.5132386341239465,4.914203821709662,5.4158714251084765,5.983760167251933,5.514056241873539,211111.85606060605,2,E01002619,6,3,5,3,4,4,5.13800811586958,5.369283782713341,5.480508300391111,5.160296401291182,5.188787251710892,5.901958788886215,5.447046889500185,268816.3939393939,0,7,2,8,1,3,2,1.0,-2,1,-1,3,-2,-1,-2
2560,5.384981913001914,5.430192601523902,5.352716048297129,5.08295034577972,5.315045820255029,5.777166658326199,5.249115776858832,205656.90131578947,2,E01002620,7,1,8,1,1,1,5.323704296189385,5.383852515349517,5.317287660289455,5.072970524994103,5.151764979877988,5.766767915519508,5.312716141906945,262059.63243243244,2,8,0,7,0,1,1,1.0,0,1,-1,-1,-1,0,0
2561,5.517942639216324,5.412204284609461,5.393593708430331,4.983075010264578,5.492902849349507,5.96809843420251,5.656469824123968,207402.82208588958,3,E01002621,7,1,6,5,4,7,5.482855068650215,5.369874912462417,5.414100713031307,5.060758779762657,5.291814698535166,5.950078028022864,5.658309908429528,264259.89171974524,4,7,1,7,2,4,6,1.0,1,0,0,1,-3,0,-1
2562,5.615480645400722,5.441615043616876,5.507581520371321,4.83617795822097,5.503714676310376,6.017908036708832,5.635027526355371,214494.2743902439,4,E01002622,7,3,4,5,5,6,5.47961615556958,5.3770002284269225,5.4658647844161115,5.080562608680506,5.242563966361955,6.022095988536703,5.7168019646885755,274326.1264367816,4,7,2,7,1,6,7,1.0,0,0,-1,3,-4,1,1
2563,5.5138632694880165,5.333030008474986,5.514203364849091,4.956571149031321,5.374707698027293,5.954973802566529,5.5362495080629985,212550.39333333334,3,E01002623,6,3,6,2,4,5,5.491500438004732,5.399535080790519,5.4343688294291495,4.998959464579821,5.246328541636467,5.947398683428764,5.668808260560036,271548.13125,4,8,2,5,2,4,6,1.0,1,2,-1,-1,0,0,1
2564,5.543508676545961,5.310003076280866,5.451580753283841,4.941632258040564,5.500055947474071,5.962005532213619,5.637272188706057,211804.64285714287,4,E01002624,5,2,6,5,4,6,5.45672281989216,5.227085934938305,5.412782232256701,5.122878365273023,5.280813234565902,5.78938956939391,5.548701458603796,270757.65693430655,3,5,1,8,2,1,4,1.0,-1,0,-1,2,-3,-3,-2
2565,5.4782740455901555,5.493184367339768,5.43047426489299,4.988862055504393,5.463995440277511,5.9816635268890925,5.479944971507181,204937.25748502993,3,E01002625,8,2,6,4,4,4,5.394989527302024,5.47728924471655,5.4372537423063205,5.115808657657953,5.19521525171068,5.9747602159594315,5.5970846289469876,261002.95061728396,3,9,2,7,1,5,5,1.0,0,1,0,1,-3,1,1
2566,5.456244668083875,5.5217854212217805,5.226593875029696,5.033961787352113,5.367556290776205,5.817247789536891,5.4033535141581375,205028.52466367712,3,E01002626,8,0,7,2,2,2,5.518316162502305,5.405665743504471,5.414334919319644,5.0115560564360395,5.235731712738332,5.926259829762667,5.584996674705472,261191.3347639485,4,8,1,6,1,4,5,1.0,1,0,1,-1,-1,2,3
2567,5.657937381002638,5.476159153161226,5.387724240620931,4.8965870980863215,5.52719090603016,5.909417337841457,5.342750959926182,205185.0,5,E01002627,8,1,5,6,3,2,5.500042278375199,5.387100095179544,5.558299274586919,5.018288929071,5.315292415334217,5.97369825662072,5.375418629219283,261318.40298507462,4,8,4,6,3,5,1,1.0,-1,0,3,1,-3,2,-1
2568,5.497990446485532,5.337933955678515,5.476748797544248,4.9834632577410165,5.418792174879912,5.899131503074792,5.432973046970975,206452.48407643312,3,E01002628,6,2,6,3,3,3,5.356517185876657,5.327809067872854,5.451764915670667,5.045027482640612,5.273173596177783,5.8632874842528455,5.492682698663774,263055.4505494505,2,7,2,6,2,2,3,1.0,-1,1,0,0,-1,-1,0
2569,5.504549594215266,5.370611950837446,5.413294838936948,5.036899815606808,5.406608755417292,5.912307396119471,5.559603483637393,207288.773480663,3,E01002629,6,2,7,3,3,5,5.416268684224384,5.312741117361115,5.472865341349346,5.055091056591127,5.32083932015954,5.964899773714019,5.575190968048282,264375.4926829268,3,6,2,6,3,4,5,1.0,0,0,0,-1,0,1,0
2570,5.371387065320775,5.451704443364903,5.434506931166718,5.104079270708388,5.301097982171653,5.914805465850277,5.4119247353595235,206801.115942029,2,E01002630,8,2,8,1,3,3,5.408504538475328,5.350056166102172,5.486165484805016,5.0030715921122555,5.173648554048721,5.914511320697274,5.648969876538416,263414.1401273885,3,7,2,5,0,3,6,1.0,1,-1,0,-3,-1,0,3
2571,5.264357436378047,5.551194355172931,5.355997981890193,5.091064093247899,5.224116246655302,5.724773038108394,5.237728614852114,211091.5754716981,1,E01002631,9,1,8,0,1,1,5.05072419010863,5.410057343998734,5.347450362176311,5.215629176217682,4.987340936855394,5.716002797593876,5.358988915170942,269945.64285714284,0,8,1,9,0,0,1,1.0,-1,-1,0,1,0,-1,0
2572,5.596494791366286,5.39597842905481,5.382158518342648,4.933820637100834,5.336142747078911,5.991821557788525,5.580031050968978,210522.63559322033,4,E01002632,7,1,5,2,4,5,5.487403734626933,5.411210049421359,5.370625349191519,5.004362616274092,5.1684456503289375,5.948467719249236,5.615855630136963,269052.952991453,4,8,1,5,0,4,5,1.0,0,1,0,0,-2,0,0
2573,5.389974878856114,5.74358478137425,4.9140469149180825,5.161598482472556,5.2018990560940335,5.591618358407702,5.0694530837876455,214190.60571428572,2,E01002633,9,0,9,0,0,0,5.373494313505596,5.642774445568016,5.054217262539321,5.2266824113394685,5.060957028123433,5.702226154818506,5.229424044757546,273869.0,2,9,0,9,0,0,0,1.0,0,0,0,0,0,0,0
2574,5.263148440491586,5.645815398721468,5.186778761801266,5.045665641625722,5.246129006147385,5.762311428785324,5.171913396744501,215504.23214285713,1,E01002634,9,0,7,0,1,0,5.370310565172615,5.518934152894101,5.28517270492295,5.077518010543565,5.168905972087451,5.915455272642233,5.309872771387046,275690.3163841808,2,9,0,7,0,3,1,1.0,1,0,0,0,0,2,1
2575,5.490980188463636,5.543247451436335,5.344508186523161,4.939624723992817,5.4744717290364395,5.8923756347419065,5.476801567744714,215842.89119170984,3,E01002635,9,1,6,4,3,4,5.348200136327488,5.396951546006024,5.468940845785294,5.080001936239355,5.294308229563708,6.039536486334979,5.649007777479243,276009.0588235294,2,8,2,7,2,6,6,1.0,-1,-1,1,1,-2,3,2
2576,5.2810024478053315,5.421130354167851,5.5156347933616345,5.078951547164043,5.328287373972303,5.903749238443739,5.51556932744179,214515.45801526718,1,E01002636,7,3,8,1,3,4,5.112871821654045,5.349656225261041,5.462381261890218,5.269363522529602,5.176092238749488,5.796456177355879,5.420791258246211,274412.27966101695,0,7,2,9,0,1,2,1.0,-1,0,-1,1,-1,-2,-2
2577,5.126864690127247,5.7768097170587875,4.992298652409812,5.239822848892768,5.041884525871833,5.493768845980786,4.930948137541901,211036.43731778426,0,E01002637,9,0,9,0,0,0,5.18237665468011,5.730125020686589,5.0080373195248855,5.327496631743165,4.906274854972671,5.622688364391484,5.133290807734507,269169.2093663912,0,9,0,9,0,0,0,1.0,0,0,0,0,0,0,0
2578,5.490233838558197,5.663466197329682,5.082078104669398,5.0383777289421525,5.246928492536792,5.742207249263664,5.193113279807103,215049.1883116883,3,E01002638,9,0,7,0,1,0,5.544279425339858,5.608666121416179,5.184570055964508,5.059287535383346,5.078258297363676,5.820869568271116,5.32235647878386,275125.93617021275,5,9,0,6,0,2,1,1.0,2,0,0,-1,0,1,1
2579,5.473536518132575,5.323781661898177,5.597687161971476,5.0090957445518995,5.475155556313346,6.091677503051045,5.644466742176876,207520.3551401869,3,E01002639,6,4,7,4,6,6,5.309561798505694,5.17694833679734,5.621640683334564,5.079065103397191,5.360640407722687,6.090128410642392,5.817042241586703,264469.7663551402,2,4,5,7,4,7,8,1.0,-1,-2,1,0,0,1,2
2580,5.433997153199237,5.339484707168911,5.615617588291998,4.976160783353059,5.413004459505496,6.120513484788978,5.493886176399562,208227.24347826088,2,E01002640,6,5,6,3,7,4,5.4929143034893535,5.101172174232594,5.737374009429544,4.8996836085250415,5.365204773087433,6.0966974341351055,5.629757526128189,265397.5,4,3,7,3,4,7,6,1.0,2,-3,2,-3,1,0,2
2581,5.510832139036872,5.362590619108894,5.578259260365457,4.890914143034906,5.388876374020721,5.979745299527139,5.473067922122551,210443.71212121213,3,E01002641,6,4,5,3,4,4,5.5832678002970555,5.083275141886302,5.742631653376988,4.8975902421133855,5.41997361098017,6.073952691895621,5.55986043555396,268648.0714285714,5,3,7,3,6,7,4,1.0,2,-3,3,-2,3,3,0
2582,5.183688646868656,5.223300127955208,5.540102290828326,5.160143850839626,5.3376738606837755,5.774793333477444,5.368726339256554,210600.33333333334,0,E01002642,4,3,9,2,1,2,5.133450679357539,5.145867433995832,5.590180208011227,5.205426237859778,5.207845415858274,5.803411504840324,5.3919044877942754,268649.0497237569,0,4,4,9,1,1,2,1.0,0,0,1,0,-1,0,0
2583,5.4165355590433855,5.383325571328207,5.4790220182705545,4.9897222861745,5.394163028866637,5.890797283135209,5.5001772392809,209924.86928104574,2,E01002643,7,2,6,3,3,4,5.3228483767044255,5.214178913977088,5.48734544399308,5.149866285847454,5.299780732247887,5.892444443411943,5.537873082771534,267947.8841463415,2,5,2,8,3,3,4,1.0,0,-2,0,2,0,0,0
2584,5.659058633651442,5.37467922600171,5.556188366795314,4.914884251492624,5.525954433069884,5.990486820235507,5.413025006993126,212369.41984732824,5,E01002645,6,4,5,6,4,3,5.579520761537895,5.234007088400477,5.54076642441235,4.956532913146259,5.405866532017001,6.003702400399627,5.442315255995277,271125.22302158276,5,5,3,4,5,5,2,1.0,0,-1,-1,-1,-1,1,-1
2585,5.3724444717423525,5.327889113344698,5.5060574274796705,5.02244836754269,5.374155923851535,5.851077599403186,5.377898204020965,214387.36752136753,2,E01002646,6,3,7,2,2,2,5.2857870446692266,5.270217264298912,5.576664317426064,5.0811385182167985,5.273496843070435,5.874357751805148,5.58641129775013,273917.1510791367,1,6,4,7,2,3,5,1.0,-1,0,1,0,0,1,3
2586,5.30937811088562,5.492680212974548,5.379678949356079,5.1569353942871095,5.350701515197754,5.855529623031616,5.387419263839722,222908.896,1,E01002647,8,1,9,2,2,2,5.183838753299859,5.390482508499204,5.441017773315196,5.138788277866277,5.184662579580118,5.877271224524229,5.572954924051999,285332.24427480914,0,8,2,8,1,3,5,1.0,-1,0,1,-1,-1,1,3
2587,5.30687633551747,5.324361045676541,5.574273656649762,5.014566723840782,5.397917769759534,5.829099429659097,5.3167956988495515,213235.22891566265,1,E01002648,6,4,7,3,2,1,5.328277533159316,5.206894997530763,5.511571333843207,5.0603571118048905,5.271246209834357,5.839567658286424,5.4481967792570964,272641.1698113208,2,4,3,7,2,2,2,1.0,1,-2,-1,0,-1,0,1
2588,5.62726790830493,5.1981393352150915,5.609458996355533,4.830274268984795,5.516133961081505,5.991096962988377,5.394248501956463,214693.34375,5,E01002649,3,5,3,5,4,2,5.531368738838604,5.156960945044245,5.659220388247853,5.003981735734713,5.367254044328417,5.966230169648216,5.51655698461192,274682.17261904763,4,4,6,5,4,4,4,1.0,-1,1,1,2,-1,0,2
2589,5.324445342024167,5.59735386286463,5.245453075993629,5.110542130612192,5.2916221760568165,5.748988164322717,5.25828702605906,227218.67261904763,1,E01002650,9,0,8,1,1,1,5.45811935816661,5.443800767459492,5.314971620493596,5.086000136809774,5.243660920327253,5.8137542811950835,5.452117536327626,291026.8118811881,3,8,0,7,1,2,2,1.0,2,-1,0,-1,0,1,1
2590,5.376835614442825,5.300220972547929,5.502892265717189,4.994523769865434,5.370816710094611,5.989604741334915,5.448395762592554,217703.63541666666,2,E01002651,5,3,6,2,4,3,5.3535114144815985,5.160677144828352,5.6241652988693085,4.987358822405917,5.193862557411194,5.970748845813344,5.611894063579226,277928.98058252427,2,4,5,5,1,5,5,1.0,0,-1,2,-1,-1,1,2
2591,5.511865913310897,5.369821082765811,5.567891602204225,4.892009071100538,5.447624295671409,5.978535320157203,5.528682490375554,221528.30841121497,3,E01002652,6,4,5,4,4,5,5.39807198699723,5.111869044792958,5.646133113111186,4.967355581430288,5.299621340556023,6.060035067745763,5.643947675696805,284496.1794871795,3,3,5,5,3,6,6,1.0,0,-3,1,0,-1,2,1
2592,5.642544951958534,5.350049425394107,5.627202041638204,4.832998601289896,5.446501281016912,6.125287930170695,5.803174057067969,212841.58333333334,5,E01002653,6,5,4,4,7,8,5.467811976373196,5.140625682473183,5.654713925719261,4.951566041260958,5.457743752747774,6.096203963458538,5.830336875468492,271773.89375,4,3,5,4,7,7,8,1.0,-1,-3,0,0,3,0,0
2593,5.652814081520032,5.363345110492342,5.637530747492602,4.855139121128495,5.503528458297632,6.133154219123209,5.6504143992806695,215588.3821656051,5,E01002654,6,5,4,5,7,7,5.510742219466737,5.26835397235508,5.572840535440925,4.9633190378796455,5.31096870073393,6.023716741434023,5.743878280650304,276051.0782122905,4,6,4,5,3,6,7,1.0,-1,0,-1,1,-2,-1,0
2594,5.799237943056858,5.196043954654173,5.7060972705031885,4.788828293482463,5.555187971302957,6.212090895934538,5.797498026580522,214828.5909090909,7,E01002655,3,6,3,6,8,8,5.6379907439355135,5.072034583610742,5.710544620241437,4.89729457323243,5.388073440311717,6.1421567258380705,5.801855515460579,274772.537414966,6,2,6,3,5,8,8,1.0,-1,-1,0,0,-1,0,0
2595,5.6860597607685115,5.468469618356716,5.398466458794666,5.05067459254237,5.448438930929753,5.9725696691992685,5.431988676389058,219585.09356725146,5,E01002656,8,1,7,4,4,3,5.455366585203397,5.3394922069323965,5.451656274257168,5.013840827890622,5.263836107587301,5.952086187178089,5.654823613423173,281886.79569892475,3,7,2,6,2,4,6,1.0,-2,-1,1,-1,-2,0,3
2596,5.723887401677313,5.227384493464515,5.613968148117974,4.834877097890491,5.50342427548908,6.1261158628123145,5.62287643126079,218659.875,6,E01002657,4,5,4,5,7,6,5.497626820715462,5.118888325807525,5.633786101893681,4.940132259595685,5.31359107247213,6.077006476681407,5.873220036669475,280543.0487804878,4,3,5,4,3,7,9,1.0,-2,-1,0,0,-2,0,3
2597,5.966451179413569,5.21896341949904,5.6394960572119475,4.6869336723470365,5.6431153712629465,6.1503364358629495,5.705312149054339,211384.25170068027,8,E01002658,4,5,1,8,7,7,5.867042770385742,5.080488042831421,5.623019866943359,4.768042229811351,5.470285943349203,6.208687946001689,5.772182814280192,269753.31333333335,8,2,5,1,7,8,8,1.0,0,-2,0,0,-1,1,1
2598,5.597922565293138,5.471572422633206,5.500276076532629,4.871714538901392,5.495425909105008,6.071550268326362,5.644140343596465,212370.77372262772,4,E01002659,8,3,4,5,6,6,5.414167148001651,5.239018821335853,5.4888605183743415,5.047315782054942,5.282082056111478,5.956433795868082,5.536930665690848,271192.579787234,3,5,2,6,2,4,4,1.0,-1,-3,-1,2,-3,-2,-2
2599,5.396626499322084,5.411531639528704,5.469050250611864,4.933155960864849,5.403341664924278,5.896758300764066,5.50275292912045,213208.4054054054,2,E01002660,7,2,5,3,3,4,5.319234587644276,5.240379377415306,5.532973653391788,5.046056870828595,5.293430890953331,5.895039146406608,5.440924207369487,272286.29824561405,2,5,3,6,2,3,2,1.0,0,-2,1,1,-1,0,-2
2600,5.035847517497399,5.567013116443858,5.394848178414738,5.321731390321956,5.23120034792844,5.699086478527854,5.323319094145999,214612.03676470587,0,E01002661,9,1,9,0,0,1,4.9668601133993695,5.394093942429338,5.378810394023146,5.340550939951624,5.005870945751667,5.644631724272456,5.279305736933436,274309.84821428574,0,8,1,9,0,0,0,1.0,0,-1,0,0,0,0,-1
2601,5.562740765461306,5.205340032674829,5.690416662060485,4.960446206890807,5.454030627296085,6.044011656118899,5.709194111175278,211703.6326530612,4,E01002662,4,6,6,4,5,7,5.486762453066675,5.038417495395008,5.7145941398645705,5.001992853848558,5.37511762270802,6.066067543468978,5.7248639197725995,270248.875,4,2,7,5,4,6,7,1.0,0,-2,1,-1,0,1,0
2602,5.465841862559318,5.382679452002049,5.489572565257549,4.9852459475398065,5.372852940112352,5.87855441570282,5.360711692273616,212287.8375,3,E01002663,7,3,6,2,2,2,5.431498833677986,5.281968376853249,5.538401171565056,4.994887745515867,5.3142257251522755,5.860901231115514,5.368171112103895,271055.0,3,6,3,5,3,2,1,1.0,0,-1,0,-1,1,0,-1
2603,5.304487859025413,5.384703794379293,5.509037912627797,5.060998838624837,5.3368711258158275,5.805853098998835,5.3160640273565125,213156.33333333334,1,E01002664,7,3,8,2,2,1,5.288304659186816,5.2655655979458755,5.535085613610314,5.163473314926272,5.29122386799484,5.841645898714743,5.384451292903045,272029.35519125685,1,6,3,8,2,2,1,1.0,0,-1,0,0,0,0,0
2604,5.258487577197933,5.408519361199451,5.395587380192861,5.078400404513383,5.288919971770599,5.789200911000997,5.438839932449725,215567.00840336134,1,E01002665,7,1,8,1,1,3,5.293716974922868,5.210721008113174,5.530192015600986,5.1314567718349515,5.216484513439116,5.851247502154991,5.4983864856548,275912.262295082,1,5,3,8,1,2,3,1.0,0,-2,2,0,0,1,0
2605,5.266570843608174,5.405779075938344,5.3730971750044665,5.047129939723488,5.305427376797657,5.864246317882412,5.510894453288704,214587.35099337748,1,E01002666,7,1,7,1,2,4,5.349281330286346,5.238662595334261,5.472440242026904,5.114582169870412,5.195504957104322,5.917367354683254,5.497831123956242,274478.04347826086,2,5,2,7,1,3,3,1.0,1,-2,1,0,0,1,-1
2606,5.62799473848637,5.33102792475192,5.476833009509789,4.849592886307166,5.4682670264517155,5.861915945481623,5.415704618991734,194103.76651982378,5,E01002667,6,2,4,4,2,3,5.5929955472034285,5.208169338237717,5.543633195033586,4.9926989947657185,5.358856741175709,5.904487289755468,5.551923896686964,246529.63346613545,5,5,3,5,4,3,4,1.0,0,-1,1,1,0,1,1
2607,5.418687357378833,5.490403145034878,5.3178754100909815,5.05410200598612,5.301988026310254,5.746491456996499,5.287940708888059,198655.26589595375,2,E01002668,8,1,7,1,1,1,5.388109377040955,5.3641794850860816,5.379259962966477,5.138050964489075,5.171813909558282,5.774065814732354,5.42540741254742,251721.95169082127,3,7,1,8,0,1,2,1.0,1,-1,0,1,-1,0,1
2608,5.529855525171435,5.514838134920275,5.370674307926281,4.968103921735609,5.360602474212646,5.966404877482234,5.425908472086932,210658.26486486488,3,E01002669,8,1,6,2,4,3,5.408169486910798,5.341382779631504,5.448652696609497,4.992269506010898,5.166205136166062,5.882058343221975,5.441699681171151,269103.5581395349,3,7,2,5,0,3,2,1.0,0,-1,1,-1,-2,-1,-1
2609,5.552482219842764,5.396271452203497,5.459407579648745,5.015257243509893,5.42887501616578,5.900460554169608,5.4222859577699145,201709.3076923077,4,E01002670,7,2,7,3,3,3,5.479746144817722,5.334538524381576,5.4891384878466205,5.083178411760638,5.200226329218957,5.994375165816276,5.65646252247595,258076.61290322582,4,7,2,7,1,5,6,1.0,0,0,0,0,-2,2,3
2610,5.61071286842837,5.474875717135201,5.555967445261994,4.883110981935646,5.4527979426913795,6.043992393895199,5.5193374080267565,201069.865497076,4,E01002671,8,4,5,4,5,4,5.491314226038316,5.244574895325829,5.615394330024719,4.945719742073733,5.252140968687394,6.042248487472534,5.689323437213898,255098.85294117648,4,5,5,4,2,6,7,1.0,0,-3,1,-1,-2,1,3
2611,5.473098848835897,5.601860927323163,5.394787653017852,5.049275122456631,5.315859364250959,5.88799866983446,5.364045056246095,215752.58474576272,3,E01002672,9,1,7,1,3,2,5.299188167908612,5.461573827967924,5.384533452987671,5.19248047506108,5.130540399691638,5.749495934738833,5.452278040437138,278304.77647058823,1,9,1,8,0,1,2,1.0,-2,0,0,1,-1,-2,0
2612,5.404661605755488,5.3733411729335785,5.56537879506747,5.09072341521581,5.4631262222925825,5.756159991025925,5.290797367691994,220061.79166666666,2,E01002673,6,4,8,4,1,1,5.285867556929588,5.355891048908234,5.581394121050835,5.286415591835976,5.034714117646217,5.7988600730896,5.603378802537918,282811.4375,1,7,4,9,0,1,5,1.0,-1,1,0,1,-4,0,4
2613,5.647681580348448,5.476906161416661,5.490989016764091,4.925192165555376,5.512512165488618,5.9346200354171526,5.495483647693288,206763.43181818182,5,E01002674,8,3,5,5,3,4,5.678325488585834,5.314994291741718,5.51281446634337,4.908320053603298,5.422571660012238,6.074853398079096,5.597286232682162,263397.92248062015,6,6,3,3,6,7,5,1.0,1,-2,0,-2,1,4,1
2614,5.752764300746812,5.240127938887032,5.63578678231213,4.810968198170319,5.550930112764981,6.1668106205555615,5.7559516739450105,204824.19337016574,6,E01002675,4,5,3,6,7,8,5.69529731203528,5.094120064202477,5.678118192448336,4.854475151791292,5.395972476286047,6.136313808665556,5.904554369169123,260712.7117647059,6,3,6,2,5,8,9,1.0,0,-1,1,-1,-1,1,1
2615,5.789919953368026,5.398790084608069,5.371600437926375,4.890020789076749,5.543905518915011,5.990401026320784,5.642471673826105,205929.8310502283,6,E01002676,7,1,5,6,4,6,5.6304387057845915,5.423013605664124,5.439834593528479,4.970803459685053,5.371268349077234,6.015792638213191,5.663521631279183,262423.5175879397,6,8,2,5,4,5,6,1.0,0,1,1,0,-2,1,0
2616,5.610134527625807,5.245319947420833,5.54011844798743,4.9609488629433045,5.403811005224664,5.908159696912191,5.548236953924937,207534.1626506024,4,E01002677,4,3,6,3,3,5,5.489145688667983,5.1311310415496365,5.547921441272347,5.0107872700262925,5.317152039019647,5.910280226233477,5.5959275539763675,264451.3353293413,4,3,3,6,3,3,5,1.0,0,-1,0,0,0,0,0
2617,5.589129458051739,5.6667957732171725,4.944392304528844,5.074688322435726,5.263072871800625,5.6450365415125185,5.183267268448165,201927.65757575756,4,E01002678,9,0,8,1,0,0,5.6227842079082,5.663312540423703,5.006719943671159,5.094963454696494,5.1295788101747,5.718100841280441,5.318363877081535,256259.12535211266,6,9,0,7,0,0,1,1.0,2,0,0,-1,-1,0,1
2618,5.379207673504597,5.520950679234632,5.3709392143985415,5.024143160328152,5.314105990364796,5.962472046454121,5.4509437999387425,198236.031496063,2,E01002679,8,1,7,1,4,3,5.245876112018191,5.521199704489249,5.307326445375898,5.173459543452144,5.111918570732307,5.856216857441804,5.486515814299261,249188.8612099644,1,9,0,8,0,2,3,1.0,-1,1,-1,1,-1,-2,0
2619,5.819006174075894,5.311343069968185,5.543855513014445,4.823557312895612,5.5637297606080525,6.034620010755895,5.657805865857659,206624.26829268291,7,E01002680,5,3,3,7,5,7,5.792326674356565,5.266482914323772,5.542541202608046,4.898956097525991,5.423038635935102,6.117696214508224,5.776721952162383,263240.7838827839,7,6,3,3,6,7,8,1.0,0,1,0,0,-1,2,1
2620,5.500615888248289,5.34924312409638,5.484101025355344,4.992395478176933,5.389178008702449,5.956522656313946,5.53782651327938,189307.65895953757,3,E01002681,6,3,6,3,4,5,5.281733046498215,5.312903484754395,5.4599653189642385,5.12206265016606,5.128074615148076,5.863951129871502,5.56683298004301,239963.72807017545,1,6,2,8,0,2,4,1.0,-2,0,-1,2,-3,-2,-1
2621,5.751833094704535,5.311995852378107,5.446102306727441,4.813393527942319,5.499014348272355,5.932683170803132,5.55531265466444,188042.34677419355,6,E01002682,5,2,3,5,3,5,5.6690311819820085,5.257692343905821,5.526641614558333,4.915412576723907,5.346331147824303,5.947314336744405,5.597209121009051,238362.4813559322,6,5,3,4,4,4,5,1.0,0,0,1,1,-1,1,0
2622,5.478266401524924,5.259006577766746,5.574293135133989,4.824354748053054,5.389577150344849,5.961604380168798,5.353217441611495,200507.79141104294,3,E01002683,4,4,3,3,4,2,5.523955804141448,5.161801534540513,5.695995013344096,4.899251090651528,5.326178299551979,5.9880211493548225,5.623142259006194,255226.3422459893,4,4,6,3,3,5,6,1.0,1,0,2,0,0,1,4
2623,5.399208775003448,5.357912847558961,5.448540718045853,5.075813807603967,5.370980261846353,5.770214754661531,5.3337102905484555,186905.91984732824,2,E01002684,6,2,8,2,1,1,5.415404941859069,5.249165409141117,5.46351174513499,5.030556547200239,5.282341981817175,5.795243392608784,5.330720442312735,236836.45185185186,3,5,2,6,2,1,1,1.0,1,-1,0,-2,0,0,0
2624,5.611135295991387,5.417636552027294,5.3873055172818045,4.905085267765181,5.508918426930904,5.947945305279323,5.4797247025583475,187723.35267857142,4,E01002686,7,1,5,5,4,4,5.5545136695106825,5.419682049254576,5.25230833341678,5.042045788466931,5.278863584001859,5.879192321499189,5.402987097203732,237890.2,5,8,0,6,2,3,2,1.0,1,1,-1,1,-3,-1,-2
2625,5.9994464094440145,5.1077153732379275,5.786211974091,4.711925118333763,5.581819369561142,6.1714643827743,5.7396444785926075,189142.57638888888,8,E01002687,2,7,1,7,7,8,5.961235739826377,5.009536034920636,5.876020892772799,4.736482568036497,5.546604861620984,6.189277648925781,5.823447821966184,239430.88235294117,9,2,8,0,8,8,8,1.0,1,0,1,-1,1,1,0
2626,5.645946525037289,5.16780630924872,5.700648499386651,4.81502283683845,5.468178778886795,6.1031355666262765,5.488919286855629,166627.2857142857,5,E01002689,3,6,3,4,6,4,5.532995646750486,5.076415746300309,5.690816693835789,4.998126810347593,5.3058653440740375,6.015991950476611,5.424982366738496,219069.0185185185,4,2,6,5,3,5,2,1.0,-1,-1,0,2,-1,-1,-2
2627,6.167017264473707,5.050638382596181,5.94085477079664,4.4783751444709035,5.715345958121737,6.326991710447727,5.8819488690311745,189827.51127819548,9,E01002690,1,9,0,9,9,9,6.053378351899081,4.977457329284313,5.9191289705823555,4.58205678389054,5.547413918399071,6.283733916837115,5.858023282169372,241745.6511627907,9,1,9,0,8,9,9,1.0,0,0,0,0,-1,0,0
2628,5.735047556772954,5.321340179243007,5.3771995185803965,4.786433807441166,5.461339206755662,5.905878793291685,5.3705273571134615,183203.6386554622,6,E01002691,6,1,3,4,3,2,5.547407181933522,5.377056083083152,5.25395298153162,5.058082464709878,5.206518148258328,5.853039272874594,5.3861738733947275,232499.1875,5,7,0,6,1,2,1,1.0,-1,1,-1,3,-3,-1,-1
2629,5.485037982463837,5.298320024101822,5.625517329132116,4.965015140948473,5.36981962621212,5.85261812530182,5.430034380820063,184263.66666666666,3,E01002692,5,5,6,2,2,3,5.474703421324363,5.23368957858065,5.645711187676434,4.925012030642786,5.330411306707374,5.925493629463824,5.554042355322735,233435.01298701297,4,5,5,4,3,4,4,1.0,1,0,0,-2,1,2,1
2630,5.785438863777675,5.068136676688867,5.787513223893804,4.723426133577077,5.55569076684355,5.97643492265713,5.508693709695266,189973.6809815951,6,E01002693,2,7,1,6,4,4,5.76077422251304,4.9695940768967075,5.83522086776793,4.755995651086171,5.561913429449002,6.059408973902464,5.635967019945383,240884.33854166666,7,1,8,1,8,6,6,1.0,1,-1,1,0,2,2,2
2631,5.436879068204801,5.16853326640717,5.652894498550729,5.084201224862713,5.420486936830494,5.77096427303471,5.308973219296703,116679.8493150685,2,E01002694,3,5,8,3,1,1,5.474249063394009,5.040322661399841,5.706998932055938,4.925946689569033,5.379666426242927,5.798209890341147,5.427499647323902,147787.03846153847,4,2,6,4,4,1,2,1.0,2,-1,1,-4,1,0,1
2632,5.40287433233526,5.032711588674122,5.721327536635929,5.011239124668969,5.472706132464939,5.792711115545696,5.513631299138069,117106.23611111111,2,E01002695,1,6,7,4,1,4,5.397096277475357,4.9503981411457065,5.717405908107757,5.021079491376877,5.3782705044746395,5.778057157993317,5.495478955507278,148333.85,3,1,7,6,4,1,3,1.0,1,0,1,-1,0,0,-1
2633,5.500782499390263,4.982790243241094,5.830361291285484,4.8663393316730374,5.431469613505948,5.79537360706637,5.523553570432048,116842.70967741935,3,E01002696,1,8,4,3,1,4,5.3999912138526325,4.919624664259295,5.749650261926313,4.976031062450815,5.336635326662807,5.729171500983814,5.496802785717849,148063.7730496454,3,1,7,5,3,1,3,1.0,0,0,-1,1,0,0,-1
2634,5.4340578130928865,5.1936471591512845,5.554720317024782,5.0329951263335815,5.494849477905825,5.741819430546588,5.328794690499823,117023.63855421687,2,E01002697,3,4,7,5,1,1,5.451924542790835,5.119392729297127,5.623573901727028,5.003833150126271,5.384310840331402,5.808339131247137,5.504538421778335,148255.90721649484,3,3,5,5,5,2,3,1.0,1,0,1,-2,0,1,2
2635,5.5343008182550735,4.965822489638078,5.792646439451921,4.8530393948680475,5.4772887606369824,5.946877288190942,5.404055093464098,115610.71052631579,4,E01002698,1,7,4,4,4,2,5.538785801658148,4.9447147966940195,5.759823412834844,4.907795895504046,5.433139287972752,5.876082423367078,5.611728325674806,146480.92405063292,4,1,7,3,6,3,5,1.0,0,0,0,-1,2,-1,3
2636,5.61712496763184,5.086629528374899,5.822807950632913,4.766547671386173,5.507302068528675,5.921675148464384,5.538765563851311,116066.38095238095,4,E01002699,2,8,2,5,3,5,5.5616449890555915,4.994877308279603,5.766332628962758,4.800289249682164,5.485705325891684,5.8523974654438735,5.5479064131831075,147039.32967032967,5,1,7,1,7,2,4,1.0,1,-1,-1,-1,2,-1,-1
2637,5.968152344226837,4.977340662479401,5.826907878262656,4.662359485455922,5.678489923477173,5.999446947234017,5.701339212485722,116377.32142857143,8,E01002700,1,8,1,9,5,7,5.830890405972799,4.946754798094432,5.772345638275146,4.738122299512227,5.51126246770223,6.012687384287516,5.715100831985474,147395.29333333333,8,1,7,0,8,5,7,1.0,0,0,-1,-1,-1,0,0
2638,5.420995980920926,4.954191861018328,5.821349123833885,4.954632445120476,5.559036822386191,5.9341954076793835,5.62564458477665,106894.1690140845,2,E01002701,1,8,6,6,3,6,5.46598756313324,4.905469320322338,5.770557152597528,4.8900378487612075,5.486098640843442,5.80241111391469,5.686141516032972,136106.44736842104,4,1,7,3,7,1,7,1.0,2,0,-1,-3,1,-2,1
2639,5.269550436582321,5.086912468967275,5.606931305339193,4.972992774767754,5.455789428490859,5.752344520682962,5.406963399332812,109037.50427350428,1,E01002702,2,4,6,4,1,3,5.203402779720448,5.046316698745445,5.701294511335868,5.089942782013504,5.374201394010473,5.59070895159686,5.529915912946065,138190.5037037037,1,2,6,7,4,0,4,1.0,0,0,2,1,0,-1,1
2640,5.3682109463042105,5.109894296397334,5.7479627927144366,4.94522986377495,5.581810108129529,5.828289712684742,5.397391823754794,116302.79710144928,2,E01002703,2,7,6,7,2,2,5.3543889834767295,4.930152922868729,5.742825053987049,4.965007604587646,5.493582200436365,5.771454141253517,5.562890680063338,147653.94047619047,2,1,7,5,7,1,4,1.0,0,-1,0,-1,0,-1,2
2641,5.174711587636367,4.889384934867638,5.760488384875698,5.032958867757217,5.422814285841541,5.7224016664684685,5.540873279606086,38610.92391304348,0,E01002704,0,7,7,3,1,5,5.141613236180058,4.8487394621342785,5.752752347492877,5.078401069582244,5.410505389725721,5.686820115204211,5.623720706245045,49349.654320987655,0,0,7,7,5,0,6,1.0,0,0,0,0,2,-1,1
2642,5.395339194032335,5.029604452172506,5.685424844014276,4.889125718283899,5.569496285055101,5.876163996372027,5.396481280474319,93402.09278350516,2,E01002706,1,6,5,7,2,2,5.4024919507832365,4.931621104478836,5.689357792509013,4.992681216577004,5.396280090356695,5.730080284949007,5.412625638575389,117205.2672413793,3,1,6,5,5,1,2,1.0,1,0,0,0,-2,-1,0
2643,5.4130355541684985,4.919132214731874,5.86576101210265,4.8413517432930195,5.532789361160414,5.909460261859725,5.623760001849284,114863.50442477876,2,E01002707,0,8,4,6,3,6,5.356220409889851,4.821987663418794,5.789965655192856,4.930392866292276,5.45839200729181,5.807261740865786,5.611584958951335,145614.04958677685,2,0,8,4,7,2,5,1.0,0,0,0,0,1,-1,-1
2644,4.976281335340679,5.468960356975788,5.295055493465445,5.212028161596857,5.237232475649586,5.491408486392617,5.087467935203847,116430.49723756906,0,E01002708,8,0,9,0,0,0,5.038891699375251,5.3655348093081745,5.31742911583338,5.25326020411956,5.179064017075759,5.512701640984951,5.161014885168809,147320.53846153847,0,7,0,9,1,0,0,1.0,0,-1,0,0,1,0,0
2645,4.962029388174415,5.423515377566218,5.482933163642883,5.156926568597555,5.332277551293373,5.612184125930071,5.149495596066117,117519.84375,0,E01002709,7,3,9,1,0,0,5.2629274745782215,5.13540136218071,5.64286523660024,5.0058336118857065,5.402221620082855,5.846534423033396,5.425263994932175,148220.1,1,3,5,5,5,2,2,1.0,1,-4,2,-4,4,2,2
2646,5.2811596067542705,5.229379720158047,5.574400445334931,5.00936884044582,5.408403211169773,5.792236366842547,5.249462025797265,116969.73504273505,1,E01002710,4,4,7,3,1,1,5.351756830215454,5.135309107780457,5.610770418167114,4.907511148452759,5.388314432144165,5.848293197631836,5.444369492530822,148160.76,2,3,5,3,5,2,2,1.0,1,-1,1,-4,2,1,1
2647,5.3119884623578315,4.953481295405055,5.778665948901656,4.899628590549943,5.5210379982841085,5.7394480373732435,5.461504235070133,117349.44378698224,1,E01002711,1,7,5,6,1,3,5.428480436347123,4.8031950437953705,5.882648924182605,4.866880453390882,5.519486709826254,5.827923341982626,5.589593058376643,148691.59537572254,3,0,8,3,8,2,5,1.0,2,-1,1,-2,2,1,2
2648,5.197263721209853,5.113825388808749,5.754278930265512,5.036604304811847,5.35603827860818,5.68608041663668,5.196192068840141,115751.88059701493,0,E01002712,2,7,7,2,0,0,5.161227514494711,5.046698475951579,5.59795329108167,5.056148843978768,5.2340987084516835,5.639557297550031,5.353874633561319,146619.23880597015,0,2,4,6,1,0,1,1.0,0,0,-3,-1,-1,0,1
2649,5.043296214479667,5.169524525220577,5.501543362553303,5.148348405957222,5.1884035766124725,5.547757068505654,5.139092947428043,115261.29807692308,0,E01002713,3,3,9,0,0,0,5.129882458413001,5.172006561024355,5.47406805387818,5.182435007378606,5.1676222923958655,5.610155884582217,5.274933090304384,146070.41584158415,0,4,2,8,0,0,0,1.0,0,1,-1,-1,0,0,0
2650,5.536045753488354,5.0050060328315285,5.8180474720749205,4.7146157657398895,5.464248654889126,5.79212885276944,5.446170088122873,116165.9705882353,4,E01002714,1,7,1,4,1,3,5.619301030191324,4.875180434372465,5.771474917056197,4.734938909441738,5.412344186992969,5.915612247030614,5.6640500264652704,147168.68644067796,6,0,7,0,5,3,6,1.0,2,-1,0,-1,1,2,3
2651,5.386799635031284,5.107244870601556,5.678060262631147,4.887402565051348,5.539122874920185,5.824396029496804,5.2334465980529785,116167.51282051283,2,E01002715,2,6,5,6,2,1,5.186170833055363,5.226838696834653,5.602056935776112,5.004597364470016,5.362022976542628,5.6812407305074295,5.228936849638473,147195.09302325582,0,5,4,5,4,0,0,1.0,-2,3,-2,0,-2,-2,-1
2652,5.478135507553816,5.161654715426266,5.76202692463994,4.888731949031353,5.461498028598726,5.882922250777483,5.429573709145188,106551.7578125,3,E01002716,3,7,5,4,3,3,5.44611401639433,5.074875498429323,5.7165658555479135,4.919115432307252,5.416757088441115,5.8223467158456135,5.5044264396031695,135654.5128205128,3,2,7,4,5,2,3,1.0,0,-1,0,-1,1,-1,0
2653,6.056874802956979,5.068454309056203,5.900455189247926,4.640927964200576,5.714455838004748,6.212647544840972,5.821904895206292,109965.5625,9,E01002717,2,8,0,9,8,9,5.942453958175995,5.031151445357354,5.848386382008647,4.752463137710487,5.57735689000769,6.135330048236218,5.794071325889001,139797.32967032967,9,2,8,1,9,8,8,1.0,0,0,0,1,0,0,-1
2654,6.112882735024036,4.73434407274488,6.276003451414511,4.362489614688175,5.708470035606707,6.442022934765883,5.974693301697852,106740.05633802817,9,E01002718,0,9,0,9,9,9,5.889392209379641,4.828747009577817,6.132692389292259,4.491542634898669,5.628951177205125,6.208037226167444,5.948575062294529,135898.98630136985,8,0,9,0,9,8,9,1.0,-1,0,0,0,0,-1,0
2655,6.092993906781643,5.025848974155474,5.871198522893688,4.604574718052828,5.684017786496802,6.143267142621776,5.790231558341015,109304.75316455697,9,E01002719,1,8,0,9,7,8,5.879576690589325,5.049675455576257,5.84123975415773,4.71222539793087,5.558972209314756,5.999668065505691,5.7137565635427645,139115.1075949367,8,2,8,0,8,5,7,1.0,-1,1,0,0,-1,-2,-1
2656,5.546536916884307,5.10547621339281,5.7243500156937355,4.933628925653261,5.503683758673267,5.931496094320422,5.499942337241128,107247.98130841121,4,E01002720,2,6,5,5,3,4,5.423236848786473,5.0920442985370755,5.697549873962998,4.9758804170414805,5.473005062900484,5.906205680221319,5.425848934799433,136561.5,3,3,6,5,7,3,2,1.0,-1,1,0,0,2,0,-2
2657,5.836558612684409,4.99046794573466,5.827960528433323,4.705677555253108,5.548779922227065,6.115306514004867,5.731632101039092,106727.01041666667,7,E01002721,1,8,1,6,7,8,5.761964094405081,4.990635870718489,5.840399096993839,4.870988991915011,5.43528507270065,6.11916139312819,5.725057723475437,135865.91176470587,7,1,8,3,6,7,7,1.0,0,0,0,2,0,0,-1
2658,5.844193119378317,5.044547110795975,5.926370745613461,4.674542848552976,5.639634206181481,6.1054921717870805,5.764922011466253,107165.5,7,E01002722,1,9,1,8,6,8,5.709117736571875,5.034653827165946,5.825446351980552,4.890512101161174,5.485964056773064,6.037268727253645,5.568103779584933,136382.8205128205,7,2,8,3,7,6,4,1.0,0,1,-1,2,-1,0,-4
2659,5.456227079877314,5.047217347711887,5.818328888911121,4.83990013262011,5.53509492131899,5.927064551497406,5.608843900122732,117689.16981132075,3,E01002723,1,7,4,6,3,6,5.4547539670188145,5.0116898755769475,5.738634942888139,4.90129655653292,5.401847539721309,5.814985650079745,5.58719163220208,148929.8918918919,3,2,7,3,5,2,5,1.0,0,1,0,-1,-1,-1,-1
2660,5.303184743504971,4.8852207637391984,5.7927504614926875,4.9335569073446095,5.465112483594567,5.78954507317394,5.492361280601472,38102.7421875,1,E01002724,0,7,5,4,1,4,5.400880620495914,4.845462011964353,5.773314187787983,4.982415629984581,5.438725027319503,5.74147502526845,5.544452637842257,47446.767123287675,3,0,7,5,6,1,4,1.0,2,0,0,0,2,0,0
2661,5.648773686091105,4.937808609008789,5.790808701515198,4.805597949028015,5.54053582350413,5.90876384973526,5.619176618258158,118193.88333333333,5,E01002725,0,7,3,6,3,6,5.605525682369868,4.879296160406536,5.844455758730571,4.785360097885132,5.465839713811874,5.906009356180827,5.740857130951351,149713.5,5,0,8,1,7,3,7,1.0,0,0,1,-2,1,0,1
2662,5.417188530132688,4.860264267592594,5.82206102897381,4.916010359237934,5.499831455329369,5.776404412039395,5.56980438807915,106359.08275862069,2,E01002726,0,8,5,5,1,5,5.366436363035633,4.971117491875925,5.73337379886258,4.879898259716649,5.42945506803451,5.728255993320096,5.536007278196274,135677.28387096775,2,1,7,3,6,1,4,1.0,0,1,-1,-2,1,0,-1
2663,5.745383292750309,4.864156906228317,5.977610279384412,4.68332620419954,5.591308126951519,5.947945665058337,5.6711797789523475,117683.0947368421,6,E01002727,0,9,1,7,4,7,5.668383794961517,4.918891298402216,5.785526528800886,4.867243917946963,5.439711587945211,5.888851613113561,5.650792787984474,149042.40206185568,6,1,7,3,6,3,6,1.0,0,1,-2,2,-1,-1,-1
2664,5.482493659784628,4.935309074645819,5.75583462105241,4.960724201313285,5.479807074679885,5.8588053930637445,5.613505136135013,117565.1046511628,3,E01002728,0,7,6,5,2,6,5.468577558795611,4.984577135493358,5.720308554669221,4.894159382830064,5.436028180023034,5.779807115594546,5.650257121771574,148965.66666666666,4,1,7,3,6,1,6,1.0,1,1,0,-3,1,-1,0
2665,5.73367052587844,4.915146725778361,5.851902242835242,4.740897071270543,5.571877330314112,5.931967575131482,5.726361125480127,117804.69465648854,6,E01002729,0,8,2,7,3,8,5.7377545067242215,4.8355354121753145,5.800295197963715,4.791333620888846,5.466062665837152,5.881023819105966,5.761220194612231,149204.17142857143,7,0,8,1,7,3,8,1.0,1,0,0,-1,0,0,0
2666,5.402227421601613,5.102762904083519,5.890722764165778,4.843601374249709,5.4604410455937975,5.936923771573786,5.503670470756397,112343.17543859649,2,E01002730,2,8,4,4,3,4,5.458092341729261,5.005797505378723,5.8249668528180605,4.9627880579834684,5.403855399254265,5.919522438574274,5.611748287437159,142552.16513761468,3,2,8,4,5,4,5,1.0,1,0,0,0,1,1,1
2667,5.28369219751166,5.026664705884537,5.833463483208778,4.997581502735215,5.403017815327484,5.814587681085471,5.373903332140622,112105.93959731543,1,E01002731,1,8,7,3,2,2,5.373527557644623,4.872061323645888,5.751310662718009,4.99138648699451,5.324115378177718,5.746590677476087,5.421403565943636,142285.4701986755,2,0,7,5,3,1,2,1.0,1,-1,-1,-2,0,-1,0
2668,5.384815437751904,5.133762424452263,5.766018491042288,4.830995258532073,5.395268174639919,5.930072686128449,5.51397869252322,111971.98245614035,2,E01002732,3,7,4,3,3,4,5.500535052669935,5.002484514693584,5.76938937124142,4.901724263656238,5.358811777485304,5.945829419065113,5.626592149419233,142141.38842975206,4,1,7,3,4,4,6,1.0,2,-2,0,-1,1,1,2
2669,5.695676783720653,5.056907946864764,5.953242123126984,4.77733971675237,5.488961415158378,6.05839862426122,5.553698498341772,111677.44444444444,5,E01002733,2,9,2,5,6,5,5.57835246184293,5.035241533728207,5.858340862919302,4.807415662442937,5.38473724267062,5.937636859276715,5.6140945378471825,142223.11764705883,5,2,8,1,5,4,5,1.0,0,0,-1,-1,0,-2,0
2670,5.13182574940711,5.028930098740096,5.640433660487539,5.142976453623821,5.374417684741856,5.680726238132752,5.198128643724107,111200.86597938144,0,E01002734,1,5,9,2,0,0,5.227379007981374,4.959555393228164,5.756402549835352,5.123404627809157,5.290373622224881,5.722849492843334,5.505533401782696,141244.22115384616,1,1,7,8,2,1,3,1.0,1,0,2,-1,0,1,3
2671,5.377159630859291,5.024811425051847,5.91694838660104,4.960530178887503,5.41482924760043,5.820253474371774,5.413372627981416,110673.0,2,E01002735,1,8,6,3,2,3,5.406989884376526,4.860288903587743,5.918247903020759,4.92530714210711,5.4397297382354735,5.854483368522242,5.519855467896712,140607.86315789472,3,0,9,4,6,2,4,1.0,1,-1,1,-2,3,0,1
2672,5.3195662460629904,5.232117611264425,5.583785484707545,5.152649737539745,5.362033874269516,5.707170346426586,5.295007823005555,111033.8253968254,1,E01002736,4,4,9,2,0,1,5.346016307087505,5.241339946494383,5.595342956921634,5.175632757299087,5.293268066995284,5.625894129276276,5.274922446292989,141008.1911764706,2,5,4,8,2,0,0,1.0,1,1,0,-1,0,0,-1
2673,5.62963984474059,5.081511766679825,5.7978779346712175,4.929076139004,5.616178958646713,5.818374537652539,5.4369691148880985,111278.03225806452,5,E01002737,2,7,5,8,2,3,5.455422592885567,5.167638477050897,5.690193595308246,5.066252704822656,5.447168675335971,5.819179663152406,5.4070301453272505,141350.71212121213,3,4,6,7,6,2,2,1.0,-2,2,-1,2,-2,0,-1
2674,6.093794151492741,4.959181636571884,5.910586367482725,4.6917939743270045,5.728504657745361,6.235081387602764,5.886346467163252,114071.46739130435,9,E01002738,1,8,1,9,8,9,5.927662259653995,5.062302315444277,5.855524851564775,4.689640081765359,5.672292606872425,6.104109916770668,5.72181965384567,144659.93859649124,9,2,8,0,9,7,7,1.0,0,1,0,-1,0,-1,-2
2675,5.865496841845689,4.833664639128579,6.089571769590731,4.601259663149163,5.617297929746133,6.238080099776939,5.7541752347239745,114104.95370370371,7,E01002739,0,9,0,8,8,8,5.7438665879975765,4.701616041157224,6.103041248584012,4.73945556540008,5.566323586560171,6.148484890614081,5.754222759413063,144687.6605504587,7,0,9,1,9,8,8,1.0,0,0,0,1,1,0,0
2676,6.0007470855072365,4.8402010798454285,6.0630552768707275,4.569827146494567,5.818211491428205,6.227378576549132,5.720838041447881,114691.27611940299,8,E01002740,0,9,0,9,8,7,6.007907823604696,4.877086267751806,5.950708238517537,4.696247283150168,5.685625331366763,6.189280301332474,5.738173327025245,145364.25,9,0,9,0,9,8,7,1.0,1,0,0,0,0,0,0
2677,6.009482740045904,5.1707892417907715,5.675606573021019,4.690960505506495,5.671061230229808,6.097617757189405,5.642944207558265,112645.58241758242,8,E01002741,3,6,1,8,6,6,6.146262755554713,5.0832697581709105,5.752982857522,4.862487823775645,5.509107272276718,6.088166903913691,5.674720687812634,142937.49438202247,9,3,7,2,8,7,6,1.0,1,0,1,1,0,1,0
2678,5.735488132996992,4.944319646466862,5.972211377187208,4.767558704723012,5.489965081214905,6.157437852837822,5.743547709150747,111940.77272727272,6,E01002742,1,9,2,5,7,8,5.8054518699646,4.888778747971525,5.995295062507551,4.73749101284853,5.45709903461417,6.158625411004135,5.790136944387377,142110.412371134,8,0,9,0,7,8,8,1.0,2,-1,0,-2,2,1,0
2679,6.273582305481185,4.818851152462746,6.207348905392547,4.440441140488012,5.868005880668981,6.474440923377649,6.066124951661522,112788.19402985074,9,E01002743,0,9,0,9,9,9,6.252325691393952,4.680112561183189,6.1985425735587505,4.550082190712886,5.669793253514304,6.419488373087414,5.891733621483419,143110.31343283583,9,0,9,0,9,9,9,1.0,0,0,0,0,0,0,0
2680,5.832698983031434,4.990464792623149,5.933865157040683,4.853837062786152,5.5640249747734565,6.11226300759749,5.689694443306365,113435.45454545454,7,E01002744,1,9,4,7,7,7,5.817384999475362,4.917139578748633,5.906566387341346,4.77550365306713,5.544837680863745,6.078629791000743,5.58442015265241,143902.07407407407,8,1,9,1,8,7,5,1.0,1,0,0,-3,1,0,-2
2681,5.803640939012358,4.9314061026029945,5.933264309846902,4.823714903638333,5.59892706780494,6.057541116883483,5.722854495048523,113376.3670886076,7,E01002745,0,9,3,7,6,8,5.708638149499893,4.8874701172113415,5.911401852965355,4.7611842304468155,5.517518994212151,6.020148208737373,5.687515623867512,143821.2125,7,0,9,1,8,6,7,1.0,0,0,0,-2,1,0,-1
2682,5.582935692148006,4.896202500830305,5.8862080574035645,4.831699324415085,5.502654697032685,6.109758113292938,5.524260283784663,111693.35106382979,4,E01002747,0,8,4,5,7,4,5.557394890408767,4.868690641302812,5.96130865498593,4.925878465175629,5.4611736347800806,6.045896009394997,5.591334637842681,141753.40789473685,5,0,9,4,7,6,5,1.0,1,0,1,0,2,-1,1
2683,5.615048207618572,5.11945535297747,5.8740995371783224,4.792264302571614,5.559502349959479,6.083525317686576,5.609483283978921,111521.42592592593,4,E01002748,2,8,3,6,6,6,5.565999838812598,4.901080326787357,6.042661054381009,4.796985987959237,5.388287749783746,6.065364434801299,5.79956631824888,141526.24137931035,5,0,9,1,5,6,8,1.0,1,-2,1,-2,-1,0,2
2684,5.661507195548007,4.910651285397379,5.890716932321849,4.792402247064992,5.537477775623924,6.138321675752339,5.658791650282709,112312.07894736843,5,E01002749,0,8,3,6,7,7,5.671786637141786,4.853501096539114,5.878505243652168,4.802927087093222,5.538566509882609,6.084788780102785,5.672889945150792,142547.2068965517,6,0,8,1,8,7,6,1.0,1,0,0,-2,2,0,-1
2685,5.628382109306954,5.196873084918873,5.7351728742187085,4.818357379049869,5.4428377924738705,5.976627423956588,5.5685588201961,113031.28378378379,5,E01002751,3,6,3,4,4,5,5.585993445063212,5.062789615378322,5.782619315457631,4.8691312562988465,5.351336298218692,5.904596963560725,5.667601987540004,143383.73493975904,5,2,7,3,4,3,6,1.0,0,-1,1,0,0,-1,1
2686,5.989392755906793,4.907785966426512,6.030617155606234,4.621208008331589,5.666551580911951,6.142000883440428,5.788615622097933,112797.81012658228,8,E01002752,0,9,0,8,7,8,5.886047547639802,4.932960328667662,5.924293324004772,4.680558048015417,5.6262424463449525,6.128616161124651,5.771598078483759,143108.18604651163,8,1,9,0,9,7,8,1.0,0,1,0,0,1,0,0
2687,5.70988809225852,4.999337054135506,5.896406617080956,4.812731412419102,5.564463924943355,5.961533680296781,5.410295988384046,119794.0701754386,6,E01002753,1,8,3,7,4,3,5.5737779008017645,5.011280552104667,5.944218825410913,4.800726528520937,5.326224013611123,5.963013706383882,5.504377508604968,151550.53703703705,5,2,9,1,3,4,3,1.0,-1,1,1,-2,-4,0,0
2688,6.086853916230409,5.03938896889272,5.988283652326335,4.652132328437722,5.76922120348267,6.326737458291261,5.904286308133083,120461.92391304347,9,E01002754,1,9,0,9,9,9,5.84669507543246,4.9274124176729295,5.98368885119756,4.677477226370857,5.528361923637844,6.269066663015456,5.891203861861002,152326.55952380953,8,1,9,0,8,9,9,1.0,-1,0,0,0,-1,0,0
2689,5.685436384494488,5.084826827049255,5.70767731666565,4.809966789759122,5.5129082276270935,5.981479329329271,5.540535699404203,117611.30769230769,5,E01002755,2,6,3,5,4,5,5.510032623608907,5.052366387049357,5.6212706375122075,5.019961972236633,5.313384189605713,5.905253661473592,5.557901512781779,149236.48,4,2,5,6,3,3,4,1.0,-1,0,-1,3,-2,-1,-1
2690,6.123370650109281,5.11564857236455,5.784209701452363,4.630205437038722,5.5756705463602305,6.100305064340656,5.713804390993011,109662.88764044944,9,E01002756,2,7,0,7,6,7,5.922567265189213,4.971485695113307,5.714073687791824,4.877183500839316,5.431614586840505,6.1177647981954655,5.7549698262111,139338.75,8,1,6,3,6,7,8,1.0,-1,-1,-1,3,-1,1,1
2691,6.296825980240444,4.8058835920297875,6.070429941393295,4.383595540838422,5.805633949783613,6.413476800018886,6.041282118491407,119896.92452830188,9,E01002757,0,9,0,9,9,9,6.061103128469908,4.768313882442621,5.944016887591435,4.67321758545362,5.475839218268027,6.293017749602978,5.95285886984605,151734.8076923077,9,0,9,0,7,9,9,1.0,0,0,0,0,-2,0,0
2692,5.7529235155809495,5.111821203004746,5.612370956511724,4.800625290189471,5.588552696364267,5.86414837269556,5.478114719901766,119240.47619047618,6,E01002758,2,5,3,7,2,4,5.687158954607976,5.042319825717381,5.723629084500399,4.945451669878774,5.406265249500027,5.934502391072063,5.5698329519915895,150688.05194805196,6,2,7,4,5,4,4,1.0,0,0,2,1,-2,2,0
2693,5.980982510333366,4.954255000073859,5.952915544205523,4.625662750386177,5.650301773497399,6.252686016103055,5.779022408292649,119952.26595744681,8,E01002759,1,9,0,8,8,8,5.837872903425615,4.964113883919769,5.844908412996229,4.7974685941423685,5.421978038745922,6.137061111219636,5.80713827924414,151768.1208791209,8,1,8,1,6,8,8,1.0,0,0,-1,1,-2,0,0
2694,5.333347113927205,5.226936630407969,5.503165924549103,5.017085740963618,5.380073376496633,5.712259807189306,5.265094494819641,119355.85,1,E01002760,4,3,7,2,0,1,5.233629776585486,5.161100022254452,5.599979969762987,5.083084402545806,5.176912624989787,5.674788740373427,5.310723508557966,151036.62903225806,1,4,4,7,1,0,1,1.0,0,0,1,0,-1,0,0
2695,6.009156615393502,4.992252659797669,6.003197675091879,4.6938327142170495,5.711441091128758,6.217014674629484,5.829998123645782,114009.4857142857,8,E01002762,1,9,1,9,8,9,5.905389259707543,4.999141188590757,5.998828477244223,4.7451932368739955,5.535531998449756,6.176403940877607,5.882351622273845,144726.44516129032,8,1,9,1,8,8,9,1.0,0,0,0,0,-1,0,0
2696,5.529546816606779,5.15088126466081,5.674029717574248,4.89097929645229,5.4243869749275415,5.915386071076265,5.438393663715672,113300.67567567568,3,E01002763,3,6,5,3,3,3,5.491919928286449,5.031797598643475,5.836862127464938,4.920697130352618,5.370226331503995,6.0037915132131925,5.6714986476553495,143463.8795180723,4,2,8,4,4,5,6,1.0,1,-1,2,-1,1,2,3
2697,5.862770935923783,5.186783026174171,5.789967654906597,4.722974997205832,5.6313847930161,6.078548507592113,5.665926446619722,123172.85567010309,7,E01002764,3,7,1,8,6,7,5.710288400743522,5.143497609624676,5.713534034934699,4.926665127277374,5.45757405313791,6.031323496033163,5.591289787900214,155694.70588235295,7,3,6,4,7,6,5,1.0,0,0,-1,3,-1,0,-2
2698,5.097382376859854,5.275707330789652,5.486423106880875,5.21398215680509,5.275644214303644,5.6251131446511895,5.224412867614815,114781.58558558559,0,E01002765,5,3,9,1,0,0,5.176733260974288,5.047710606828332,5.587526986375451,5.0747060887515545,5.29373986274004,5.711660950444639,5.350174369290471,145479.0390625,0,2,4,7,2,0,1,1.0,0,-3,1,-2,1,0,1
2699,5.241408780534217,5.2889235298684305,5.367633729539019,5.100974829907113,5.386369086326437,5.602695069414504,5.228361747366317,117365.28723404255,1,E01002766,5,1,8,2,0,0,5.2985400703488565,5.10894529673518,5.62560207868109,5.043562176276226,5.34498135897578,5.752827461884946,5.403167857199299,148727.27551020408,1,3,5,6,4,1,2,1.0,0,-2,4,-2,2,1,2
2700,5.6784410869374,5.026698074621312,5.746637675341438,4.8121894205317775,5.596908555311315,6.109313075682696,5.790025716669419,113647.57647058823,5,E01002767,1,7,3,7,6,8,5.5821251541960475,4.897526736352958,5.742974568815792,4.808830258893032,5.474730173746745,6.051191612785938,5.708962916159162,144088.72549019608,5,0,7,2,7,6,7,1.0,0,-1,0,-1,0,0,-1
2701,5.782648778823485,5.074770772313497,5.816099508699164,4.816904899585678,5.55147749257375,6.000057875391948,5.605042987559215,123777.2530120482,6,E01002768,2,7,3,6,5,6,5.686949136645295,4.96517614292544,5.770191328470097,4.9465155449024465,5.464118269986884,6.023817184359529,5.6256572008132935,156603.08139534883,6,1,7,4,7,6,6,1.0,0,-1,0,1,1,1,0
2702,5.768301864632037,5.223537844770095,5.753230527669442,4.864827314344775,5.574063472387169,6.089706619246667,5.591749078085442,120991.99159663866,6,E01002769,4,7,4,7,6,6,5.784478123371418,5.114864748767299,5.741930109822852,4.8303685096594,5.388005046762972,6.062326542332641,5.665031000080272,153122.64102564103,7,3,7,2,5,6,6,1.0,1,-1,0,-2,-2,0,0
2703,5.634304849839792,5.025065776778431,5.802013513518543,4.868252629913935,5.457308097583492,5.94724884556561,5.604338273769471,120624.9268292683,5,E01002770,1,7,4,4,4,6,5.489206084230328,4.992212217815673,5.71753791946074,4.954221515365727,5.258542872924172,5.899674133701219,5.678832785859292,152517.4364640884,4,1,7,4,2,3,7,1.0,-1,0,0,0,-2,-1,1
2704,5.718748819397156,4.991439267813441,5.946708104696619,4.685332877090178,5.537537704031151,6.106451784271791,5.733651831925633,120732.01204819277,6,E01002771,1,9,1,6,6,8,5.782171801380489,4.951981113008831,5.899045428504115,4.807006670081097,5.4341810889866045,6.0564458085143045,5.8045785219773,152709.22826086957,7,1,9,1,6,6,8,1.0,1,0,0,0,0,0,0
2705,5.63220154301504,4.899005000510912,5.934588400165686,4.80161379428392,5.462716132067563,5.9636715717529984,5.507581579551268,120171.0,5,E01002772,0,9,3,4,4,4,5.486803041415268,4.996413820245293,5.80701818091146,4.9683899892849865,5.383646760094032,5.879418721359767,5.389616964908129,152018.34831460673,4,1,8,5,5,3,1,1.0,-1,1,-1,2,1,-1,-3
2706,5.570137530985013,5.1251809395534895,5.643409802880086,4.943840018460448,5.460485062129061,5.834438908268028,5.534715143727585,120759.0,4,E01002773,2,5,6,4,2,5,5.40481375058492,5.082855432828268,5.651348622639974,4.97180078347524,5.314838895797729,5.782457478841146,5.485688877105713,152690.76,3,2,5,5,3,1,3,1.0,-1,0,0,-1,-1,-1,-2
2707,5.901473714950237,4.899816836448426,6.102201799128918,4.736042696110745,5.58218474591032,6.161677994626634,5.786787811745989,120211.65957446808,8,E01002774,0,9,2,7,7,8,5.79132034778595,4.907457522153854,6.008827109336853,4.705351915359497,5.384141541719437,6.11115407705307,5.744580067396164,152089.79,7,1,9,0,5,7,8,1.0,-1,1,0,-2,-2,0,0
2708,5.919288960663048,4.937776098380217,5.80972930708447,4.59200249974792,5.665372813070142,6.171528001089354,5.7143364725886165,114678.55405405405,8,E01002775,0,7,0,8,7,7,5.9088756689658535,4.866803409503056,5.899545959325937,4.681084845616267,5.598914703956017,6.119996026846079,5.687379418886625,145215.46153846153,8,0,9,0,9,7,7,1.0,0,0,2,0,1,0,0
2709,5.50456690788269,5.217406745019712,5.663209295586536,4.901656368845387,5.537391281441638,5.848857779251902,5.4949063831254055,113783.05263157895,3,E01002776,4,5,5,6,2,4,5.4770123301720135,5.126675347892606,5.702598316328866,4.910385858039467,5.439122399505304,5.835148300443377,5.450137538569314,143347.20408163266,4,3,6,3,6,2,2,1.0,1,-1,1,-2,0,0,-2
2710,5.681668817996979,4.998335535796183,5.7777444304160355,4.80339039159271,5.590541704645696,6.081866228355552,5.593030124340418,109576.94339622642,5,E01002777,1,7,3,7,6,6,5.56085083882014,5.053305498525208,5.69494604363161,4.896892401517606,5.452938188524807,6.004060364237018,5.527929145915835,138629.30392156861,5,2,6,3,6,5,4,1.0,0,1,-1,0,-1,-1,-2
2711,5.3287122211759055,5.31694922182295,5.504272354973687,5.049428196180434,5.445090872900827,5.737299109262134,5.318944261187599,104765.80952380953,1,E01002778,5,3,7,4,1,1,5.335156882131422,5.184490854675706,5.712479008210672,5.105522228253855,5.461289423543054,5.819455040467752,5.358232844520259,133881.97297297296,2,4,6,7,7,2,1,1.0,1,-1,3,0,3,1,0
2712,5.979664789624961,4.939616658601416,5.9416769441351835,4.571782705295517,5.721538813717394,6.239009837070143,5.824688572481454,113874.43373493975,8,E01002779,0,9,0,9,8,9,6.027289853209541,4.876642648662839,5.999300142129262,4.59410410409882,5.630010301158542,6.200368412903377,5.784783099378858,144380.61904761905,9,0,9,0,9,8,8,1.0,1,0,0,0,0,0,-1
2713,5.995272027529203,4.6890008724652805,6.235247626671424,4.678143273867094,5.692850476044875,6.279217485281137,5.852386047289921,114096.2923076923,8,E01002780,0,9,1,9,9,9,5.812171560345274,4.8406196381106525,6.151640505501718,4.5654945156791,5.550176259243127,6.0818575403907085,5.873990185333021,144647.4696969697,8,0,9,0,8,7,9,1.0,0,0,0,-1,-1,-2,0
2714,6.150044987418434,4.812424182891846,5.920229729739103,4.602308229966597,5.770722025090998,6.2968312480232935,5.786172030188821,113909.67272727273,9,E01002781,0,8,0,9,9,8,6.425826228394801,4.758572035906266,5.968100966239462,4.4648542769101205,5.7806461343959885,6.239272920452819,5.8562211990356445,144377.79591836734,9,0,9,0,9,9,9,1.0,0,0,1,0,0,0,1
2715,5.651593704746194,5.075217728745447,5.796756274079623,4.748814445652374,5.481785416603088,5.970631298953539,5.456483372270244,109163.79452054795,5,E01002782,2,7,2,5,4,3,5.763338877830976,5.015352815757563,5.800672628261425,4.823262124885748,5.4885207090848755,5.973473849119963,5.5246207331433705,139156.14814814815,7,2,8,2,7,5,4,1.0,2,0,1,0,2,1,1
2716,5.727259284920162,5.180898418029149,5.633704781532288,4.939088826378186,5.4754036366939545,5.912605444590251,5.464137002825737,124915.70833333333,6,E01002783,3,5,6,4,3,3,5.715956116095185,5.108647784218192,5.651847597211599,4.917573498561978,5.389746995642781,5.995134726166725,5.617817856371403,157849.796875,7,3,5,4,5,5,5,1.0,1,0,0,-2,1,2,2
2717,5.684114108482997,5.122094672173262,5.730015108982722,4.813929062336683,5.5993310411771136,6.014774911105633,5.633247678478559,124995.39583333333,5,E01002784,2,6,3,7,5,6,5.69244932003741,5.135645058919799,5.636166496096917,4.892562888703257,5.473015821204995,5.986486740832059,5.5984251240514356,157966.40566037735,6,3,5,3,7,5,5,1.0,1,1,-1,0,0,0,-1
2718,6.021550227055507,5.001099181386222,6.07997234310724,4.66862617446258,5.657064800768827,6.328605493613049,5.896912970374116,119135.43362831858,8,E01002785,1,9,1,8,9,9,5.89301892330772,4.880302864208556,6.006447007781581,4.74943272691024,5.48075113484734,6.237617967421548,5.8910235574370935,150718.8947368421,8,0,9,1,7,9,9,1.0,0,-1,0,0,-1,0,0
2719,5.599168151197299,5.110314864507863,5.856422083478578,4.842783251278837,5.4716212480840545,5.938621285935523,5.527462843438269,114572.69014084506,4,E01002786,2,8,4,4,4,5,5.640063192163195,4.993003363268716,5.84063652242933,4.997113185269492,5.530115001542228,5.987920910971505,5.6683429888316565,145557.3,6,1,8,5,8,5,6,1.0,2,-1,0,1,4,1,1
2720,5.766376850821755,5.14760599786585,5.784293777292425,4.7435215689919215,5.540124776146628,6.117887180501764,5.617530332912098,120878.6909090909,6,E01002787,3,7,2,6,7,6,5.7052728644872115,5.0267319861104935,5.8228119672355,4.917506706916679,5.496977636369608,6.08307836419445,5.6746421587669245,153022.42372881356,7,2,8,4,7,7,6,1.0,1,-1,1,2,1,0,0
2721,6.010462862473947,4.887013270899102,6.123660822709401,4.630088784076549,5.7211347774223045,6.297105206383599,5.840479715002908,122752.07407407407,8,E01002788,0,9,0,9,9,9,5.973129441153328,4.910079244172798,6.111804966656667,4.663307170822935,5.560723395842426,6.236134848504697,5.838711713844875,155138.12264150943,9,1,9,0,8,9,9,1.0,1,1,0,0,-1,0,0
2722,6.265254759591473,4.760882052508268,6.1346104085938,4.524868592743046,5.811957170155423,6.503062537878998,5.966359081347127,125340.09917355372,9,E01002789,0,9,0,9,9,9,6.0534113044581135,4.804121491337611,6.134474673547035,4.685016582820041,5.623930384304898,6.35130579215436,5.8535524183068395,158342.5785123967,9,0,9,0,9,9,9,1.0,0,0,0,0,0,0,0
2723,5.744169998500082,4.8721935997406645,5.897056659062703,4.760540458891127,5.686843643585841,6.033508386876848,5.677242486013307,115785.20833333333,6,E01002790,0,8,2,9,5,7,5.829666582934828,4.73827104252505,5.9789067549877855,4.721198181071913,5.652057653450104,6.111078897154475,5.868685142103448,146670.2168674699,8,0,9,0,9,7,9,1.0,2,0,1,-2,0,2,2
2724,5.693415970042132,4.96896655490433,5.841650596563367,4.760415195554927,5.598948326663694,5.930477399756943,5.486879397993502,112941.41304347826,5,E01002791,1,8,2,7,3,4,5.6818807140674465,5.008164759554894,5.806945260054146,4.786450485778011,5.573586820776946,5.955049600476533,5.63667068528194,142866.73856209152,6,2,8,1,9,4,6,1.0,1,1,0,-1,2,1,2
2725,5.564181710148717,4.699808827391616,5.842829644143045,4.781671373693793,5.542110544067246,5.783943603704642,5.5943479548703445,116097.57657657658,4,E01002792,0,8,2,6,1,6,5.663466525678875,4.857498965343507,5.901106079085534,4.715497132108993,5.5123536827183575,5.8429984785929445,5.791337385898879,147076.11764705883,6,0,9,0,8,2,8,1.0,2,0,1,-2,2,1,2
2726,5.506092854168104,4.999265092870464,5.856125334034795,4.777962671673817,5.546600672213928,5.928547486014988,5.570871057717697,110658.92391304347,3,E01002793,1,8,2,6,3,5,5.4557937233297675,4.934153928413047,5.8204764181429205,4.8665212339109125,5.483475898837184,5.804085679956384,5.641738022769894,140496.63063063062,3,1,8,3,7,1,6,1.0,0,0,0,1,1,-2,1
2727,5.442196151062294,4.824481490806297,5.845009512371487,4.797298951502199,5.460009743549206,5.8150705213899965,5.538248578707377,116486.88888888889,2,E01002794,0,8,3,4,2,5,5.330132450153625,4.898329541574117,5.809117747288124,4.845384672576306,5.3389823849684275,5.713879237767139,5.578458439290913,147533.40522875817,2,0,8,2,3,0,5,1.0,0,0,0,-1,-1,-2,0
2728,5.442804289025229,5.067437330613265,5.694565848724262,4.93774935925329,5.464090898230269,5.866133456294601,5.4364360458142045,115060.63513513513,2,E01002795,2,6,6,4,2,3,5.486859433300845,4.994306012467071,5.740289716453819,4.898801071660502,5.449269834931914,5.849426846404175,5.504488961679952,145756.02097902098,4,1,7,3,6,2,3,1.0,2,-1,1,-3,2,0,0
2729,5.553071446232981,4.939020635245682,5.836794456878266,4.836705368834656,5.527508970978972,5.908619574138096,5.453617993887368,115325.76623376623,4,E01002796,0,8,4,6,3,3,5.551431809983602,5.059583807863841,5.667044869283351,4.9325143200595205,5.4563013475115705,5.783473465500808,5.552390158176422,146139.15853658537,5,2,6,4,6,1,4,1.0,1,2,-2,0,0,-2,1
2730,5.452423912106139,5.030580656697052,5.770312971538967,4.831936644785332,5.505374754318083,5.8552788435810745,5.42781517481563,107571.47474747474,3,E01002797,1,7,4,5,2,3,5.514181056153884,5.060232908353893,5.682628815327216,4.974004822039823,5.492042541503906,5.837663342099671,5.500574414883185,136804.90825688074,4,2,6,5,7,2,3,1.0,1,1,-1,1,2,0,0
2731,5.480738452739185,5.006577850215965,5.662746626469824,4.862536619934771,5.385425893796815,5.838857857717408,5.553888192607297,107081.05555555556,3,E01002798,1,5,4,2,2,5,5.454060088185703,5.037870912867434,5.669890185489374,4.90338804266032,5.35108467761208,5.902388765531428,5.525575428324587,136264.52205882352,3,2,6,3,4,3,4,1.0,0,1,1,-1,2,1,-1
2732,5.409056571465504,5.090866878062864,5.6544916659970825,4.9264632040941265,5.4222075758101065,5.705970371825786,5.361775082877919,107916.6835443038,2,E01002799,2,5,5,3,0,2,5.29622518710601,4.967917376603836,5.585183574603154,4.941443405090234,5.378025543995393,5.668458600838979,5.455331256756415,137422.65384615384,1,1,4,4,4,0,2,1.0,-1,-1,-1,-1,1,0,0
2733,5.520112135471442,5.130599358142951,5.6824677387873335,4.857812797411894,5.548624324492919,5.7930931983849945,5.423849642276764,108164.28205128205,3,E01002800,2,6,4,6,1,3,5.298928604331068,5.215392469077982,5.6423626753591725,5.016584520698876,5.377817261603571,5.7941720280596005,5.434206992067317,137623.13978494622,1,5,5,6,4,1,2,1.0,-2,3,-1,2,-2,0,-1
2734,5.520207186991518,4.907031865282492,5.817635785449635,4.697498920288953,5.50232885371555,5.799642500552264,5.604094838554209,113081.27272727272,3,E01002801,0,7,1,5,1,6,5.500941254474498,4.865946224442235,5.849543957798569,4.786348305366658,5.455653090167929,5.8463442656728954,5.596378203895357,143451.94444444444,4,0,8,1,6,2,5,1.0,1,0,1,0,1,1,-1
2735,5.412854181395637,4.968269960085551,5.839823987748888,4.876273251904381,5.465195804172092,5.784585581885444,5.543580912219154,108569.8111111111,2,E01002802,1,8,4,4,1,5,5.306155092311355,4.961938818670669,5.803832926840152,4.937218921364479,5.326892623361552,5.7395071376044795,5.4974768870281725,138078.51886792452,2,1,8,4,3,1,3,1.0,0,0,0,0,-1,0,-2
2736,5.498245329889532,5.012952526138253,5.7112427606974565,4.784687247994828,5.525747733573391,5.773510114787376,5.502623949148884,112755.56849315068,3,E01002803,1,6,3,6,1,4,5.476771133397919,4.914376047701618,5.726557370104821,4.791528517903846,5.442960073745328,5.727657293961718,5.600357187339683,143242.58823529413,4,1,7,1,6,1,5,1.0,1,0,1,-2,0,0,1
2737,5.712522383247103,5.138581497328622,5.746953217756181,4.7855090626648495,5.540684257234846,6.050836900870006,5.602459769873392,109904.09523809524,6,E01002804,3,7,3,6,5,6,5.510920837361326,5.0448766895519785,5.778494081189556,5.003331927842991,5.261119742547312,5.946712811787923,5.528220381788028,139692.33333333334,4,2,7,5,2,4,4,1.0,-2,-1,0,2,-4,-1,-2
2738,5.613525790326736,4.9692333469203875,5.866803938267278,4.830057728524301,5.546053014549554,6.0260691549263745,5.635562058757333,110024.16666666667,4,E01002805,1,8,3,6,5,6,5.653492467016236,4.792697619169187,5.839599112160186,4.920271516865135,5.535399950467623,5.987867414441883,5.6847661305696535,139843.1965811966,6,0,8,4,8,5,7,1.0,2,-1,0,1,2,0,1
2739,5.770313076178232,4.946727653344472,5.905493007765876,4.655666756629944,5.618985546959771,6.092397435506185,5.620906154314677,110195.27777777778,6,E01002806,1,8,1,8,6,6,5.597420008094223,5.019737150934008,5.734839610111567,4.842017017764809,5.357425851586425,6.0205961451118375,5.5855269741128994,140014.28395061727,5,2,7,2,4,6,5,1.0,-1,1,-1,1,-4,0,-1
2740,5.397084627832685,5.123282644010725,5.704465403443291,4.884024303583872,5.480898383117857,5.874310819875626,5.316031160808745,116740.91666666667,2,E01002807,2,6,5,5,2,1,5.32179673228945,5.055308875583467,5.5689764732406255,5.060802349022457,5.343633455889566,5.726798213663555,5.305867180937812,148133.2142857143,2,2,4,7,4,1,1,1.0,0,0,-2,2,-1,-1,0
2741,5.729308653871218,5.088916026552519,5.7885615428288775,4.837554955482483,5.636594078938166,6.104662374655406,5.547018772363662,112568.66666666667,6,E01002808,2,7,4,8,6,5,5.583183985264575,5.109959908196183,5.697451491824916,4.92416974169309,5.352387927594732,5.89410276686559,5.503459749651737,143007.88524590165,5,3,6,4,4,3,3,1.0,-1,1,-1,0,-4,-3,-2
2742,5.668112566525286,5.069053468379107,5.772742011330345,4.761908081444827,5.547061115503311,6.064512523737821,5.470139983025464,119484.85227272728,5,E01002809,2,7,2,6,6,4,5.767102547180959,4.873674695308392,5.968850759359507,4.774960611111078,5.461457319748708,6.068427853095225,5.62321302982477,151209.20512820513,7,0,9,1,7,7,6,1.0,2,-2,2,-1,1,1,2
2743,5.560774512747501,4.966172701500832,5.933275369887657,4.781194144106926,5.50885399098092,5.948252036216411,5.595808511084699,115530.93617021276,4,E01002810,1,9,2,5,4,6,5.578919378079866,4.931694963103847,5.912015500821565,4.8386419233522915,5.4386700379221065,5.986128786990517,5.677864265441895,146194.09473684212,5,1,9,2,6,5,6,1.0,1,0,0,0,1,1,0
2744,5.948253113882882,4.998987511226109,5.902303862571716,4.66003566639764,5.631318184307643,6.253760017667498,5.727925155844007,109295.31428571428,8,E01002811,1,8,1,8,8,8,5.794389753402034,5.037092647975004,5.810618225532242,4.74186716351328,5.349078869517846,6.059174444102034,5.630444490456883,138932.20253164557,7,2,8,1,4,6,6,1.0,-1,1,0,0,-4,-2,-2
2745,5.971311413066488,4.876409013506392,6.107669578471654,4.667149661292492,5.637547207550264,6.098048690339209,5.867501376380383,143893.69014084508,8,E01002812,0,9,1,8,6,9,5.842739788924947,4.742875393699197,6.07482431566014,4.584088690140668,5.566067818333121,6.031625621459064,5.860629779451034,182019.82352941178,8,0,9,0,9,6,9,1.0,0,0,0,-1,1,0,0
2746,5.53385351906138,4.899928609201731,5.953533016945705,4.699727056440243,5.587403531902092,6.037142479715269,5.80989103671933,143658.47933884297,4,E01002813,0,9,1,7,5,8,5.596312809333527,4.799703522551831,6.011102698689742,4.6735502610103685,5.5236033647180465,6.041640550970174,5.851384624302816,181729.22302158273,5,0,9,0,8,6,9,1.0,1,0,0,-1,1,1,1
2747,5.33669957289329,5.172096651334029,5.679691653985244,5.032960974253141,5.299618341601812,5.752298763165107,5.539485172583507,144076.23076923078,1,E01002814,3,6,7,1,1,5,5.386233409897226,5.075584152682882,5.738848615865239,4.94347460348098,5.308791391185073,5.844512296504662,5.696613440748121,182189.19672131148,3,2,7,4,3,2,7,1.0,2,-1,1,-3,2,1,2
2748,5.701048851013184,4.95442091551694,5.978385348753496,4.67985427162864,5.542842045697299,6.054146606271917,5.723905509168452,144081.25454545455,5,E01002815,1,9,1,6,5,8,5.792111467231404,4.8570428842848,6.082408130168915,4.753349957141009,5.545410205017436,6.024354056878523,5.854110056703741,182204.13636363635,7,0,9,1,8,6,9,1.0,2,-1,0,0,2,1,1
2749,5.72562645899283,4.8004865646362305,6.085989188503575,4.695583884780471,5.7353454860481055,5.937653341808835,5.764652761253151,143263.72972972973,6,E01002816,0,9,1,9,3,8,5.685464943156523,4.670883043723948,6.14744846610462,4.724539446480134,5.75920609516256,5.906835037119248,5.795028737362693,181210.82352941178,6,0,9,0,9,3,8,1.0,0,0,0,-1,0,0,0
2750,5.721308118984347,4.989184712777372,5.748776672316379,4.754272543016027,5.53352581282131,5.902976907667567,5.590539210155362,143532.96721311475,6,E01002817,1,7,2,6,3,6,5.706157636993072,4.969741226995692,5.780320402453928,4.79823280432645,5.49390001069097,5.927772749872768,5.678685126935735,181559.41176470587,7,1,7,1,7,4,6,1.0,1,0,0,-1,1,1,0
2751,5.549316155910492,4.745240351286801,6.020642789927396,4.842640972137451,5.569553931192918,5.861909738995812,5.666484278440476,127690.65454545454,4,E01002818,0,9,4,7,2,7,5.562713858961057,4.7450427022300845,5.923114900328532,4.770267924340833,5.589998642937476,5.909068379081598,5.717830403512266,161177.21848739494,5,0,9,1,9,3,7,1.0,1,0,0,-3,2,1,0
2752,5.606038318866748,4.794371660246233,5.937839550264714,4.803147309704831,5.595791142523003,5.94861604722493,5.649993654643519,128546.64114832536,4,E01002819,0,9,3,7,4,7,5.628808592961839,4.789534680606905,5.945012338397917,4.782924974752852,5.54635829669385,5.951367260010774,5.741417592714641,162223.03719008266,6,0,9,1,8,4,7,1.0,2,0,0,-2,1,0,0
2753,5.653165486252424,4.8219070816502985,6.026637378248196,4.760557381852159,5.573930066766091,5.9561697256217885,5.8403665336590365,129794.08737864078,5,E01002820,0,9,2,7,4,9,5.6845892283876065,4.752150034500381,6.047640440827709,4.724636440559969,5.570985467757209,5.967234140735561,5.9158513707629705,163744.48305084746,6,0,9,0,9,4,9,1.0,1,0,0,-2,2,0,0
2754,5.738220712506627,4.873090375618762,6.010623789695372,4.700076024216342,5.658224639404251,5.920454289539751,5.762573441827153,128963.77108433735,6,E01002821,0,9,1,8,3,8,5.71589027650608,4.81081763927981,5.977203206245943,4.769029080497552,5.523717985390136,5.9230894065051345,5.766019439845351,162756.98757763975,7,0,9,1,8,4,8,1.0,1,0,0,0,0,1,0
2755,5.880745621414872,4.836464658513799,5.9510926362630485,4.6898751140714765,5.681986067746137,6.021430586909388,5.86870648946848,130129.63063063064,7,E01002822,0,9,1,9,5,9,5.763666081234692,4.754180485640115,6.055643771722065,4.689292993971972,5.5830060892957984,5.954599721644952,5.916322599581586,164192.71544715448,7,0,9,0,9,4,9,1.0,0,0,0,-1,0,-1,0
2756,5.571036932369073,4.962988718102376,5.802770654360454,4.7856849531332655,5.539414775868257,5.892795992394288,5.654319969316323,129771.10416666667,4,E01002823,1,7,3,6,3,7,5.690925739705563,4.9667005849381285,5.860628806054592,4.719935558736324,5.576860388120015,5.858349171777566,5.623636307815711,163781.04166666666,6,1,8,0,9,2,6,1.0,2,0,1,-3,3,-1,-1
2757,5.782879981441774,4.829750781473906,6.105375251908233,4.684551347856936,5.683393544045048,6.111506199491197,5.816838489062544,142312.24637681158,6,E01002824,0,9,1,9,7,9,5.828162718510282,4.842673163483108,6.122539924538654,4.732211596723916,5.589614591736725,6.025729016981263,5.824547574140023,179979.46376811594,8,0,9,0,9,6,8,1.0,2,0,0,-1,0,-1,-1
2758,5.973293835999535,4.833826926888013,5.928781843576275,4.649223067721382,5.724382818722334,6.050462314339935,5.704380468266909,142476.24590163934,8,E01002825,0,9,0,9,5,7,5.98950703509219,4.858930630726857,5.925944568874599,4.729028314083546,5.701421129810917,6.054966580760372,5.825784406146488,180180.83783783784,9,0,9,0,9,6,8,1.0,1,0,0,0,0,1,1
2759,5.71345759692945,4.715128804508009,6.029975211411192,4.68997204408311,5.6639813393877265,5.9503073253129655,5.709606792843132,142599.93859649124,6,E01002826,0,9,1,8,4,7,5.466828513603944,4.645878546513044,6.051334243554336,4.900943688475168,5.495105819060252,5.8571516802677746,5.775975678975765,180292.50961538462,4,0,9,3,7,2,8,1.0,-2,0,0,2,-1,-2,1
2760,5.461325503684379,4.924821785978369,5.9359888917690995,4.759134038880065,5.5954307688249125,5.985631212994859,5.6909478765887185,142104.3581081081,3,E01002827,0,9,2,7,4,7,5.555065248858544,4.768139856092391,6.006921220594837,4.841414813841543,5.497159259550033,5.882901300922517,5.719359529402948,179723.29677419356,5,0,9,2,7,3,7,1.0,2,0,0,0,0,-1,0
2761,5.647078488693863,5.050673426174726,5.743635328089605,4.769363569431618,5.629895178998103,5.9185407826157865,5.591220975899305,142184.25409836066,5,E01002828,1,7,2,8,3,6,5.623723229092937,4.928220393196229,5.7644218648633645,4.826601244749561,5.600715538186412,5.893664365814578,5.587872322528593,179824.6693548387,6,1,7,2,9,3,5,1.0,1,0,0,0,1,0,-1
2762,5.592197855313619,4.807104396097587,6.0091927593404595,4.828421005696962,5.568609815655333,5.855146003491951,5.612042685349782,137579.24242424243,4,E01002829,0,9,3,7,2,6,5.557442199100148,4.799076150764119,6.038551861589605,4.785956561565399,5.467831105896921,5.963702606432365,5.778537853197618,173782.5,5,0,9,1,7,4,8,1.0,1,0,0,-2,0,2,2
2763,5.556470753310562,4.972620129585266,5.903611463385743,4.833982080608219,5.526063270383067,5.935311023291055,5.49370044547242,138132.1038961039,4,E01002830,1,8,4,6,3,4,5.441331103250578,4.883332246309751,5.977319485181338,4.812482923656315,5.454288917702514,5.874522237034587,5.6328710395020325,174673.67532467534,3,0,9,2,6,3,6,1.0,-1,-1,1,-2,0,0,2
2764,5.431972860035144,4.845245470498737,5.978479279969868,4.860386344006187,5.514671762366044,5.895933018232647,5.596838779198496,138275.47368421053,2,E01002831,0,9,4,5,3,6,5.335296432177226,4.819416221450357,5.995109597841899,4.841891348361969,5.437780712165084,5.892447504342771,5.563063478937336,174827.4019607843,2,0,9,2,6,3,4,1.0,0,0,0,-2,1,0,-2
2765,5.52278119843939,4.916018159493156,5.96732734338097,4.824041897835939,5.5419418423072155,5.9632144129794575,5.601079625927883,138439.19565217392,3,E01002832,0,9,3,6,4,6,5.419921391081102,5.004648164947434,5.924747743228875,4.883660910153153,5.400347133674244,5.83847980688114,5.557260905161942,175081.56435643564,3,1,9,3,5,2,4,1.0,0,1,0,0,-1,-2,-2
2766,5.513845377049203,4.796414749097016,6.076488608020847,4.896968043456643,5.6044730129888505,5.913036217123775,5.785160038430812,140270.98305084746,3,E01002833,0,9,5,7,3,8,5.6260038223759885,4.655775031139111,6.09935201036519,4.8354691205353575,5.484683937039868,5.98465528159306,5.7791569561793885,177358.4827586207,6,0,9,2,7,5,8,1.0,3,0,0,-3,0,2,0
2767,5.9504466617808625,4.692425708560383,6.233211825875675,4.580465704202652,5.6044772898449615,6.0756928359760956,5.938812429414076,144614.9411764706,8,E01002834,0,9,0,7,6,9,5.943831784857644,4.742259057031737,6.200412260161506,4.481141747699843,5.612875498003429,6.036604053444332,6.0066278907987805,182871.09722222222,9,0,9,0,9,6,9,1.0,1,0,0,0,2,0,0
2768,5.641565477711031,4.815605548606522,5.974054547561996,4.797876975317111,5.620358534242915,5.907095773466702,5.787343103995268,138277.4712643678,5,E01002835,0,9,3,8,3,8,5.619998560196314,4.85453963463123,5.932327716778486,4.78610332929171,5.559705934157738,5.942012871228732,5.865232953658471,174616.2717948718,6,0,9,1,8,4,9,1.0,1,0,0,-2,0,1,1
2769,6.101078472275665,4.466503281524216,6.326441059941831,4.578457174093827,5.858200066331504,6.202946351922077,6.133525620336118,144875.27536231885,9,E01002836,0,9,0,9,8,9,5.947018553813298,4.536452346377903,6.246856977542241,4.463888444834286,5.767979188097848,6.086206465959549,6.041561812162399,183210.86111111112,9,0,9,0,9,7,9,1.0,0,0,0,0,0,-1,0
2770,5.8528262575467425,4.838637265894148,6.089321666293674,4.631977217064963,5.689960406886207,6.0702324079142675,5.904843744304445,136058.93055555556,7,E01002837,0,9,0,9,6,9,5.898620199512791,4.809533647588782,6.063014507293701,4.678358396968326,5.671031555613956,6.089902478295404,5.86880435653635,171885.2837837838,8,0,9,0,9,7,9,1.0,1,0,0,0,0,1,0
2771,5.814181857638889,4.694032400846481,6.099765313996209,4.661578782730633,5.719428211450577,6.051004595226711,5.888517344991366,130573.125,7,E01002838,0,9,1,9,5,9,5.850835560183776,4.639372414664218,6.072710768172615,4.635559380054474,5.663100233203487,6.078644096851349,5.947394700426805,164717.13157894736,8,0,9,0,9,7,9,1.0,1,0,0,-1,0,2,0
2772,5.811766205010591,4.643854531976912,6.104281919973868,4.816195657959691,5.573196596569485,5.9964287899158615,5.92555026654844,144225.57407407407,7,E01002839,0,9,3,7,4,9,5.745893845819447,4.679149392532976,6.174138559054022,4.655742508091339,5.628285038961123,6.037406353101338,6.035384400250161,182438.4109589041,7,0,9,0,9,6,9,1.0,0,0,0,-3,2,2,0
2773,5.361745509505272,5.086488851904869,5.850114154815674,4.982454746961594,5.389930564165115,5.833215409517289,5.330186486244202,76933.8375,2,E01002840,2,8,6,3,2,1,5.497609216433305,5.000008103175041,5.821318782292879,4.894173667981074,5.389583587646484,5.871059983204573,5.522985822115189,99025.93589743589,4,1,8,3,5,3,4,1.0,2,-1,0,-3,2,1,3
2774,5.490962456254398,5.009709206281924,5.846463266540976,4.898466228270063,5.45803891209995,5.873445720064874,5.514279331646714,78787.5,3,E01002841,1,8,5,4,2,4,5.576317341640742,4.879367470741272,5.925432884331905,4.900216011085895,5.423672051140756,5.928005409963204,5.565948532085226,100778.79797979798,5,0,9,3,6,4,4,1.0,2,-1,1,-2,2,2,0
2775,6.157783895730972,4.82549375295639,6.070884555578232,4.7215126901865005,5.654553115367889,6.101230770349503,5.767929255962372,77266.25,9,E01002842,0,9,1,8,6,8,6.103457689285278,4.4663145542144775,6.132725715637207,4.674984961748123,5.654714226722717,6.095356285572052,6.171196460723877,99322.5,9,0,9,0,9,7,9,1.0,0,0,0,-1,1,1,1
2776,5.642232757144504,5.171751454141405,5.870643499162462,4.835280601183573,5.5103967136806915,5.856905534532335,5.6671797964307995,81789.93333333333,5,E01002843,3,8,4,5,2,7,5.503574940024829,4.944150707760795,5.892352631834687,4.913883486732107,5.52515257382002,5.889376241652692,5.576556790070455,105542.52459016393,4,1,8,3,8,3,5,1.0,-1,-2,0,-1,3,1,-2
2777,5.676935199896494,4.9522780557473505,5.791894054412841,4.744843803842863,5.629454441865286,5.896392011642456,5.742093759775162,76423.28333333334,5,E01002844,1,7,2,8,3,8,5.790414866770288,4.850270398395998,5.888574641038471,4.724052173154363,5.578187345066887,5.9899270859209945,5.823275638461577,98861.06614785992,7,0,8,0,9,5,8,1.0,2,-1,1,-2,1,2,0
2778,5.712859363879188,4.786499536643594,5.8702662960957674,4.5943011611194935,5.559763346688222,5.977809926210823,5.678893477229749,76687.06779661016,6,E01002845,0,8,0,6,4,7,5.639876127243042,4.658337129921209,5.99443745222248,4.629058751903597,5.561563429285268,5.926306177358159,5.914795914634329,98624.4262295082,6,0,9,0,8,4,9,1.0,0,0,1,0,2,0,2
2779,5.818401585022609,4.698019723097484,6.163984467585881,4.593002537886302,5.629248867432277,6.085599685708682,6.0048307453592615,143694.04166666666,7,E01002846,0,9,0,8,6,9,5.893769795695941,4.77126266558965,6.12160229186217,4.703736757238706,5.710181832313538,6.00161428252856,5.939738658567269,181675.04166666666,8,0,9,0,9,5,9,1.0,1,0,0,0,1,-1,0
2780,6.05067192739056,4.56026953266513,6.19850306741653,4.542610179993414,5.743730987271955,6.207578247593295,6.079978269915427,144974.62903225806,9,E01002847,0,9,0,9,8,9,5.835208482008714,4.610702340419476,6.254520588654739,4.561253998829768,5.576101981676542,5.979940482286307,6.029102948995737,183261.0923076923,8,0,9,0,9,5,9,1.0,-1,0,0,0,0,-3,0
2781,5.6470285021528905,4.943705685284673,5.991704605063614,4.810650528693686,5.517552862361986,5.96927379102123,5.798515168987975,145005.6326530612,5,E01002848,1,9,3,5,4,8,5.76598264341769,4.846293498640475,6.011740725973378,4.703316286854122,5.519204328889432,6.008640501810157,5.861392767533012,183248.78260869565,7,0,9,0,8,5,9,1.0,2,-1,0,-3,3,1,1
2782,5.9268702580378605,4.610541831530058,6.15640959739685,4.632924421016987,5.664597804729755,6.041743241823637,5.94113808962015,144825.6923076923,8,E01002849,0,9,0,8,5,9,5.95139495531718,4.599264877429907,6.209614729535753,4.55030594010284,5.612976927688156,6.091900262279787,5.9888185660044355,183122.52173913043,9,0,9,0,9,7,9,1.0,1,0,0,0,1,2,0
2783,5.55826156023072,4.816015013834325,6.003508701557067,4.793249082274553,5.611919670570187,5.965123420808373,5.607925621474662,144223.8780487805,4,E01002850,0,9,3,8,4,6,5.538993089036508,4.654683050784198,6.0521201681007035,4.7938007035038686,5.51382038268176,5.855916009707884,5.694172505627979,182442.9090909091,4,0,9,1,8,2,7,1.0,0,0,0,-2,0,-2,1
2784,5.507300120885255,4.833107281903752,6.020401868663851,4.858238149861821,5.456744059187467,5.942288816952314,5.719905737970696,144473.4262295082,3,E01002851,0,9,4,4,4,7,5.6712700205464515,4.782707602747025,6.113361585524775,4.717334458904881,5.466317057609558,6.058494429434499,5.84693456080652,182693.46774193548,6,0,9,0,7,6,9,1.0,3,0,0,-4,3,2,2
2785,5.15475112883771,5.294023511839694,5.253423141651466,5.343885202876857,5.1857901342579575,5.596120752272059,5.23613094306383,136117.59016393442,0,E01002852,5,0,9,0,0,1,5.2326781302016245,5.239532913018136,5.33309018234322,5.1885026671767775,5.220659953976109,5.65042465250956,5.26941724114828,173055.51583710406,1,5,1,8,1,0,0,1.0,1,0,1,-1,1,0,-1
2786,5.17396963270087,5.1934606464285595,5.636044188549644,5.1598518302566125,5.267771711474971,5.62017496008622,5.235357293957158,138002.63157894736,0,E01002853,3,5,9,1,0,1,5.287128064139136,5.093368441894136,5.661860276912821,4.974447219536223,5.298926706971793,5.877531220173013,5.482820572524235,174428.6551724138,1,3,6,5,3,3,3,1.0,1,0,1,-4,2,3,2
2787,5.078457933361247,5.634286563275224,4.999919119527784,5.314154388540882,4.968882104097786,5.370620099164672,5.135211795063342,137874.45762711865,0,E01002854,9,0,9,0,0,0,5.025583907500985,5.295680199701762,5.2718132304162095,5.160362794227207,5.101910215063193,5.589723587036133,5.263509498429053,174306.84536082475,0,6,0,8,0,0,0,1.0,0,-3,0,-1,0,0,0
2788,5.182006137187664,5.157534918418297,5.57347816320566,5.052812979771541,5.2106176174603975,5.6298767456641565,5.2498731393080496,137990.64615384614,0,E01002855,3,4,7,0,0,1,5.416400725596419,4.904612512231987,5.689638752803624,5.041467667740082,5.28609609826703,5.807565477406867,5.449595866916336,174415.6168224299,3,1,6,6,2,2,2,1.0,3,-2,2,-1,2,2,1
2789,5.664843845698568,5.025257251328892,5.830303947130839,4.877136944068803,5.400747913453314,5.941512636012501,5.717630692654186,138172.25,5,E01002856,1,8,4,3,4,7,5.522787052231866,5.066916419042124,5.699886497613546,4.968883461243397,5.280273058929959,5.859712839126587,5.792114612218496,174712.75675675675,4,2,6,5,2,2,8,1.0,-1,1,-2,1,-1,-2,1
2790,4.886591298239572,5.4065836157117575,5.60945919581822,5.211661543164935,5.264080728803362,5.640202386038644,5.169405835015433,138038.85714285713,0,E01002857,7,5,9,1,0,0,5.26841103813865,5.025616136464206,5.679488801956177,5.233065388419411,5.245506845821033,5.745896755565297,5.352920111742887,174379.9090909091,1,2,6,9,2,1,1,1.0,1,-5,1,0,1,1,1
2791,5.333639692451994,4.861341201652915,5.855170488357544,5.013336357423815,5.442293441901772,5.841575669030012,5.44139581615642,128678.25423728813,1,E01002858,0,8,7,4,2,3,5.2300802983086685,4.877974518414201,5.817067491597142,4.976244850405331,5.409332437761899,5.740139484405518,5.587663662844691,162375.5344827586,1,0,8,5,5,1,5,1.0,0,0,0,-2,1,-1,2
2792,5.861856072953662,4.636400793333474,6.209472776209034,4.65667273938281,5.775123695157609,5.996687509728678,5.930808916031939,127799.83647798742,7,E01002859,0,9,1,9,4,9,5.867395721782337,4.572153319012035,6.1427073030760795,4.61366830811356,5.669599369800452,6.070190892075047,5.952050644701178,161329.0181818182,8,0,9,0,9,7,9,1.0,1,0,0,-1,0,3,0
2793,5.398436555425629,4.912133198658019,5.766232439579855,4.792493005745284,5.468977504104148,5.851511480244062,5.6060287524725645,128273.03816793892,2,E01002860,0,7,3,4,2,6,5.4586442063625595,4.856026922849784,5.813705584160368,4.845231137777629,5.48079452478796,5.838568328914786,5.631303593628388,161876.29323308272,3,0,8,2,7,2,6,1.0,1,0,1,-1,3,0,0
2794,5.570559842718972,4.736400220129225,5.985323817641647,4.818602076283208,5.653776091557962,5.946728147842266,5.646585286767395,129502.30555555556,4,E01002861,0,9,3,8,4,6,5.571501810271461,4.7370952625532405,5.964031889631942,4.780841288265881,5.579382703110978,5.949438501048732,5.690583689792736,163418.9009009009,5,0,9,1,9,4,7,1.0,1,0,0,-2,1,0,1
2795,5.5379481590711155,4.817145086251772,5.938847775642689,4.873660142605122,5.681635173467489,5.817534355016855,5.569382236554072,129983.42307692308,4,E01002862,0,9,4,9,2,5,5.491794214410297,4.679087149894844,5.9589969505698,4.847308110382597,5.590594101760347,5.856917005474284,5.688341068009199,163983.5593220339,4,0,9,2,9,2,7,1.0,0,0,0,-2,0,0,2
2796,5.624268844064358,4.905750885473943,5.760203348851837,4.791493504448274,5.65535516021526,5.7206633512952685,5.5927299925711305,127617.18584070797,5,E01002863,0,7,3,8,1,6,5.679595360235006,4.8605182822011095,5.865181510187998,4.692652019132085,5.596661713944764,5.898805890764509,5.74061817581914,161042.49579831932,6,0,8,0,9,3,7,1.0,1,0,1,-3,1,2,1
2797,6.08348348125908,4.881008859006514,5.905452055960708,4.643907341897858,5.695704978445302,6.129456093592673,5.83986845297843,142881.27329192546,9,E01002864,0,8,0,9,7,9,5.906354380559318,4.982877317863174,5.923917512350444,4.702343729477894,5.573762732216075,6.0893571844583825,5.850209513797036,180818.19620253163,8,1,9,0,9,7,9,1.0,-1,1,1,0,0,0,0
2798,5.776231052478154,4.892351121703784,5.9896825393040976,4.767088085412979,5.608510652184487,6.073567018906275,5.7238961587349575,142802.66666666666,6,E01002865,0,9,2,7,6,8,5.814264567930307,4.836252074633071,5.958572473098982,4.665490047255559,5.595585165628746,6.099076614451053,5.836042642593384,180614.4552238806,8,0,9,0,9,7,8,1.0,2,0,0,-2,2,1,0
2799,5.937676405420109,4.828399795658735,6.044721591229341,4.629110030981959,5.625127760731444,6.153294675204219,5.889133810997009,140543.51020408163,8,E01002866,0,9,0,8,7,9,6.011226154509044,4.790221814882187,6.071647201265607,4.610835721379234,5.64301609992981,6.101161418642317,5.85328683966682,177789.62857142856,9,0,9,0,9,7,9,1.0,1,0,0,0,1,0,0
2800,5.670804727778715,4.850226995524238,6.005205120759852,4.7200230121612545,5.562899572709028,5.981745705885046,5.724480522380156,143890.54117647058,5,E01002867,0,9,1,7,4,8,5.817839456159015,4.902609316415565,5.969546914100647,4.688975409019825,5.586775552394778,5.9375724016233935,5.729059413421986,181829.2093023256,8,0,9,0,9,4,7,1.0,3,0,0,-1,2,0,-1
2801,5.984092880809118,5.048432001045772,5.939863933457269,4.7386175734656195,5.574160634525239,6.124379250738356,5.821769141961658,141679.55555555556,8,E01002868,1,9,2,7,7,9,5.943639469576311,4.966628698615341,5.857221248987559,4.7090730548978925,5.519515331800993,6.081339503193761,5.887113590498228,179031.87387387388,9,1,8,0,8,7,9,1.0,1,0,-1,-2,1,0,0
2802,5.819950557090867,4.946196210216469,5.941426925256219,4.829555073254545,5.445120992794843,6.004867234700162,5.757122791988749,140098.77464788733,7,E01002869,1,9,3,4,5,8,5.760857923531238,4.904867069220837,5.962658729082272,4.767530099845227,5.571715101783658,6.0001810715522295,5.849743430997118,177237.46913580247,7,1,9,1,9,5,9,1.0,0,0,0,-2,5,0,1
2803,5.160975562847726,5.291322593766499,5.394292427272331,5.22634081433459,5.2494204955372386,5.5592701008649374,5.1924746501736525,139414.28455284552,0,E01002870,5,1,9,0,0,0,5.239838684704287,5.160487176678705,5.543509136700461,5.097433893393117,5.28946944415992,5.704108067438112,5.441526653918814,176340.24822695035,1,4,3,7,2,0,2,1.0,1,-1,2,-2,2,0,2
2804,5.6098290968544875,4.9864310501497,5.842855332772943,4.799384237844733,5.527490203139148,5.835154130489012,5.545299808435802,141988.3987341772,4,E01002871,1,8,3,6,2,5,5.496725099317489,4.991178457198605,5.8391210048429425,4.84428280861147,5.499479061557401,5.868152769150273,5.629520959238852,179589.54193548387,4,1,8,2,7,3,6,1.0,0,0,0,-1,1,1,1
2805,5.664918602781093,5.039704492751588,5.794205094905609,4.85356165373579,5.576712922847017,5.898232363639994,5.517801190944428,140375.82978723405,5,E01002872,1,7,4,7,3,4,5.4758105778694155,5.027115124464035,5.789489574432373,4.859074807167053,5.498534673452378,5.890432486534118,5.588638124465942,177668.83,4,2,8,2,7,3,5,1.0,-1,1,1,-2,0,0,1
2806,5.499715792197807,5.153991468981201,5.661636813014161,5.013906995455424,5.307213496928122,5.808428451126697,5.4833522894803215,139869.10784313726,3,E01002873,3,5,7,1,2,4,5.542330590454307,5.119257646637994,5.67367929918272,4.868801282332824,5.3114117072509215,5.845006485243101,5.61245385268787,176948.45945945947,5,3,6,3,3,2,5,1.0,2,0,1,-4,2,0,1
2807,5.7575449993213015,4.758823009828727,6.083607971668243,4.69380825261275,5.596101798117161,6.168222685654958,5.8695408056179685,139288.27083333334,6,E01002874,0,9,1,7,7,9,5.633395461068637,4.911714540011641,6.089055130447167,4.7538492454998735,5.530389146528382,6.160669447719187,5.963904812716056,176181.36231884058,6,1,9,1,8,8,9,1.0,0,1,0,0,1,1,0
2808,5.9480076449758865,4.9949818972279045,5.864697547519908,4.695794314146042,5.553782204494757,6.1076812638955955,5.759401474805439,141169.21323529413,8,E01002875,1,8,1,6,6,8,5.815043294266479,4.971999471318232,5.886293999136311,4.736509929781091,5.502113451696422,6.062843755499958,5.894773240775278,178436.2808219178,8,1,8,0,7,6,9,1.0,0,0,0,-1,1,0,1
2809,6.384666180342771,4.728266036912297,6.204415650849931,4.588541008113475,5.718806521276409,6.549551007452975,6.1420273486148105,138456.94382022473,9,E01002876,0,9,0,9,9,9,6.1676446620155785,4.719410068848553,6.018404661440382,4.653371431079566,5.6323903167949005,6.411372367073508,6.056626938137353,174950.6862745098,9,0,9,0,9,9,9,1.0,0,0,0,0,0,0,0
2810,5.15290101346253,5.454746739023682,5.288174392170989,5.283869397433507,5.134052721062147,5.5977708170179685,5.197732153655477,138889.76878612716,0,E01002877,8,0,9,0,0,0,5.165043923655167,5.435806249750072,5.326275601762856,5.24939911706107,5.093448760474256,5.623678482812027,5.311632091188666,175711.7684729064,0,8,1,9,0,0,1,1.0,0,0,1,0,0,0,1
2811,5.517398649683366,5.229870048853067,5.505182003745666,5.012595254641313,5.2931951295871,5.843393085094599,5.488420288150127,138425.61538461538,3,E01002878,4,3,7,1,2,4,5.415623520492414,5.219175150635046,5.555858031325384,5.073736398591908,5.202943249579963,5.824923661870694,5.564083835400573,175003.63302752294,3,5,4,7,1,2,4,1.0,0,1,1,0,0,0,0
2812,5.59249503657503,5.044602956411974,5.796961842842822,4.9063637256622314,5.4741281023565325,5.825135716852152,5.482563851014623,138983.43396226416,4,E01002879,1,7,5,4,2,4,5.521363272183184,5.036159470461417,5.699213864146799,4.950125423030577,5.357801677524179,5.863916175952856,5.558573358300803,175676.13043478262,4,2,6,4,4,2,4,1.0,0,1,-1,-1,0,0,0
2813,5.194843032903838,5.301592851939954,5.377824770776849,5.193857402132268,5.222535154275727,5.555466735572145,5.263356079135025,139065.12280701756,0,E01002880,5,1,9,0,0,1,5.182925464743275,5.380670745494002,5.467283006441796,5.142228789248709,5.086221935385365,5.593964132211976,5.30533882318917,175901.5593220339,0,8,2,8,0,0,1,1.0,0,3,1,-1,0,0,0
2814,5.663175113499165,5.100531296804547,5.823954023420811,4.873900083824992,5.572427291423082,5.976060602813959,5.536898918449879,139204.578125,5,E01002881,2,8,4,7,4,5,5.673534688664906,5.006839364322264,5.838819115909178,4.863442844419337,5.410901293825748,5.923827327899079,5.6172063955620155,176067.8208955224,6,2,8,2,5,4,5,1.0,1,0,0,-2,-2,0,0
2815,5.739067966555372,4.885049922966663,5.965258239228048,4.797020809150037,5.561249126622706,5.928820451100667,5.8301768567827015,141263.5185185185,6,E01002882,0,9,3,6,3,9,5.826976930772936,4.867749328548844,6.032850462037164,4.7425643415064425,5.486115347694707,5.993783699499594,5.881125081229854,178724.0,8,0,9,1,7,5,9,1.0,2,0,0,-2,1,2,0
2816,5.758186164528433,4.984227084150218,5.916865991823601,4.799848131459169,5.561885098014215,5.958342219844009,5.638280634928232,141734.65656565657,6,E01002883,1,8,3,7,4,6,5.589770272246793,5.014659447547717,5.80160358420804,4.795603944705083,5.471924676854386,5.852231700196225,5.699900368339995,179255.84615384616,5,2,8,1,7,2,7,1.0,-1,1,0,-2,0,-2,1
2817,5.694708313002731,4.848907387617863,6.050289695913142,4.69543713873083,5.606133314696225,5.972274198676601,5.735499203205109,141451.63636363635,5,E01002884,0,9,1,7,4,8,5.614253947314094,4.869057223376106,5.995730613259708,4.904383743510527,5.503663346346687,5.904360810448142,5.86503220726462,178942.55294117646,5,0,9,3,8,3,9,1.0,0,0,0,2,1,-1,1
2818,5.975000061486897,4.578959662663309,6.241349138711628,4.677959354300248,5.659610189889607,6.214192070459065,5.937677088536714,141464.73684210525,8,E01002885,0,9,1,8,8,9,5.848640739917755,4.747769912083943,6.068877145648003,4.67502165089051,5.6060347110033035,6.090879241625468,5.9965877284606295,178920.625,8,0,9,0,9,7,9,1.0,0,0,0,-1,1,-1,0
2819,5.794369144538014,4.849811437203712,6.011458224856977,4.69347650980212,5.490708722281702,6.0976712408754015,5.819414618089027,139848.04123711342,7,E01002886,0,9,1,5,6,9,5.706860043108463,4.8407741859555244,5.953207388520241,4.769060372241905,5.502648238624845,6.018903556678977,5.682640513139112,176404.41964285713,7,0,9,1,7,6,7,1.0,0,0,0,0,2,0,-2
2820,5.677347627686865,4.867146487589236,6.051729255252415,4.769887345808524,5.5419902301129,6.041117400298884,5.856796032116737,143544.76543209876,5,E01002887,0,9,2,6,5,9,5.58466405927399,4.846046931949663,6.0287379629818005,4.824887615663034,5.57677611892606,5.971564125131677,5.898575366279225,181566.23456790124,5,0,9,2,9,5,9,1.0,0,0,0,0,3,0,0
2821,5.835892123718784,4.875934120726912,5.928996197164875,4.716265805780071,5.59218498452069,6.029427799460006,5.82848043637733,143778.1780821918,7,E01002888,0,9,1,7,5,9,5.627332718975572,4.916909154639186,5.893421563757471,4.816329247980232,5.452694796654115,5.894764905952545,5.732164540922786,181951.73493975904,6,1,8,2,6,3,7,1.0,-1,1,-1,1,-1,-2,-2
2822,5.970738923007792,4.5296581238508224,6.249035827138207,4.622073294086889,5.720977151935751,6.1630960621617055,5.910836639729413,142767.23863636365,8,E01002889,0,9,0,9,7,9,5.755294873876479,4.581651891319497,6.151818830990097,4.60273567912648,5.6104897515287675,5.98039244448097,5.97681460797208,180624.2427184466,7,0,9,0,9,5,9,1.0,-1,0,0,0,0,-2,0
2823,5.73345536845071,4.990057265758514,5.909990760258266,4.670325838668006,5.628076867546354,6.06755176612309,5.691268524101802,143265.37142857144,6,E01002890,1,8,1,8,6,7,5.702459012937246,4.803277219616392,5.951153279850318,4.739060156000485,5.591864876777121,6.016456149659067,5.783442001672661,181212.50943396226,7,0,9,1,9,5,8,1.0,1,-1,1,0,1,-1,1
2824,5.817731142044067,4.853115117911137,5.988537867863973,4.716194884945648,5.587246503492798,5.983523173765703,5.704263712420608,140772.19191919192,7,E01002891,0,9,1,7,4,7,5.733153282550344,4.888068350783565,5.869457604592307,4.782163879327607,5.523544826005635,5.992420803036606,5.825421418014326,178024.84210526315,7,0,8,1,8,5,8,1.0,0,0,-1,0,1,1,1
2825,5.490009517283053,4.87633976743028,5.9967696698936255,4.893638520627408,5.492212949572383,5.88666336117564,5.667417717946543,137783.01351351352,3,E01002892,0,9,5,5,3,7,5.6162792768167416,4.923257981953413,5.967271527518397,4.7835549556690715,5.586614266685817,5.938516388768735,5.881664110266644,174346.0,5,1,9,1,9,4,9,1.0,2,1,0,-4,4,1,2
2826,6.135704700048867,4.717469977093981,6.2074791641978475,4.576970984409382,5.8028802035690905,6.215505813623404,6.006316692798169,94566.22077922078,9,E01002893,0,9,0,9,8,9,5.955841556772009,4.546435575980644,6.250234120851987,4.577802512552831,5.701260740106756,6.172663515264338,6.097979768530115,127776.35064935064,9,0,9,0,9,8,9,1.0,0,0,0,0,0,0,0
2827,5.958554650942484,4.6934582837422685,6.075853287378947,4.7113635571797685,5.8067596213022865,6.148496929804484,5.835471064249674,134966.08,8,E01002894,0,9,1,9,7,9,5.641858185254611,4.578584052966192,6.033863940605751,4.740567025771508,5.682081184020409,6.032272624969482,5.901540493965149,174945.24615384615,6,0,9,1,9,6,9,1.0,-2,0,0,0,0,-1,0
2828,5.544117197102191,4.964796572339301,5.936688633526073,4.750086159098382,5.4994405543102935,5.912707279710209,5.6676750148043915,106361.92156862745,4,E01002895,1,9,2,5,3,7,5.614965570093405,4.835325938282591,5.897159643847533,4.73005613413724,5.512630599917787,5.925203874857739,5.68222642426539,135966.0,5,0,8,0,8,4,7,1.0,1,-1,-1,-2,3,1,0
2829,5.933684267276941,4.6681877915249315,6.143414001132166,4.658022310844688,5.645064613153768,6.1707242533218025,5.919638456300247,109099.8488372093,8,E01002896,0,9,1,8,7,9,5.946078737576802,4.689243966624851,6.125244194553012,4.623834675266629,5.611072727612087,6.190559461003258,6.030483555226099,136690.45238095237,9,0,9,0,9,8,9,1.0,1,0,0,-1,1,1,0
2830,5.939898294738576,5.019933908800535,5.883598692809479,4.7154249179212355,5.719495706920382,6.032337255115751,5.638794432712507,82223.21518987342,8,E01002897,1,8,1,9,5,6,5.600478948108734,4.766515926709251,5.966342717882187,4.674480782614814,5.742811626858181,5.934391082279266,5.860876121218243,105331.57142857143,5,0,9,0,9,4,9,1.0,-3,-1,1,-1,0,-1,3
2831,6.081396488042978,4.714715977291484,5.98580342727703,4.492118312762334,5.713458273436997,6.13629410293076,5.915503885719803,145027.52747252746,9,E01002898,0,9,0,9,7,9,6.031480527841127,4.759850748074361,6.125281440906035,4.509308163936321,5.696227900492839,6.106575379004846,5.970890674835596,183332.60256410256,9,0,9,0,9,7,9,1.0,0,0,0,0,0,0,0
2832,5.44187439029867,5.005045921513529,5.889250155651208,4.873691988713814,5.456084536783623,5.935153484344482,5.545129911466078,97376.36363636363,2,E01002899,1,8,4,4,3,5,5.445451536040375,4.922796437705773,5.889519463414731,4.878638174222863,5.511547416880511,5.921108905819879,5.688239458678425,123861.85507246378,3,1,8,3,8,4,7,1.0,1,0,0,-1,4,1,2
2833,5.888175052932546,4.938848518872563,5.795941518831857,4.688928291767458,5.645567700078216,6.024803229525119,5.680277822138388,73998.3670886076,7,E01002900,0,7,1,8,5,7,5.7867288565149115,4.956723800321826,5.83526028581217,4.770703183550413,5.592420331474875,5.974887045062318,5.741014297316674,95619.1768707483,7,1,8,1,9,5,7,1.0,0,1,1,0,1,0,0
2834,5.992136250842702,4.916283381449712,5.752501651838228,4.700466926221724,5.694021283806144,5.988978277553212,5.693674130873247,100863.0,8,E01002901,0,7,1,9,4,7,5.918406008933642,4.897160887718201,5.819561166052493,4.800705129315394,5.51824012306166,5.97462564965953,5.724892000974335,130709.95652173914,8,0,8,1,8,5,7,1.0,0,0,1,0,-1,1,0
2835,5.863021017256237,4.65595528511774,6.196011936096918,4.630071603684199,5.6753697667803085,5.9510999838511145,5.8387788341158915,128052.93333333333,7,E01002902,0,9,0,9,4,9,5.794244374714646,4.622283054333107,6.098587706977246,4.652896946551753,5.710272090107787,5.944036257033255,5.855699450361962,161376.01960784313,7,0,9,0,9,4,9,1.0,0,0,0,0,0,0,0
2836,5.449622686893221,4.974598862822094,5.854899750815497,4.798672765966446,5.478547682837834,5.802546868248592,5.590772845442333,122529.50793650794,3,E01002903,1,8,3,5,1,6,5.397905900962371,4.891999104865511,5.840903335944154,4.772099651788411,5.535033556751739,5.7301546451740695,5.621859139069579,155347.17293233084,3,0,8,1,8,1,5,1.0,0,-1,0,-2,3,0,-1
2837,5.520536812868985,5.142245234865131,5.7762979160655625,4.973392154231216,5.301684542135759,5.848475427338571,5.349449638164405,135514.12121212122,3,E01002904,3,7,6,1,2,2,5.50112420797348,5.21689083814621,5.7232028579711915,4.842138586044311,5.399579534530639,5.957903256416321,5.624208273887635,171149.16,4,5,7,2,5,4,6,1.0,1,2,0,-4,4,2,4
2838,5.574090300571351,4.911331217913401,5.820877452691396,4.88723844005948,5.413404877696719,5.902342427344549,5.529778751589003,138433.95238095237,4,E01002905,0,7,5,3,3,5,5.614656134085222,4.890772397853127,5.798266682743041,4.871897201892758,5.44606977553407,5.93978903707394,5.678942422236293,175080.77685950414,5,0,8,3,6,4,7,1.0,1,0,1,-2,3,1,2
2839,5.832906612844178,5.037383657513243,5.768196962096474,4.784193920366691,5.564963221549988,6.107244645104264,5.550704358202038,137345.93181818182,7,E01002906,1,7,3,7,6,5,5.742670147624237,4.965311768828639,5.778241976996921,4.8511961635374865,5.536355717292684,6.037466091825473,5.5941592383858385,173764.53642384105,7,1,7,2,8,6,5,1.0,0,0,0,-1,1,0,0
2840,5.565313667785831,4.957872943180363,5.806473656398494,4.820363873388709,5.5675220722105445,6.056507279233235,5.575424665358009,135475.26829268291,4,E01002907,1,7,3,7,6,5,5.599713584651118,4.882907162541929,5.930707418400308,4.689889114835988,5.530197527097619,6.043023985365163,5.515729595785555,171166.78260869565,5,0,9,0,8,6,4,1.0,1,-1,2,-3,1,0,-1
2841,5.995669910077298,4.929092827807652,6.015318808930643,4.68160489569889,5.655866215738018,6.293250110711944,5.790630293696114,136385.32584269662,8,E01002908,0,9,1,8,9,8,5.96986351207811,4.960875547662074,6.045215244195899,4.682337731731181,5.454426441873823,6.242536140947926,5.870822368835916,172440.9387755102,9,1,9,0,6,9,9,1.0,1,1,0,-1,-2,0,1
2842,6.095015752195108,4.797268204014711,6.106860182502053,4.629119469661905,5.653677126373908,6.226847010429459,5.874942692843351,138470.39393939395,9,E01002909,0,9,0,8,8,9,5.943226759433746,4.717835466861725,6.160543985366822,4.627153636217117,5.558370010852814,6.24893506526947,6.014747750759125,175109.7,9,0,9,0,8,9,9,1.0,0,0,0,0,0,1,0
2843,5.902814109150956,4.896381946114021,5.963372577496661,4.649682159346294,5.630235654551808,5.962114173222363,5.7642243528753765,111228.9756097561,8,E01002910,0,9,0,8,4,8,5.7117721009845575,4.861786017733172,5.936284791339528,4.744775158314665,5.548709459541258,5.958028145072874,5.752500467063967,141164.0909090909,7,0,9,1,8,4,8,1.0,-1,0,0,1,0,0,0
2844,5.664661496419173,4.836697449133946,5.985821061867934,4.733490919149839,5.538394195299882,6.091472071867723,5.8266127742253815,79862.16153846154,5,E01002911,0,9,2,6,6,9,5.7304798490632844,4.786118375576608,6.0727835360581315,4.698592606598769,5.502879590522952,6.07525982314009,5.921690266306808,101662.21951219512,7,0,9,0,7,7,9,1.0,2,0,0,-2,1,1,0
2845,5.499304419696921,4.867192208176792,6.004079226220008,4.7723591422090434,5.567334192814213,5.999274324662615,5.621243500473476,78704.9603960396,3,E01002912,0,9,2,7,5,6,5.470030349280153,4.7657782435417175,5.990326498235975,4.742245386753764,5.465732014604977,6.048807244215693,5.804489203861782,101290.83035714286,4,0,9,1,7,6,8,1.0,1,0,0,-1,0,1,2
2846,5.503420960795772,4.837436737240972,5.909908021892513,4.838619651021184,5.536322209212157,5.922272385777654,5.604682791340458,81505.81081081081,3,E01002913,0,8,4,6,3,6,5.536040090024471,4.79784394428134,6.008607476949692,4.8465329967439175,5.479922081033389,5.937960272034009,5.73380437741677,103866.80208333333,4,0,9,2,7,4,7,1.0,1,0,1,-2,1,1,1
2847,5.504975577880597,4.9709516851772815,5.852291003823868,4.871455531402175,5.49334555893696,5.847373981193956,5.506251393280593,130172.62068965517,3,E01002914,1,8,4,5,2,4,5.460182009162484,4.922264714817424,5.853643074140444,4.79557982643882,5.470561842996996,5.905567902785081,5.5847520513848945,164229.0879120879,4,1,8,1,7,3,5,1.0,1,0,0,-3,2,1,1
2848,5.492991953296999,5.495405103253052,5.385409543999528,5.064914654841465,5.354468053421088,5.906001577862596,5.531211720631186,7890.274336283186,3,E01002915,8,1,8,2,3,5,5.413481098232848,5.51468144918417,5.340723112548068,5.123193388377433,5.2205621974292775,5.904449777169661,5.659765295652084,10409.056277056277,3,9,1,8,1,3,6,1.0,0,1,0,0,-1,0,1
2849,5.955892307758331,5.239542431235313,5.706513719558716,4.790173107981682,5.66724609375,6.301981950998306,5.844320015311241,8843.1,8,E01002916,4,6,3,8,9,9,5.914788692605262,5.307096402434742,5.776492782667572,4.739624130375245,5.659608286385443,6.3163915931009775,5.986323834634295,11652.813725490196,8,6,7,1,9,9,9,1.0,0,2,1,-2,1,0,0
2850,5.96020161501969,5.229266297968128,5.6691531365430805,4.685658005219471,5.7367846513096294,6.414421713804897,5.893021576012237,8199.424050632912,8,E01002917,4,5,1,9,9,9,5.803264989302709,5.34277233404991,5.592775561870673,4.761344767533815,5.601844605727074,6.270383179187775,5.928547649047314,10803.397435897436,8,7,4,1,9,9,9,1.0,0,3,-1,0,0,0,0
2851,5.5717052074677165,5.419882637294219,5.62986336034887,5.022817938723029,5.595348921051637,6.05493595383384,5.42438866110409,7666.524064171123,4,E01002918,7,5,7,7,6,3,5.442882946917885,5.453112112848382,5.57547616770393,5.186188788790452,5.336709798009772,5.962841676410876,5.481908335811213,10116.405263157894,3,8,4,8,3,4,3,1.0,-1,1,-1,1,-4,-2,0
2852,5.290743588928192,5.529451297862189,5.357420270878171,5.219267244376834,5.281241134518669,5.711603560617992,5.305550992488861,8215.265873015873,1,E01002919,8,1,9,1,0,1,5.267003835721909,5.48699999571689,5.348592678986674,5.24600372718838,5.177776238943578,5.7541839798431935,5.409543244240562,10801.39222614841,1,9,1,9,1,1,2,1.0,0,1,0,0,0,1,1
2853,5.94117746199331,5.2985833214175315,5.715500113271898,4.738097556175724,5.733973467734552,6.315025105014924,5.809964667597125,10311.567741935483,8,E01002920,5,6,2,9,9,8,5.776350364798591,5.3128576427698135,5.633543545291538,4.837496952641578,5.6167427485897425,6.261589552674975,5.802896503181684,13413.720238095239,7,6,5,2,9,9,8,1.0,-1,1,-1,0,0,0,0
2854,5.905170459595937,5.2266375290022955,5.666005306773716,4.783197887360104,5.601147093470135,6.0744174264726185,5.645540122947995,18699.25396825397,8,E01002921,4,5,2,7,6,6,5.8054577487788785,5.283309683407823,5.694722049856839,4.826159731166004,5.475077528659612,6.0481194584337,5.709477447483637,24401.69178082192,8,6,6,2,7,6,7,1.0,0,2,1,0,0,0,1
2855,6.075128182849369,5.247051631437766,5.749834359658731,4.7034067527667895,5.695068312335659,6.290792603106112,5.762375387629947,12881.572972972974,9,E01002922,4,7,1,9,9,8,5.906654080385884,5.235998351107199,5.653609862403264,4.765948974266254,5.600398083843252,6.218017016769086,5.965264976970733,17112.359788359787,8,5,5,1,9,9,9,1.0,-1,1,-2,0,0,0,1
2856,5.28416040577466,5.405484495283682,5.462703403038315,5.072979168046879,5.306008426448967,5.781671424455281,5.208967732477792,20041.962025316454,1,E01002923,7,2,8,1,1,0,5.247659677034848,5.497229845492871,5.454328345013903,5.1143610229739895,5.311846412621535,5.862830242553315,5.37753013666574,26457.20779220779,1,9,2,7,3,2,1,1.0,0,2,0,-1,2,1,1
2857,6.126795734267637,5.154088859816632,5.846867470856172,4.6469046236520795,5.823658194886633,6.48846058385918,5.95915999398174,9654.572289156626,9,E01002924,3,8,0,9,9,9,5.997814128273411,5.1965562844137,5.705646555326139,4.715181689513357,5.713447031221892,6.353198111405846,6.103267711505556,12525.345029239767,9,4,6,0,9,9,9,1.0,0,1,-2,0,0,0,0
2858,5.750284719787188,5.186237633628333,5.70327675422566,4.750986300058813,5.532365477325132,6.0966284323058675,5.491529866352978,18256.46308724832,6,E01002925,3,6,2,6,6,4,5.563202929812551,5.159998674266386,5.6157382197727435,4.930898026914786,5.427432184977247,6.045657802101792,5.553231982205877,24490.139072847684,5,4,5,4,6,6,4,1.0,-1,1,-1,2,0,0,0
2859,5.922952661147485,5.221151162416507,5.703001732703967,4.776279576008136,5.62016974351345,6.240973678001991,5.772830892831851,12657.34358974359,8,E01002926,4,6,2,8,8,8,5.7992091379543345,5.1763453536694595,5.6929086417254835,4.842569214872794,5.542367399329006,6.171785237765548,5.804699556662305,16404.59405940594,8,4,6,2,8,8,8,1.0,0,0,0,0,0,0,0
2860,5.5655824096052795,5.277126481483033,5.653334427546788,4.866969113583331,5.417885525243266,6.168513248016784,5.600405324589122,11815.643356643357,4,E01002927,5,5,4,3,7,6,5.454548572024254,5.18776407143841,5.647723878899666,5.018625585183705,5.249515171736887,6.024812878811196,5.6497943940227975,15394.67808219178,3,4,5,6,2,6,6,1.0,-1,-1,0,2,-1,-1,0
2861,5.583994925022125,5.31494037764413,5.620774630137852,4.84457295536995,5.443356314727239,6.136402027947562,5.58866531763758,11675.842857142858,4,E01002928,5,5,4,4,7,6,5.5289986227072925,5.223940641272302,5.653428668290182,4.919966240334355,5.405577577017491,6.073578613256317,5.609438117812662,15253.771241830065,4,5,5,4,5,7,5,1.0,0,0,0,0,1,0,-1
2862,6.129290823375477,5.057981582248912,5.849449788822847,4.597170749832602,5.673529729422401,6.3586488176794616,5.95490859746933,11262.1,9,E01002929,2,8,0,9,9,9,5.789955057479717,5.0823894864247166,5.683258017640055,4.848101227371781,5.482834343557005,6.254028964925696,5.942317038406561,14729.401234567902,7,2,6,2,7,9,9,1.0,-2,0,-2,2,-2,0,0
2863,5.46321853506502,5.147546599781703,5.6867183793789495,4.944591823078337,5.426607713497505,5.969353148546168,5.5585201524552845,11459.306878306877,3,E01002930,3,6,6,3,4,5,5.402400802640082,5.109583575170017,5.656826997266232,4.956937622098089,5.360673272493973,5.937063967139975,5.5290430911536355,14944.135922330097,3,3,5,4,4,4,4,1.0,0,0,-1,-2,1,0,-1
2864,6.020442639311699,5.046182714912989,5.891377437604617,4.679030753978311,5.663356184142909,6.427878041789956,5.902967915143052,11203.739726027397,8,E01002931,1,8,1,8,9,9,5.731285497813881,5.047592577106225,5.824618246740924,4.80601869657368,5.513926086311569,6.307959787859888,5.817747343086197,14592.359281437126,7,2,8,1,8,9,8,1.0,-1,1,0,0,0,0,-1
2865,5.250188412829342,5.445210102276924,5.368407897460155,5.063775045240027,5.290288570599678,5.853415326175527,5.454873698389428,11607.74358974359,1,E01002932,7,1,8,1,2,3,5.170580356351791,5.320562316525367,5.4115171278676675,5.143715739250183,5.135251678766743,5.772967317411976,5.408053694232818,15133.064516129032,0,7,1,8,0,1,2,1.0,-1,0,0,0,-1,-1,-1
2866,5.821224005641164,5.098628189918157,5.790258169174194,4.794372681024912,5.530903763062245,6.227062059415354,5.74385662417154,15585.52027027027,7,E01002933,2,7,3,6,8,8,5.857158722606957,5.057686695815824,5.805856383438652,4.908979513966445,5.592433893934209,6.253653849270327,5.7798657180569695,20459.82978723404,8,2,8,3,9,9,8,1.0,1,0,1,0,3,1,0
2867,5.877610578917075,5.230117969754813,5.774811338687289,4.801474707714026,5.6086499535519145,6.295470978902734,5.822720494823179,17031.644927536232,7,E01002934,4,7,3,7,9,9,5.912571834374781,5.1478069122523475,5.736784343033621,4.880432814767916,5.595044660241636,6.308256924968877,5.83269317591027,22424.86301369863,8,4,7,3,9,9,8,1.0,1,0,0,0,2,0,-1
2868,5.740496378366639,5.103987013401628,5.693475497823183,4.869737240732933,5.528599331979038,6.092034640766325,5.6433921711785455,14916.265306122448,6,E01002935,2,6,4,6,6,6,5.719686257688305,5.002941239483749,5.770536474034756,4.84380935339988,5.519413503664959,6.079616846163062,5.6053899232345294,19821.848101265823,7,1,7,2,8,7,5,1.0,1,-1,1,-2,2,1,-1
2869,5.742297203917253,5.093828734598662,5.82317540729255,4.855378605817494,5.48115747225912,6.207714929915311,5.652846659484663,15127.701754385966,6,E01002937,2,8,4,5,8,7,5.748985500171266,5.024630002934357,5.810279901685385,4.882121031654292,5.513726220048707,6.186813192120914,5.725141868509096,20031.25,7,2,8,3,8,8,7,1.0,1,0,0,-1,3,0,0
2870,5.9040645707417,5.152251504324927,5.818812715596166,4.7298062006240995,5.583446147993867,6.2767356874907545,5.807883044181787,14619.57142857143,8,E01002938,3,7,2,7,8,8,5.8943396139144895,5.0365351760387425,5.923490689992905,4.802875606417656,5.60129908144474,6.275209382772446,5.824572927355766,19321.865,8,2,9,1,9,9,8,1.0,0,-1,2,-1,2,1,0
2871,5.430071609829544,5.49776280254399,5.382344215834906,5.063528235352368,5.316761096136285,5.86447825781796,5.411243268656074,19722.435779816515,2,E01002939,8,1,8,1,2,3,5.360681314428313,5.451546170130498,5.496805541154717,5.0730754167091945,5.2933438209926384,5.890694900721061,5.472582381813466,25779.441176470587,2,8,3,7,2,3,3,1.0,0,0,2,-1,1,1,0
2872,5.485369904131829,5.529421420791481,5.431209517430656,4.98550245505345,5.319332627555992,5.980861929398548,5.549291657496102,21719.20253164557,3,E01002940,8,2,6,1,4,5,5.419200931390127,5.4372895375887556,5.491019361813863,5.023268505732219,5.224183897972107,6.036807649930318,5.674551016489665,28510.066666666666,3,8,2,6,1,6,6,1.0,0,0,0,0,0,2,1
2873,5.655490291990885,5.386206710047838,5.52544292705815,4.88477069633763,5.451778875327692,6.003117618328187,5.606028120692184,22326.90243902439,5,E01002941,7,3,5,4,5,6,5.5506230632089215,5.245016957229039,5.511415594028977,4.96238449215889,5.4044234055393146,5.981075381332973,5.639800897746716,29306.825471698114,5,5,3,4,5,5,6,1.0,0,-2,0,-1,1,0,0
2874,5.5861296312064885,5.509433293798168,5.460304355165761,4.9526388106072785,5.422294486859801,6.007203717140635,5.558898819479973,21181.738853503186,4,E01002942,8,2,6,3,5,5,5.424435157042283,5.3993736276259785,5.509502954972096,5.073868230367318,5.324740804158724,5.992053147309866,5.634079302732761,27869.46794871795,3,8,3,7,3,5,6,1.0,-1,0,1,1,0,0,1
2875,5.387456571354585,5.622451687949935,5.346550614226098,5.139048948786617,5.373493797638837,5.87836977235632,5.378217027078267,22465.16339869281,2,E01002943,9,1,9,2,2,2,5.2648560363541606,5.560068758778602,5.363753242312737,5.122122670869407,5.315157690138187,5.942882356403759,5.413241496625936,29423.64150943396,1,9,1,8,3,4,2,1.0,-1,0,0,-1,1,2,0
2876,5.252313424956124,5.614834586779277,5.1782643420141445,5.175277272110465,5.249190390484888,5.729635640510224,5.145031993494094,9170.735849056604,1,E01002944,9,0,9,0,1,0,5.322172171929303,5.508219169635399,5.363230695911482,5.099468023169274,5.289742571076537,5.808593209272896,5.320179401659498,12013.660130718954,2,9,1,7,2,2,1,1.0,1,0,1,-2,2,1,1
2877,5.553532598510621,5.450398494957616,5.429930842111981,4.918937494515111,5.490124522062836,6.0112715322504595,5.594856929526758,14439.650793650793,4,E01002945,8,2,5,5,5,6,5.393025275049263,5.4563899899328225,5.442407639332989,5.0981476020546594,5.3001950266640945,5.9923500415333155,5.641635651029022,18608.525139664805,3,8,2,7,3,5,6,1.0,-1,0,0,2,-2,0,0
2878,5.598137166540502,5.453681987220958,5.449054454342794,4.971321854550959,5.5198625467591365,6.052233984914877,5.518781993348719,22614.127118644068,4,E01002946,8,2,6,6,5,4,5.275364711743976,5.5319576482160375,5.389086797696735,5.176422119140625,5.127870115665121,5.9149331871522675,5.650438225597417,28430.816513761467,1,9,1,8,0,3,6,1.0,-3,1,-1,2,-6,-2,2
2879,5.4941163029469235,5.450002127130267,5.451649776646788,4.968484745898717,5.398130609955587,5.958548468603214,5.529002629535299,22295.795774647886,3,E01002947,8,2,6,3,4,5,5.392554638197097,5.45240043393142,5.4099191675940865,5.0551116809570535,5.252726812156842,5.9144565047120015,5.6121987215906595,28784.956834532375,3,8,1,6,2,3,5,1.0,0,0,-1,0,-1,-1,0
2880,5.789708217602332,5.5908289497338455,5.019210713118025,4.917988234816246,5.442731551985139,5.700786173227922,5.3471898808062654,356563.21747572813,6,E01002948,9,0,5,4,0,2,5.769492882824498,5.554660296301777,5.092739838004343,5.000680061557999,5.293581473758189,5.786744868732283,5.4509461036733775,462166.12572533847,7,9,0,5,2,1,2,1.0,1,0,0,0,-2,1,0
2881,5.586644320776968,5.477708788833233,5.477441524014329,4.941108673509925,5.486801356980295,6.002356118626064,5.630342007887484,23735.929292929293,4,E01002949,8,2,6,5,5,6,5.530894698383652,5.397194262976958,5.465793453087317,5.018219516656109,5.365979182943005,6.046346948525616,5.7733352791483155,31272.294392523363,4,8,2,6,4,6,8,1.0,0,0,0,0,-1,1,2
2882,5.7421068959903225,5.514673121852578,5.289183436897752,4.86422352099048,5.494964450752179,5.856671271546517,5.407491849494104,24519.331606217616,6,E01002950,8,0,4,5,2,3,5.531253520218102,5.49795316618842,5.286976992761766,5.047088207425298,5.29651904235015,5.870920158076931,5.519779631253836,32230.37837837838,4,9,0,6,2,3,4,1.0,-2,1,0,2,-3,1,1
2883,5.874069452285767,5.2727618630115805,5.657027035951614,4.744756085368303,5.669940893466656,6.04709088573089,5.813702567265584,14281.711538461539,7,E01002951,5,5,2,8,5,9,5.696446446103788,5.309840071091958,5.545908479515566,4.941574215888977,5.487041171537626,5.9166389539701125,5.559397997112449,18737.16513761468,6,6,3,4,7,3,4,1.0,-1,1,-2,2,-1,-2,-5
2884,5.975520755812439,5.4911449785121,5.332979681896187,4.818231586824384,5.605440065874691,5.835976583915844,5.4451291888777975,14413.33918128655,8,E01002952,8,1,3,7,2,3,5.900126279604556,5.494241836095097,5.37122010221385,4.810701506306427,5.480944115706165,5.9532356996728915,5.444383733802372,18822.075757575756,8,9,1,2,7,4,2,1.0,0,1,0,-1,0,2,-1
2885,5.70777643210646,5.563120675778044,5.164554356492084,5.025768514647,5.345930475428484,5.725627884657487,5.351103052540102,14884.713043478261,6,E01002953,9,0,7,2,1,2,5.760315897404982,5.571938190619593,5.252602600453624,4.911348460444501,5.321594912029575,5.839009729932609,5.464596613535974,19711.551532033427,7,9,0,3,3,2,3,1.0,1,0,0,-4,1,1,1
2886,5.761788499909778,5.322453584781913,5.487201186113579,4.915329549201699,5.604403127071469,6.012530728828075,5.509046607239302,15048.732558139534,6,E01002954,6,3,5,7,5,4,5.763213909033573,5.267509652809664,5.588748576063098,4.9061743725429885,5.486484746138255,6.068203086202795,5.64922338272586,19920.18181818182,7,6,4,3,7,7,6,1.0,1,0,1,-2,0,2,2
2887,5.670506238937378,5.4882449934153055,5.367447959698312,4.920418126796319,5.4274422347061035,5.902240801632889,5.550072850735207,7031.150406504065,5,E01002955,8,1,5,3,3,5,5.722402317497563,5.413775571597898,5.506599209845286,4.895644399072851,5.409325753190861,5.997249391246106,5.61044429017169,9514.221402214022,7,8,3,3,5,5,5,1.0,2,0,2,-2,2,2,0
2888,5.965464731057485,5.360165401416666,5.440970381100972,4.740323593219121,5.6293295376441055,5.9865566351834465,5.612855067440107,10480.196078431372,8,E01002956,6,2,2,8,4,6,5.8764601288354985,5.378805348156813,5.463412220702578,4.747826138419421,5.5935071893871635,5.997465833954747,5.613925095096297,13268.058295964125,8,8,2,1,9,5,5,1.0,0,2,0,-1,1,1,-1
2889,6.011307809466407,5.382950528462728,5.453629573186238,4.712911316326687,5.641686947005136,5.899860429763794,5.565018853687104,14106.352380952381,8,E01002957,7,2,1,8,3,5,5.659530678241373,5.464935594325443,5.357221258629997,4.939276218414307,5.4726838276540635,5.853075425401866,5.383695816822189,18529.942446043166,6,9,1,4,7,2,1,1.0,-2,2,-1,3,-1,-1,-4
2890,5.712207346377165,5.17042439709539,5.692643430958624,4.712552161838698,5.530439197498819,6.282277078213899,5.654342675209046,11663.504347826087,6,E01002958,3,6,1,6,9,7,5.650184550116547,5.120709850724819,5.572856369271743,4.882538350282517,5.328200525942102,6.153522126442563,5.699112990261179,14972.769911504425,6,3,4,3,3,8,7,1.0,0,0,-2,2,-3,-1,0
2891,6.037903609483139,5.241755358180645,5.66610084261213,4.620696726793088,5.6492708469769966,6.226001351516439,5.763693850232948,15707.714285714286,8,E01002959,4,5,0,8,8,8,5.963696141442853,5.148525841935666,5.673679055567987,4.715807235169554,5.580170322321132,6.29952340211697,6.026675892447283,20794.88622754491,9,4,6,0,9,9,9,1.0,1,0,1,0,1,1,1
2892,5.90931277002607,5.181166186332702,5.732725535801479,4.718825391360691,5.652841848645892,6.274407325472151,5.8115655156544275,14685.091428571428,8,E01002960,3,6,1,8,8,8,5.892826585693562,5.109952894297052,5.776487119654392,4.7932294772026385,5.5987081400891565,6.262737681256964,5.96809431339832,19622.67021276596,8,3,7,1,9,9,9,1.0,0,0,1,0,1,1,1
2893,5.891417045851012,5.236471904827668,5.686079567617124,4.719319800535838,5.647512499276583,6.249920475590336,5.785944759845734,16064.666666666666,7,E01002961,4,6,1,8,8,8,5.879525192747725,5.24787535312328,5.627608047647679,4.822698280659128,5.594916946837243,6.230141606229417,5.9013532866822915,21307.582978723403,8,5,5,2,9,9,9,1.0,1,1,-1,1,1,1,1
2894,5.48240431807095,5.467557075328397,5.4208098945761085,4.907185804575009,5.356195163009758,6.0554712428186175,5.49559265599215,12474.96992481203,3,E01002962,8,2,5,2,6,4,5.2255593366965565,5.371238941917876,5.387012975658485,5.072702377142306,5.200386901815494,5.947086240003209,5.580614523259466,15986.173652694612,1,7,1,7,1,4,5,1.0,-2,-1,-1,2,-1,-2,1
2895,5.886495177810256,5.111625646685694,5.761850911217767,4.637435978597349,5.618300317643999,6.302640869810775,5.826874900508571,12156.783783783783,7,E01002963,2,7,0,8,9,9,5.657431809759852,5.215679716708055,5.609443725045048,4.8705004071121785,5.450727348007373,6.1619387776104375,5.707818344457825,15929.111940298508,6,5,5,3,6,8,7,1.0,-1,3,-2,3,-2,-1,-2
2896,5.762478388777566,5.216803582436448,5.618771384615417,4.81501578245688,5.526506428324848,6.009900899108397,5.580880940507312,17575.84862385321,6,E01002964,4,5,3,6,5,5,5.806434890803168,5.0976941033905625,5.740735249425851,4.8413469632466635,5.5588178326101865,6.098861809337841,5.631391064325968,23116.90588235294,8,3,7,2,8,7,6,1.0,2,-1,2,-1,2,2,1
2897,5.648866349482441,5.256370036725504,5.647500519733505,4.912204556731114,5.526150281685757,5.996277791095445,5.59860996943546,18542.19123505976,5,E01002965,4,5,5,6,4,6,5.63621977370555,5.2200737018284835,5.63515880164199,4.962802262287441,5.451323412065431,6.007864081953454,5.591152627167739,24664.444881889765,6,5,5,4,6,5,5,1.0,1,1,0,-1,0,1,-1
2898,5.837831411759058,5.1151326232486305,5.648911207252079,4.782523655891419,5.572680632273356,6.201459504498375,5.602039160993364,13965.344444444445,7,E01002966,2,5,2,7,8,6,5.888110398017254,5.162132204807911,5.645530629403813,4.927288087987408,5.591947225565763,6.104385906888037,5.610402685465272,18367.025773195877,8,4,5,4,9,7,5,1.0,1,2,0,2,2,-1,-1
2899,5.735580985248089,5.3103851564228535,5.686869844794273,4.915874246507883,5.511514724045992,6.063661415874958,5.579315010458231,18784.775,6,E01002967,5,6,5,5,6,5,5.66690528831599,5.180049839926643,5.77072697621913,4.857267479223708,5.432064543472477,6.1195557219850505,5.664646523861797,24935.987730061348,6,4,7,2,6,7,6,1.0,0,-1,1,-3,1,1,1
2900,5.2563109479238355,5.157074609140712,5.607866381409913,5.0692340088641545,5.293276541189258,5.778077114598331,5.389035950182617,18152.90288713911,1,E01002968,3,5,8,1,1,2,5.269376632637988,5.055516201706865,5.652943025052911,5.054748614790969,5.340998931960516,5.7635550030380065,5.367534815415345,24123.38900203666,1,2,5,6,3,1,1,1.0,0,-1,0,-2,2,0,-1
2901,5.19301446220454,5.422825441640966,5.3697645839522865,5.170720074106665,5.1851893277729255,5.638438599951127,5.101361798889497,12923.70588235294,0,E01002969,7,1,9,0,0,0,5.199187889243618,5.401295544523181,5.5049878431089,5.19900538704612,5.225972769838391,5.767173763477441,5.333025769753889,16937.409090909092,1,8,3,9,1,1,1,1.0,1,1,2,0,1,1,1
2902,5.31933148730573,5.343880255445302,5.538954834286257,5.055764940145204,5.306092604458761,6.010564077672341,5.486777927378099,11731.136690647481,1,E01002970,6,3,7,1,5,4,5.112645030832615,5.297758631154793,5.459575385463481,5.150668355072437,5.133587557442334,5.934426677470305,5.595267818087623,15227.86394557823,0,6,2,8,0,4,5,1.0,-1,0,-1,1,-1,-1,1
2903,5.685026967589231,5.349762940789289,5.553388918147368,4.7906925888622505,5.448062218446783,6.004505422663561,5.513396363844846,14582.951871657753,5,E01002971,6,4,3,4,5,4,5.707466317340732,5.184511251126726,5.667483619103829,4.894658528889219,5.465371630464991,6.013210008541743,5.586613196258743,19355.598958333332,7,4,6,3,7,5,5,1.0,2,-2,2,0,3,0,1
2904,5.557666902061847,5.208531734754714,5.611700140314994,4.935924796749362,5.417154401326351,6.005986136498211,5.450807360436419,16173.94964028777,4,E01002972,4,5,6,3,5,3,5.574298879143539,5.156416669013394,5.690018919622823,4.902808677618671,5.435668186017662,6.079131903921723,5.680189911726933,21444.617834394903,5,4,6,3,6,7,7,1.0,1,0,1,-3,3,2,4
2905,5.429433712917092,5.3490356375685835,5.450042112738685,5.017757058143616,5.3267807464684,5.917520995688649,5.395347980271398,10449.902654867257,2,E01002973,6,2,7,1,3,2,5.188893956522787,5.387418005735643,5.381230115890503,5.166973338973138,5.170338175950512,5.844410493489234,5.5550328531572895,13565.362903225807,0,8,1,8,0,2,4,1.0,-2,2,-1,1,-1,-1,2
2906,5.718248825164357,5.140299274663257,5.725187461087658,4.907901621168586,5.479714569772125,6.2206660926721655,5.706395708071958,15900.140127388535,6,E01002974,3,6,5,5,8,7,5.778440649482025,5.038639873608775,5.746263083370253,4.8583692723307115,5.564545229248617,6.292018536863656,5.83418058526927,21121.08620689655,7,2,7,2,9,9,8,1.0,1,-1,1,-3,4,1,1
2907,5.636686672270298,5.3675794787704945,5.554822874069214,5.001721353828907,5.462742932140827,6.0742687180638315,5.680449490994215,7425.74375,5,E01002975,6,4,7,4,6,7,5.5422269573527805,5.434243733711664,5.489777957536898,5.152436045651936,5.299689526057375,6.0607631285546235,5.82083926082316,9798.563535911602,5,8,2,8,3,6,8,1.0,0,2,-2,1,-1,0,1
2908,5.761182483806405,5.283015704283151,5.684259090372311,4.850371515238157,5.667504998945421,6.267059135180648,5.797292633082277,6106.086021505376,6,E01002976,5,6,4,8,8,8,5.488526610509018,5.359807791154077,5.53937925736597,5.063066944754197,5.336398758039884,6.096404653385373,5.739029014768776,8132.944785276074,4,7,3,7,3,7,7,1.0,-2,2,-3,3,-5,-1,-1
2909,5.710195256559641,5.4462659975026275,5.498354038136117,4.887999713020837,5.571318965630243,6.121737704181031,5.642991411605937,7092.523489932886,6,E01002977,7,3,5,7,7,6,5.621620577167381,5.455268815837123,5.4372481188990855,4.991698862476782,5.417961706492034,6.112649351358414,5.615931697867134,9336.238636363636,6,8,2,5,6,7,5,1.0,0,1,-1,0,-1,0,-1
2910,5.838183382609943,5.285401853355202,5.519718892402477,4.892432234308741,5.569504773294604,6.144682944357932,5.746016108774924,6528.585585585585,7,E01002978,5,3,5,7,7,8,5.732343016753551,5.332224593932972,5.463484544941432,4.935260021530385,5.453372715862558,6.114260174822078,5.8008926549853195,8706.903930131004,7,7,2,4,6,7,8,1.0,0,2,-1,-1,-1,0,0
2911,5.978462435305119,5.352745413780212,5.552968008443713,4.757808142341673,5.699720088392496,6.17612393014133,5.759682657197118,7100.875,8,E01002979,6,4,2,9,7,8,5.844674631220395,5.370067157706276,5.567841015878271,4.8269678266322025,5.600604391488873,6.101406603563027,5.8013693524188685,9395.475409836066,8,7,4,2,9,7,8,1.0,0,1,0,0,0,0,0
2912,5.781222729455857,5.3302350019922065,5.6187261983650885,4.784604203133356,5.583816276926573,6.299607006060023,5.818174189450789,6905.60544217687,6,E01002980,6,5,3,7,9,9,5.729165521779454,5.373419119003124,5.555509626417232,4.921212458969059,5.531399260786243,6.248966810398532,5.9141767742042255,9128.218045112782,7,7,4,4,8,9,9,1.0,1,1,-1,1,1,0,0
2913,5.451016789095269,5.575904787414604,5.331111269278659,5.10557592411836,5.258521729459365,5.861902587529686,5.478811290529039,10446.642361111111,3,E01002981,9,1,8,0,2,4,5.374039203305788,5.529027219814591,5.271629491561575,5.158935852443116,5.173653172541268,5.860075258001497,5.540797644778143,13461.93670886076,2,9,0,8,0,2,4,1.0,-1,0,-1,0,0,0,0
2914,5.718266875024826,5.432345976905217,5.463423667761384,5.014651658043029,5.434661595909684,5.9693006819518155,5.543240224242841,8943.746031746032,6,E01002982,7,2,7,3,4,5,5.539465794291521,5.397989399692555,5.424608013172842,5.039943100257241,5.302316391406282,5.9542924838980245,5.553444087814173,12061.088082901555,4,8,1,6,3,4,4,1.0,-2,1,-1,-1,0,0,-1
2915,5.953270078252215,5.307504716269467,5.651364743162732,4.9054745966141375,5.645891730938483,6.207184435030736,5.859914091748929,8920.912844036697,8,E01002983,5,5,5,8,8,9,5.692263672978098,5.4497174260803085,5.482081594555059,5.007646339280265,5.485798654468378,6.095857613647039,5.845997487894401,11911.161290322581,6,8,2,5,7,7,9,1.0,-2,3,-3,0,-1,-1,0
2916,5.78820302588808,5.27424188186786,5.652969875218678,4.8463186574128505,5.5348208696564285,6.097277135205415,5.658425051010459,12399.932515337423,6,E01002984,5,5,4,6,6,7,5.722498401410162,5.246495854383134,5.649546477754237,4.906015785400477,5.449147305919626,6.12311979471627,5.783874327180076,16215.079096045198,7,5,5,3,6,7,8,1.0,1,0,0,-1,0,1,1
2917,5.414725371886944,5.492481858976956,5.502151823865956,5.102348533169977,5.297164957276706,5.891856087487319,5.363224392923816,12266.551724137931,2,E01002985,8,3,8,1,3,2,5.319438998272877,5.304672778836939,5.492461783996481,5.227580339703339,5.281321589520435,5.891425211698015,5.3851300880608965,15998.211920529802,2,6,3,9,2,3,1,1.0,0,-2,0,1,1,0,-1
2918,5.767982994149995,5.399606576701939,5.613650109143865,4.839994631357641,5.4868303929399325,6.152666248731165,5.537981264543213,12835.020134228187,6,E01002986,7,5,4,5,7,5,5.611268228292465,5.272881653904915,5.517129470407963,4.838845244050026,5.431181417405606,6.04465210288763,5.602483474463225,16758.59375,5,6,3,2,6,6,5,1.0,-1,-1,-2,-2,1,-1,0
2919,5.577281783653211,5.092590947694417,5.767354355582708,4.881190029880669,5.5158024875423575,5.944205217723605,5.432459942147702,19836.367088607596,4,E01002987,2,7,4,5,4,3,5.644439516748701,5.0564214066096715,5.841204974310739,4.89517665045602,5.463659351893834,6.034642519269671,5.588846168518066,26136.53142857143,6,2,8,3,7,6,5,1.0,2,0,1,-1,2,2,2
2920,5.8362278894466515,5.219957118525224,5.589585913454785,4.84131417993237,5.550232598886771,6.03551063116859,5.569903542890268,22391.058823529413,7,E01002988,4,4,4,6,5,5,5.695169779307702,5.182737395167351,5.608194393270156,4.952618505148327,5.487560133723652,6.01215602720485,5.657776659025865,29388.08088235294,6,4,5,4,7,5,6,1.0,-1,0,1,0,1,0,1
2921,5.834463685975039,5.193196879293685,5.744652772308292,4.780532800165334,5.516892228807722,6.17160709818503,5.716477128796112,20824.85714285714,7,E01002989,3,7,2,5,7,7,5.674187926892881,5.143950860588639,5.7535367170969645,4.830505896497656,5.460017882453071,6.1166066611254655,5.680010633998447,27445.992592592593,6,3,7,2,7,7,7,1.0,-1,0,0,0,2,0,0
2922,5.756286868150683,5.286932240361753,5.648034999336022,4.888094953004865,5.502196111540863,5.9920519797698315,5.639634116836216,17994.615942028984,6,E01002990,5,5,5,5,4,6,5.653916846381294,5.300319366984898,5.608092732782717,4.985879959000481,5.458082048098246,5.952764325671726,5.622146144619695,23676.962962962964,6,6,5,5,7,4,5,1.0,0,1,0,0,2,0,-1
2923,5.98571515083313,5.205754627352175,5.784622710684071,4.67987584993706,5.646014999899065,6.242571383529568,5.866838268611742,15828.496894409938,8,E01002991,4,7,1,8,8,9,5.922170938071558,5.185335071073413,5.753514447454679,4.804529641981179,5.527425497938684,6.2746571295678955,5.948248102166558,20925.338983050846,8,4,7,1,8,9,9,1.0,0,0,0,0,0,1,0
2924,5.6447477199899865,5.419136421886955,5.460508322152566,4.845790051099822,5.4942821020216455,6.031879674731277,5.505832459044269,12316.370078740158,5,E01002992,7,2,4,5,5,4,5.555064641512358,5.482109226859533,5.382851802385771,5.0768380887233295,5.419508707064849,6.062003046274185,5.567378079661956,16103.64423076923,5,9,1,7,6,6,4,1.0,0,2,-1,3,1,1,0
2925,5.98793549681532,5.268170421493465,5.708834132243847,4.796153082929808,5.668700499781247,6.161714208537135,5.599184543922029,21912.80172413793,8,E01002993,5,6,3,8,7,6,6.024289567129952,5.142629210154215,5.767468840735299,4.717668791044326,5.7403624057769775,6.257959465753465,5.700442443575178,28781.638095238097,9,3,7,0,9,9,7,1.0,1,-2,1,-3,1,2,1
2926,6.157281060913699,5.211649026103954,5.6734975414659505,4.624465458357155,5.782448345093272,6.22966873825495,5.842694518554151,21259.130653266333,9,E01002994,4,6,0,9,8,9,6.024843592688723,5.282098700415413,5.58652574330006,4.694077823521956,5.691619110557268,6.147427167532579,5.8332822643361,27981.278301886792,9,6,4,0,9,8,8,1.0,0,2,-2,0,0,0,-1
2927,6.327259041014171,5.287014018405568,5.622988264798086,4.529618362327675,5.838558803389083,6.137169817309359,5.798971713879408,21245.865800865802,9,E01002995,5,5,0,9,7,8,6.128362127435886,5.208862538744763,5.619744770895175,4.606329941168064,5.770344105193286,6.189983349505479,5.802529321938026,27921.60569105691,9,5,5,0,9,8,8,1.0,0,0,0,0,0,1,0
2928,5.810792673201788,5.135474238130781,5.758277266744583,4.8008143863980735,5.5901851171538945,6.251301935740879,5.750586928829314,13759.095238095239,7,E01002996,3,7,3,7,8,8,5.732662958758218,5.0962306920971185,5.816787136452539,4.850834836917264,5.488050238362381,6.20067135138171,5.9008568951061795,18369.821428571428,7,3,8,2,7,8,9,1.0,0,0,1,-1,0,0,1
2929,5.998275603118696,5.1299576461315155,5.763814352060619,4.69482032562557,5.639990251315267,6.295676276872032,5.912110488665731,20271.315789473683,8,E01002997,2,7,1,8,9,9,5.85910534709692,5.139723094552755,5.8233530730009075,4.786710200458765,5.586593545973301,6.302616082131863,5.893694806843996,26741.7,8,3,8,1,9,9,9,1.0,0,1,1,0,1,0,0
2930,5.443126917878787,5.187356402476628,5.667519291241963,4.97487070163091,5.450329105059306,6.107590067386627,5.474876246849695,12743.525,2,E01002998,3,5,6,4,6,4,5.44347526520256,5.219950447870991,5.660871823002973,5.020415057347515,5.381302238449337,6.1311198444817006,5.670284183945243,16415.55905511811,3,5,6,6,5,8,6,1.0,1,2,1,0,1,2,2
2931,5.915716686491239,5.312875016260955,5.661817625417548,4.721266503051176,5.600147372585232,5.949827145721953,5.521281323190463,20666.872881355932,8,E01002999,5,5,1,7,4,4,5.6730671649979,5.275844426885728,5.523799810678728,4.837685611940199,5.486443727247177,5.937381313693139,5.570257600276701,27232.629032258064,6,6,3,2,7,4,4,1.0,-2,1,-2,1,0,0,0
2932,5.266277665644884,5.528829661756754,5.212438778951764,5.1781177096068856,5.257845362648368,5.746856163442135,5.241857287660241,11593.375,1,E01003000,8,0,9,0,1,1,5.358030499067417,5.472360716309658,5.228265304551568,5.162132952102395,5.302753570814465,5.794317456871965,5.3641295644433,15084.148255813954,2,9,0,8,3,1,1,1.0,1,1,0,-1,3,0,0
2933,5.400613601674738,5.559352553996844,5.2776433057391765,5.141121453026316,5.3363831383256155,5.834724572925633,5.413159804655514,9262.938144329897,2,E01003001,9,0,9,2,2,3,5.47676083384728,5.451562721307586,5.433819847042058,5.037444117117901,5.341461147580828,5.954334583412222,5.587694062667639,11963.755102040815,4,8,2,6,4,4,5,1.0,2,-1,2,-3,2,2,2
2934,5.503785708575573,5.478913472115415,5.383798079583252,5.029729098949618,5.395392938146314,5.932895126273331,5.396011166780898,21059.077669902912,3,E01003002,8,1,7,3,3,2,5.42967991072398,5.419171862877333,5.412829734958136,5.061952196061611,5.315506470891146,5.877788850894341,5.3656151953798075,27617.60576923077,3,8,1,7,3,3,1,1.0,0,0,0,0,0,0,-1
2935,5.404210171881755,5.332872185737464,5.591480985568587,5.002178525469105,5.437142012984889,5.965380859982436,5.429422955604116,8759.649681528663,2,E01003003,6,4,7,4,4,3,5.496685525491124,5.282994195109322,5.5573647277695795,4.909751704051381,5.449615963867733,5.983778533481416,5.602755628881001,11464.94642857143,4,6,4,3,6,5,5,1.0,2,0,0,-4,2,1,2
2936,5.407775948755443,5.442443906329572,5.35176913253963,5.024842563550919,5.290080606471747,5.870145317632705,5.44768023211509,20676.88671875,2,E01003004,7,1,7,1,2,3,5.375302764085623,5.417280102693118,5.359673898036664,5.133526348609191,5.247328528991113,5.864222174424391,5.457353019255859,27273.146153846155,2,8,1,8,2,2,3,1.0,0,1,0,1,1,0,0
2937,5.340555612700326,5.572301575796945,5.236746183804104,5.259724787303379,5.287014581816537,5.797695845876421,5.422604608535766,19126.411428571428,1,E01003005,9,0,9,1,1,3,5.254976715830808,5.416672785637787,5.311990413876528,5.274318877504675,5.275026960926161,5.802837818367046,5.393469093912873,24803.441988950275,1,8,0,9,2,1,2,1.0,0,-1,0,0,1,0,-1
2938,5.86129116319841,5.3876699247667865,5.527107317986027,4.829353202542951,5.578012980953339,6.080007090107087,5.743761984763607,9326.890322580644,7,E01003006,7,3,3,7,6,8,5.885603655392016,5.187380048590646,5.70187617355669,4.8167132424636625,5.617522221216014,6.225969893831603,5.918358764178317,12566.098591549297,8,4,6,2,9,9,9,1.0,1,-3,3,-1,2,3,1
2939,6.014480628714656,5.332374193021003,5.594801313829738,4.794936098010335,5.639741333904645,6.151774708008924,5.7867734661165455,8313.549668874171,8,E01003007,6,4,3,8,7,8,6.021364838469262,5.160378031481326,5.709149645824058,4.912114804866267,5.610028514675066,6.125171647352331,5.795732265204386,11510.73202614379,9,4,6,3,9,7,8,1.0,1,-2,2,0,1,0,0
2940,6.075302082438801,5.2869358818198355,5.68975044821584,4.800165118866189,5.692246668560561,6.4079780038013014,5.934623917174894,17391.279069767443,9,E01003008,5,6,3,9,9,9,6.1125965903444985,5.149260735366402,5.80772247837811,4.824944769463888,5.6624198526870915,6.329114003879268,5.952559062620488,22915.634146341465,9,4,8,2,9,9,9,1.0,0,-1,2,-1,0,0,0
2941,6.004068281060906,5.31513262115499,5.626020311027445,4.747166620787754,5.576028782834289,6.156299439809656,5.714757277119544,13303.381720430107,8,E01003009,5,5,2,7,7,7,5.9237666985263,5.246105589944383,5.65624445028927,4.766616638587869,5.5991275193898575,6.200507192508034,5.725279375910759,17427.059782608696,9,5,5,1,9,8,7,1.0,1,0,0,-1,2,1,0
2942,6.15926635813439,5.151973359886257,5.76388005004532,4.568130822702386,5.690863365414499,6.337894519170125,5.875826260824313,18177.471264367818,9,E01003010,3,7,0,9,9,9,6.1727881027243985,5.095173871308043,5.818926388757271,4.630252824192159,5.689256925331919,6.382871187221237,5.9266209992748955,24026.573099415204,9,3,8,0,9,9,9,1.0,0,0,1,0,0,0,0
2943,6.091626262989174,5.086571536907534,5.858122575850714,4.609105614577832,5.642042925568665,6.282272102070504,5.760344044691851,18707.63945578231,9,E01003011,2,8,0,8,9,8,6.162722909752326,5.004904562913919,5.81613645825205,4.599110042747063,5.672158429894266,6.25042407573024,5.805274424673636,24602.62658227848,9,1,8,0,9,9,8,1.0,0,-1,0,0,1,0,0
2944,5.093010737479312,5.274731211291933,5.497335423543615,5.165353313233089,5.245902464806455,5.612422879459788,5.375755249875263,519464.43203883496,0,E01003013,5,3,9,0,0,2,5.231869477086363,5.122800635025564,5.551293636845276,5.160713428944613,5.202926949589654,5.7113800338939225,5.521158726869431,663155.4159292035,1,3,4,8,1,0,4,1.0,1,-2,1,-1,1,0,2
2945,5.494226394028499,5.053342228100218,5.702860542823529,4.952674053455222,5.415905985338934,5.85216506514056,5.584583841521164,547064.8206896551,3,E01003014,1,6,6,3,2,6,5.474420875993394,4.968712103275853,5.775731951225805,5.005706423111544,5.3994824249325815,5.868968563225433,5.621599472206057,694411.2900763359,4,1,7,5,5,3,5,1.0,1,0,1,-1,2,1,-1
2946,5.706653362909953,5.0413432772954305,5.803921701113383,4.880626123746236,5.577162144978841,5.99540452003479,5.607157799402873,534205.8,5,E01003015,1,7,4,7,4,6,5.621609479457408,5.140826675268981,5.6870908071328925,4.955845393576063,5.467146695197165,5.855292849712543,5.464151556427415,670472.1981981982,6,3,6,4,7,2,3,1.0,1,2,-1,0,0,-2,-3
2947,5.366084293772777,5.12572035441796,5.611644949764013,5.010214262952407,5.383534500996272,5.688895970582962,5.478037471572558,479248.0520833333,2,E01003016,2,5,7,2,0,4,5.282739836594154,5.099720530468842,5.606889169791649,5.017263891368077,5.291762990170512,5.748407936301724,5.541562303386885,627130.7155172414,1,3,5,6,2,1,4,1.0,-1,1,0,-1,0,1,0
2948,5.216686049103737,4.9775622941553594,5.736264275014401,5.051570491492749,5.436601378023624,5.655810356885195,5.3632380157709125,618265.1,0,E01003017,1,6,7,3,0,2,5.299962512793995,4.916731073742821,5.675615997541518,5.018154658022381,5.403303641648519,5.63582530546756,5.406952639420827,783476.7321428572,1,1,6,6,5,0,2,1.0,1,0,0,-1,2,0,0
2949,5.962503492432153,4.891539870492564,5.993944040080845,4.759315213901084,5.5734830110665134,6.274418736464225,5.764754294549059,634212.6375838926,8,E01003018,0,9,2,7,8,8,5.864952213670078,4.889771912443011,5.99166088825778,4.781222072086837,5.541269592548671,6.213341803927171,5.751440774453314,804304.9539473684,8,0,9,1,8,8,8,1.0,0,0,0,-1,1,0,0
2950,5.741760501861572,5.041024049758911,5.759852672576904,4.825422644615173,5.5947512397766115,6.11617868900299,5.529581939697265,283626.416,6,E01003019,1,7,3,7,7,5,5.659280556393421,5.036129817249268,5.770610527729425,4.8328391604536165,5.449984101798591,6.094979729239396,5.667996625261982,350984.89763779525,6,2,7,2,6,7,6,1.0,0,1,0,-1,-1,0,1
2951,5.837724352067755,4.887125604836515,5.961289764374726,4.736706404722939,5.584451399108236,6.280383882596511,5.779193175855533,633938.3565891472,7,E01003020,0,9,2,7,9,8,5.6759836401258195,5.003141825539725,5.85131927217756,4.8279708325862885,5.383324133498328,6.184837208475385,5.723406824895314,803968.6928571429,6,1,8,2,5,8,7,1.0,-1,1,-1,0,-2,-1,-1
2952,5.645978027919553,5.145727362272875,5.721011969278443,4.884338059515323,5.421825962246589,6.056927343584457,5.509438015379995,548608.5283018867,5,E01003021,3,6,5,3,6,4,5.438571043809255,5.17684493859609,5.594194793701172,5.079198662439982,5.311125268538793,5.906468552350998,5.569166541099548,612758.35,3,4,4,7,3,3,4,1.0,-2,1,-2,2,0,-3,0
2953,6.025120300405166,5.066244644277236,5.857675566392786,4.610176542226006,5.638446022482479,6.23476013249042,5.728201224523432,171320.3725490196,8,E01003022,2,8,0,8,8,8,5.872062839487548,4.92385192712148,5.805451208545316,4.767591318776531,5.493776937966706,6.111861277652043,5.828637805036319,309399.311827957,8,1,8,1,7,7,8,1.0,0,-1,0,1,-1,-1,0
2954,5.421752243979364,5.1447544892628985,5.718982212563866,4.981824008827536,5.370001265126416,5.910062351797381,5.311597490921999,473572.9743589744,2,E01003023,3,6,6,2,3,1,5.39525932501137,5.135755358869013,5.708143055187499,4.975480139004027,5.352078736582889,5.946306353379906,5.520257108825168,609763.0168776371,3,3,6,5,4,4,4,1.0,1,0,0,-1,2,1,3
2955,5.654922094396365,5.308290099584928,5.545071271158034,4.9529670259004,5.506379853012741,5.877942149357129,5.392072249484318,634681.7634408602,5,E01003024,5,4,6,5,2,2,5.718148279671717,5.217971674119584,5.599447951172337,4.853063389508411,5.4220602247450085,5.994149251417681,5.617723188014946,804900.8787878788,7,5,4,2,6,5,5,1.0,2,0,0,-4,1,3,3
2956,5.927250484625499,5.085155873497327,5.782980418205261,4.710380216439565,5.545862184961637,6.2091911971569065,5.706602851549785,633852.3083333333,8,E01003025,2,7,1,6,8,7,5.8538953109699134,5.137270962490755,5.745800439049216,4.822191408451865,5.453956317375688,6.186869538882199,5.730841979384422,803965.7132352941,8,3,7,2,6,8,7,1.0,0,1,0,1,0,0,0
2957,6.106892572508918,5.012655697616876,5.838146756677067,4.626117675133001,5.743828441582474,6.227212000516505,5.720118691718656,69931.79738562091,9,E01003026,1,8,0,9,8,7,6.1769525904855325,5.0462514847338555,5.720469148573048,4.665149864322411,5.560333773047624,6.181725669049931,5.785511644300587,91802.63473053892,9,2,7,0,8,8,8,1.0,0,1,-1,0,-1,0,1
2958,6.421363456682726,4.803905336694284,6.165368597615849,4.469060536135327,5.72349878874692,6.599896422841332,6.166873983361504,72076.29545454546,9,E01003027,0,9,0,9,9,9,6.249629362245624,4.7257784122831366,5.997592885842484,4.607603062404675,5.6544574726833385,6.524819033869197,6.145810936274153,93196.89887640449,9,0,9,0,9,9,9,1.0,0,0,0,0,0,0,0
2959,6.073228111170759,5.015700723185684,5.807883563667837,4.628647928286081,5.713774782238585,6.2979948785569935,5.753016220198737,66340.90909090909,9,E01003028,1,7,0,9,9,8,5.987927070287901,5.027916028120807,5.825873588847223,4.72342800871234,5.511624122334418,6.3081784927956415,5.821066171209389,86306.16822429906,9,2,8,0,8,9,8,1.0,0,1,1,0,-1,0,0
2960,5.911810074702347,5.201019496020704,5.735572354628308,4.717311182824692,5.642009418789703,6.083267370072922,5.579243176054247,65914.62376237624,8,E01003029,3,6,1,8,6,5,5.687155854134333,5.230035396984645,5.705572634651547,4.881577172733489,5.522942904063633,6.036498943964641,5.622303037416367,85898.86666666667,6,5,6,3,8,6,5,1.0,-2,2,0,2,0,0,0
2961,6.234113300168836,4.710861625972095,6.222473125200014,4.476336911991909,5.665619517231847,6.590901898908186,6.061790191375457,67885.41441441441,9,E01003030,0,9,0,8,9,9,6.06964142116036,4.834610240665946,6.0077710508361575,4.58714458416766,5.585599895537369,6.397711158737423,5.943218024696891,88137.72440944881,9,0,9,0,9,9,9,1.0,0,0,0,0,1,0,0
2962,6.1479311818661895,4.97945025001747,5.992291882418204,4.629939758259317,5.8097104715264365,6.245938484219537,5.882612383883933,66721.84057971014,9,E01003031,1,9,0,9,8,9,5.86885862925957,4.9189357346501845,5.873442033241535,4.635508681165761,5.625264854266725,6.217221486157384,5.785828364306483,86816.43103448275,8,1,8,0,9,8,8,1.0,-1,0,-1,0,0,0,-1
2963,5.71816466439445,5.23575045627618,5.633687085325613,4.890108199239527,5.635225846332574,5.935520713434279,5.489436071623796,74345.46540880503,6,E01003032,4,5,5,8,3,4,5.684254260788187,5.224248050946241,5.654699064834773,4.871862250461913,5.489060792309499,5.964973756444384,5.626074225581878,95947.42105263157,6,5,5,3,7,4,6,1.0,0,1,0,-2,-1,1,2
2964,6.1810824469234165,4.9271551826027,6.066958456896664,4.573568259732107,5.581437769900547,6.421461086594657,5.912903403967954,69817.70786516854,9,E01003033,0,9,0,7,9,9,5.90677262033735,4.961883210000538,5.847599288395473,4.805659548441569,5.497112957636515,6.198733070918492,5.869369806562151,91115.35238095238,8,1,8,1,7,8,9,1.0,-1,1,-1,1,0,-1,0
2965,5.838490128517151,4.960978873364337,5.898563857202406,4.66873489417039,5.515269166463382,6.123808075855305,5.692933649211735,70384.1948051948,7,E01003034,1,8,1,5,7,7,5.768092926591635,4.831066278119882,5.781194520493348,4.833327657232682,5.367343510190646,6.068042653302352,5.699058511604865,91107.30208333333,7,0,7,2,4,6,7,1.0,0,-1,-1,1,-1,-1,0
2966,5.600475153923035,4.966089471578598,5.9080188274383545,4.832749801874161,5.41842493057251,5.97814636349678,5.395353760719299,72509.28,4,E01003035,1,8,4,3,4,2,5.534932974251833,4.811322748661041,5.915348625183105,4.922065016356382,5.386945702812889,5.915418236905878,5.67532872503454,93766.74545454545,4,0,9,4,5,3,6,1.0,0,-1,1,0,2,-1,4
2967,5.724179992308984,5.05358654326135,5.7816109421489,4.76336762538323,5.502384601058541,6.106449609274392,5.569829412869045,71418.46153846153,6,E01003036,1,7,2,5,6,5,5.727183530205174,4.982219018434224,5.7744649742778975,4.859587652118583,5.472686442889665,6.132536257568159,5.676516699163537,92250.02631578948,7,1,7,2,7,8,6,1.0,1,0,0,0,2,2,1
2968,5.188573469350367,5.254916277932532,5.479721678627862,5.080917356926718,5.34471775572977,5.724279368365252,5.219092364664431,71447.12345679013,0,E01003037,4,2,8,2,1,0,5.172114955584208,5.217128841082255,5.4619466590881345,5.232869462966919,5.263110914230347,5.66639656384786,5.268537247975667,92358.28,0,5,2,9,2,0,0,1.0,0,1,0,1,0,-1,0
2969,5.517542174368193,5.107523714653169,5.762796585005943,4.83715075314647,5.471326579951277,5.9697789302980055,5.548248784710663,72276.58585858585,3,E01003038,2,7,4,4,4,5,5.455299463358012,5.0125974588566,5.662234802503844,4.982422224036208,5.280735909401834,5.819538550333934,5.525674847869186,93496.48648648648,3,2,6,5,2,2,4,1.0,0,0,-1,1,-2,-2,-1
2970,5.726509408019055,4.962709283691713,5.900481119923208,4.754902340899939,5.5070832104518495,6.07367948554028,5.631005113837363,72852.83908045977,6,E01003039,1,8,2,5,6,6,5.79909552423294,4.895686470856101,5.908975178239036,4.7812363589550815,5.493110451321144,6.070799425496894,5.736931606201129,94156.45197740113,8,0,9,1,7,7,7,1.0,2,-1,1,-1,2,1,1
2971,6.327507966902198,5.035950015230877,5.852839126819518,4.5823550544134,5.852201720563377,6.229458480346493,5.793492450946715,73399.36585365854,9,E01003040,1,8,0,9,8,8,6.094878045524039,4.9612779312017485,5.917291995955677,4.695581318401709,5.572033094196785,6.161006575677453,5.880998915288506,94656.17073170732,9,1,9,0,9,8,9,1.0,0,0,1,0,0,0,1
2972,5.6337449903841375,4.994268825024735,5.859466664585066,4.75846290146863,5.495378850418844,6.013937623412521,5.446518724347338,72093.24691358025,5,E01003041,1,8,2,5,5,3,5.568289548158646,4.968170921910893,5.805923434821042,4.8124217282642014,5.450618705966256,5.966200289401141,5.589943085204471,93440.93181818182,5,1,8,2,6,4,5,1.0,0,0,0,0,1,-1,2
2973,5.840958682584091,5.252391764815425,5.74027938238332,4.744435503449239,5.684753182908179,6.063277167333683,5.599701559039908,73094.74647887323,7,E01003042,4,7,2,9,6,6,5.905906344981903,5.204954341371009,5.592508130885185,4.970276528216423,5.45232969142021,5.969125945517358,5.602478289857824,94433.24468085106,8,4,4,5,6,5,5,1.0,1,0,-3,3,-3,-1,-1
2974,5.737872824668885,4.888400813102722,5.870126886367798,4.743706522941589,5.565716595649719,6.151346488952637,5.634011522293091,629965.456,6,E01003043,0,8,2,7,7,6,5.753950910568237,4.884737788200378,5.821840925216675,4.7895048789978025,5.467532028198242,6.09423279953003,5.724002154350281,798947.68,7,0,8,1,7,7,7,1.0,1,0,0,-1,0,0,1
2975,5.841698106129964,5.070855077107748,5.648278403282165,4.796671791871389,5.5353134870529175,6.015467723210652,5.500714707374573,629607.9666666667,7,E01003044,2,5,3,6,5,4,5.369246506690979,5.149390654563904,5.4834596633911135,5.1698931694030765,5.482675790786743,5.842178039550781,5.384903063774109,798441.32,2,4,2,8,7,2,1,1.0,-5,2,-3,5,1,-3,-3
2976,5.425340226422185,5.366114595661992,5.522370209901229,5.055135492656542,5.418776319337928,5.828699230111163,5.307814364847929,630316.7739130434,2,E01003045,6,3,7,3,2,1,5.284865622597981,5.283335941593822,5.388875772313374,5.1741710067764535,5.260028579370762,5.770209176753594,5.252250594821403,799376.6260162601,1,6,1,8,2,1,0,1.0,-1,0,-2,1,-1,-1,-1
2977,5.684866754488013,5.204615220256235,5.737315643792865,4.956354302921515,5.510822246814596,5.9902436705841415,5.518204552003707,627195.091954023,5,E01003046,4,6,6,5,4,4,5.529452791920415,5.267492356123747,5.591952862562956,5.044304896284033,5.412237577968174,5.957101150795266,5.458848306426296,795551.0370370371,4,6,4,6,5,4,3,1.0,-1,2,-2,0,0,0,-1
2978,5.352366010348002,5.031671715966353,5.751952543326303,4.945329076854895,5.475912481335038,5.714595532586388,5.400881594799935,630735.9219858156,2,E01003047,1,7,6,4,1,2,5.484025433937215,4.924219682349921,5.806250098329153,4.901564439631397,5.448072088431127,5.8686289950187165,5.572013638774801,799762.1118012422,4,1,8,3,6,3,5,1.0,2,0,1,-3,2,2,3
2979,5.360359453819167,5.38591445667643,5.479171141772203,5.177116954830331,5.237593602126752,5.837951579564054,5.433091692521539,628126.8591549295,2,E01003048,7,2,9,0,2,3,5.26753270403247,5.312975165999938,5.444454516205832,5.272980986354507,5.227437613166381,5.743500267233804,5.334834449759153,796774.1962616822,1,6,2,9,1,1,1,1.0,-1,-1,0,0,1,-1,-2
2980,5.5619446561577615,5.197839305641946,5.685675934459386,4.926687074511238,5.443377797523241,5.96170681514097,5.527625097317642,629215.4943820224,4,E01003049,3,6,5,4,4,5,5.387244432471519,5.277791102265203,5.518349228903305,5.1030770831329875,5.262730515280436,5.858467226804689,5.522722535355147,797597.9069767442,3,6,3,7,2,2,4,1.0,-1,3,-3,2,-2,-2,-1
2981,6.04323312971327,4.808044518033664,5.951432433393267,4.67075589299202,5.639257616466946,6.095790670977698,5.710527092218399,632388.3194444445,9,E01003050,0,9,1,8,6,7,5.776053970118603,4.99964844175132,5.831503330943096,4.714152435222304,5.444574094680418,5.982364743588919,5.6115756135389026,801956.156626506,7,1,8,0,6,5,5,1.0,-2,1,-1,-1,-2,-1,-2
2982,5.507684596379598,5.1386355497218945,5.553066640430027,4.957539314693875,5.425324912424441,5.811714126445629,5.430327733357747,626426.2,3,E01003051,3,4,6,3,2,3,5.417672046669969,5.0594945651990875,5.488126778387809,5.039240457990148,5.343521608962669,5.7386351125734345,5.448918980521125,793581.5225225225,3,2,2,6,4,1,2,1.0,0,-1,-2,0,1,-1,-1
2983,5.324899664464986,5.2038448486688,5.571100163009931,5.179001491024809,5.38764585638946,5.761351167031054,5.256251994168983,629568.3018867924,1,E01003052,4,4,9,3,1,1,5.198203865472261,5.218360116889885,5.410907922564326,5.172540884834152,5.3136874630644515,5.5748503723660034,5.098507064956802,798330.5045045045,1,5,1,8,3,0,0,1.0,0,1,-3,-1,0,-1,-1
2984,5.720143550863633,4.878665271859902,5.95492067703834,4.774012995453981,5.570495259303313,6.082738091166203,5.589300634769293,633641.8846153846,6,E01003053,0,9,2,7,6,6,5.541595231773507,4.799354265897702,5.964871184438722,4.815170908585573,5.384643984656049,5.951532916126088,5.667656952499325,803609.4102564103,5,0,9,2,5,4,6,1.0,-1,0,0,0,-2,-2,0
2985,5.6424259726206465,4.794289819399515,6.0846536890665694,4.875265814463297,5.519773082733154,6.109633496602377,5.554638926188151,72695.41333333333,5,E01003054,0,9,4,6,6,5,5.660024743331106,4.831510821455403,5.947709234137284,4.892562944638102,5.455457963441548,6.011042550990456,5.679523323711596,93835.19736842105,6,0,9,3,6,5,7,1.0,1,0,0,-1,0,-1,2
2986,5.344423141565409,5.0285943177369266,5.815220098237734,4.969605040979815,5.439635815921131,5.856893049704062,5.395015009888658,633698.027027027,1,E01003055,1,7,6,4,2,2,5.396042866584582,4.977147199149824,5.8138443099127874,4.874761300209241,5.313077980636532,5.843248791164822,5.485169467763004,803684.9743589744,3,1,8,3,3,2,3,1.0,2,0,1,-3,-1,0,1
2987,5.652656617984976,4.9838163532236575,5.944855336220034,4.926089238095027,5.582364809128546,6.126216880736813,5.685682381353071,364709.2150537634,5,E01003056,1,9,5,7,7,7,5.7005126994065565,4.925907259035593,5.92332578187037,4.786712190117499,5.55919604349618,6.0568655163350735,5.62726434433099,462866.0909090909,7,1,9,1,8,6,6,1.0,2,0,0,-4,1,-1,-1
2988,5.531714836271798,5.028179303901951,5.803292416944736,4.782408382834458,5.5008196074788165,5.937165423137386,5.5643564477199465,142682.51219512196,3,E01003057,1,7,2,5,3,5,5.433533452369354,4.954152180598332,5.752440350396292,4.8873692043535,5.476436190552764,5.948861777127444,5.5307522016567185,172926.65934065933,3,1,7,3,7,4,4,1.0,0,0,0,1,2,1,-1
2989,5.843063292565284,4.846399743835647,5.969398523305918,4.7949006170421455,5.5593383838604025,6.223520306797771,5.540441407785787,522996.6233766234,7,E01003058,0,9,3,6,8,5,5.879078854353,4.874841492909652,6.025040589846098,4.75097596186858,5.396120062241187,6.219156601490119,5.7717918157577515,683928.0512820513,8,0,9,1,5,9,8,1.0,1,0,0,-2,-1,1,3
2990,5.081078802455555,5.169781886447559,5.430737354538658,5.12339491627433,5.282163869250905,5.594885461980646,5.0280175100673326,634537.6181818182,0,E01003059,3,2,8,1,0,0,5.077816991894333,5.154599776974431,5.418365390212448,5.14677870715106,5.360389581433049,5.5552420042179245,5.24678271788138,804866.9814814815,0,4,1,8,4,0,0,1.0,0,1,-1,0,3,0,0
2991,5.370799452539474,5.1256639465453135,5.623894173001486,5.144145284380231,5.444870787953573,5.714013406208584,5.235602870820061,635208.2380952381,2,E01003060,2,5,9,4,1,1,5.246260548981143,4.915463111769985,5.546647887834361,5.055183848864596,5.360386774573527,5.748028335436969,5.403706658054405,805020.0985915493,1,1,3,6,4,1,2,1.0,-1,-1,-2,-3,0,0,1
2992,5.399117984889466,4.969149440894892,5.858642210195094,4.927531155539148,5.481265332963732,5.85235783494549,5.451594948768616,633518.6666666666,2,E01003061,1,8,5,5,2,3,5.409086264669895,4.8422745883464815,5.953315705060959,4.893860530853272,5.410764303803444,5.907738375663757,5.55529705286026,803493.3375,3,0,9,3,5,3,4,1.0,1,-1,1,-2,0,1,1
2993,5.828288745036168,5.073948421309479,5.836004862743142,4.715844218709828,5.591573274241084,6.006457343565679,5.613497304705392,483920.61946902657,7,E01003062,2,8,1,7,5,6,5.748687192797661,4.848946835845709,5.876343585550785,4.739972768351436,5.499864727258682,5.9797260873019695,5.613870527595282,504690.609375,7,0,8,1,7,5,5,1.0,0,-2,0,0,0,0,-1
2994,5.9071692781788965,5.117056250572205,5.716514419941675,4.716448988233294,5.576105122055326,6.051213676021213,5.609104656037831,615841.5595238095,8,E01003063,2,6,1,7,5,6,5.798264685323683,5.046855653746653,5.6945008827468095,4.844751103449676,5.525711694006192,6.028063293230736,5.593913577370724,781146.3389830509,8,2,6,2,8,6,5,1.0,0,0,0,1,1,1,-1
2995,5.9454274699929055,4.888856405622504,5.930438856060586,4.711117996258682,5.616514173786292,6.344095615858443,5.97829721482952,621554.1910112359,8,E01003064,0,9,1,8,9,9,5.957199095463266,5.003608084454829,5.961756769491702,4.740018535633476,5.4837046143959975,6.365632200727657,5.998669512417852,788515.3163265307,9,1,9,1,7,9,9,1.0,1,1,0,0,-1,0,0
2996,5.560349785364592,5.262617032606523,5.527036563380734,4.92591944369641,5.414478229952382,5.919989271478339,5.4279086118216044,621739.4835164836,4,E01003065,5,3,5,3,3,3,5.499715124738628,5.276194344306814,5.554211075963645,4.960294314499559,5.3739634228163755,5.930881514631468,5.48322380925047,788791.8793103448,4,6,4,4,4,4,3,1.0,0,1,1,-1,1,1,0
2997,5.458334080223898,5.326062455918025,5.54128834807757,5.010047351272361,5.3052492523656305,5.884628367655486,5.358860537843797,621730.6601941747,3,E01003066,6,3,7,1,3,2,5.211727309596631,5.193716268206751,5.456557478091513,5.086230304814125,5.217451066933861,5.7655421966730165,5.352188885673996,788777.4108527132,1,4,2,7,1,1,1,1.0,-2,-2,-1,0,0,-2,-1
2998,5.748590458994326,5.0201504740162175,5.750453580980715,4.73109885920649,5.487517112407131,6.148033807243126,5.730652630329132,621934.7246376812,6,E01003067,1,7,2,5,7,8,5.782410760448403,5.036620951678655,5.830746284902912,4.850330639375399,5.490324422104718,6.132758611685609,5.726066296231257,789010.3082191781,7,2,8,2,7,8,7,1.0,1,1,1,0,2,1,-1
2999,5.737299509537526,5.091728420339079,5.696179000740377,4.736765878832238,5.551332522661258,6.10675536465441,5.6246280833187265,622560.1367521368,6,E01003068,2,6,2,6,6,6,5.663397899213827,5.120696715588839,5.6816993411981835,4.8329158987639085,5.468205658894665,6.015052768419373,5.588365004872376,789890.0094339623,6,3,6,2,7,5,5,1.0,0,1,0,0,1,-1,-1
3000,5.998759061318856,5.143383946242156,5.679898970215409,4.685603849093119,5.597171257160328,6.240018230014377,5.845986316822193,613324.325925926,8,E01003069,3,6,1,7,8,9,5.930773651188818,5.168663320048102,5.628332022140766,4.791743576115575,5.540546491228301,6.145296784927105,5.748846599973481,778166.675862069,9,4,5,1,8,8,8,1.0,1,1,-1,0,1,0,-1
3001,5.738678637892008,5.201473975554109,5.743868362158537,4.761514091864228,5.5375849306583405,5.977780342102051,5.6511332634836435,613407.640625,6,E01003070,3,7,2,6,4,7,5.668616602155898,5.158691493670146,5.785866615507338,4.876947408252292,5.398726754718357,5.87625748846266,5.494878511958652,778944.6,6,4,7,3,5,3,3,1.0,0,1,0,1,-1,-1,-4
3002,5.861789620874499,5.007071555793965,5.899048065504647,4.677251409668433,5.540842297412596,6.181774269945268,5.741688227925464,625162.669201521,7,E01003071,1,8,1,6,7,8,5.7336203443592995,5.010127706363283,5.760193615946276,4.770264923983607,5.561262380665746,6.08897516316381,5.632673618711274,793024.3310344828,7,2,7,1,8,7,6,1.0,0,1,-1,0,2,0,-2
3003,6.0603557537111,5.065370508794034,5.877829806188519,4.619417777222194,5.6399218754821945,6.308050790529572,5.892393072669425,619203.6797752809,9,E01003072,2,8,0,8,9,9,5.967427644729614,5.040099400792803,5.865854971749442,4.740410530907767,5.60558176449367,6.289810762405396,5.947421261242458,785367.3028571429,9,2,8,1,9,9,9,1.0,0,0,0,1,1,0,0
3004,5.448433004757938,5.165346204357989,5.704482544870937,4.970331553150626,5.416177259648547,6.004444558830822,5.410027821274364,618704.7058823529,3,E01003073,3,6,6,3,5,3,5.407707645468516,5.05711975816178,5.700289175934987,4.950849043179865,5.287704911950517,5.916984866743219,5.583713498017559,785141.0136986302,3,2,6,4,2,3,5,1.0,0,-1,0,-2,-1,-2,2
3005,5.747543371184754,5.028020499160935,5.782856696877031,4.835289522429197,5.472957382544628,6.061298700985987,5.692739169241974,626807.9281767956,6,E01003074,1,7,4,4,6,7,5.7148061434427895,5.01322860982683,5.8037427306175235,4.846587245994144,5.518232625722885,6.013337353865306,5.673974199427499,795391.8611111111,7,2,8,2,8,5,6,1.0,1,1,1,-2,4,-1,-1
3006,5.330541130522607,5.3455227949249915,5.4058179687446275,5.05525609641008,5.395123612712807,5.779145093031333,5.1943957217982115,626709.9014084507,1,E01003075,6,1,7,3,1,0,5.207415793253028,5.236422523208287,5.4566701771556465,5.167547457460044,5.309904501058053,5.744900909023008,5.3742557332135625,794914.463768116,1,5,2,8,3,1,1,1.0,0,-1,1,1,0,0,1
3007,5.641767904309943,5.0498248739997935,5.809648824800359,4.866747074198015,5.482559558188561,6.094513340751724,5.543153405779659,624272.5297029703,5,E01003076,1,7,4,5,6,5,5.485265708305467,5.012999985139695,5.704224077748581,4.95575784181765,5.321243458510565,5.952499059444302,5.603570614062565,791736.2488262911,4,2,6,4,3,4,5,1.0,-1,1,-1,0,-2,-2,0
3008,5.623755330020941,5.130922414724109,5.8070837872699625,4.834184647763817,5.501461117012987,6.017867208684533,5.649015820142135,623813.1941747572,5,E01003077,2,7,4,5,5,7,5.541892102084209,5.01521806618602,5.80279389115953,4.939634417750172,5.419629325571749,5.940584851294449,5.667379261292133,791752.4432989691,5,2,8,4,6,4,6,1.0,0,0,1,0,1,-1,-1
3009,6.15005693395259,4.988741860551349,5.892227492089999,4.580176531258276,5.703438437591164,6.4181895033787875,5.958169456255638,618545.7372881356,9,E01003078,1,8,0,9,9,9,5.966854618377044,4.950429154043438,5.868118748945348,4.684715618606375,5.565790577095096,6.377364228753483,5.878477947050784,784544.5882352941,9,1,8,0,9,9,9,1.0,0,0,0,0,0,0,0
3010,5.793940454232888,5.153528913122709,5.592912353453089,4.782993129042328,5.44675913795096,5.9266585307043105,5.481442183744712,628797.7540983607,7,E01003079,3,4,2,4,3,4,5.562717499811788,5.104695325055398,5.6672204417630665,4.9093579241066925,5.377994334402163,5.925787938527824,5.448675027563552,797277.7438016529,5,3,6,3,4,4,2,1.0,-2,0,2,1,0,1,-2
3011,5.8064450696110725,5.076203757897019,5.810428125783801,4.732549197040498,5.537509965710342,6.2094956543296576,5.697523274458945,629207.140625,7,E01003080,2,7,2,6,8,7,5.781059266006859,4.979313811246496,5.844035430546224,4.74434950838994,5.509683555060059,6.221513882170629,5.727026490399437,798041.5328467153,7,1,8,1,8,9,7,1.0,0,-1,1,-1,2,1,0
3012,5.335453603857307,5.221620843615583,5.598248961151287,4.966650851952132,5.383758346880636,5.778116558187751,5.294966667570094,624865.1666666666,1,E01003081,4,4,6,2,1,1,5.206733437581251,5.155712114215571,5.548377070049781,5.133904866579562,5.270913314684636,5.718288223622209,5.259017332799017,792187.8587570621,1,4,3,8,2,0,0,1.0,0,0,-1,2,0,-1,-1
3013,5.683452728059557,5.152699857287937,5.695346660084194,4.784357039133708,5.471970012452867,6.101824381616381,5.59043365849389,624137.2222222222,5,E01003082,3,6,3,4,6,6,5.476196368535359,5.125736120869131,5.664622769636266,4.874275123371797,5.338680617949542,5.961124018126843,5.434287169400384,792216.2450980392,4,3,6,3,3,4,2,1.0,-1,0,0,0,-1,-2,-4
3014,5.83030622312338,5.159521750884481,5.7863630705540725,4.671163411423711,5.588912572010909,6.214754343032837,5.750036429650713,629777.3168316832,7,E01003083,3,7,1,7,8,8,5.773060862300466,5.098900085514032,5.764980455046719,4.837768808151912,5.534002518190921,6.217224755333465,5.750315643051295,798359.0,7,3,7,2,8,8,8,1.0,0,0,0,1,1,0,0
3015,6.041604970322281,5.079856342956668,5.937393184568061,4.642647710979962,5.611960936765202,6.376537477383848,5.79786045434045,628402.5737704918,9,E01003084,2,9,0,8,9,8,5.851191601386437,4.96973042671497,5.899591153401595,4.768923618243291,5.505633088258596,6.258687516359182,5.77594215961603,796885.6307692308,8,1,9,1,8,9,8,1.0,-1,-1,0,1,0,0,0
3016,5.919913924824108,5.129181209477511,5.718141633814032,4.6190309604009,5.6398488261482935,6.219084771474202,5.724424548582597,629273.503030303,8,E01003085,2,6,0,8,8,8,5.77232454750273,5.091078292661243,5.705911558204227,4.812209239270952,5.5020876699023775,6.186188047462039,5.665761658218172,798046.8888888889,7,3,6,2,7,8,6,1.0,-1,1,0,2,-1,0,-2
3017,6.005199890136719,5.182827266057332,5.659119771321614,4.721339246431986,5.607021265029907,6.153439102172851,5.741006534894307,629552.8266666667,8,E01003086,3,5,1,7,7,8,5.857777363724178,5.073625008265178,5.646367834673987,4.748801012833913,5.525985510812865,6.214075121614668,5.621663005815612,798479.2916666666,8,2,5,1,8,8,5,1.0,0,-1,0,0,1,1,-3
3018,5.852471281233288,5.317295890762693,5.595211201622373,4.765320870989845,5.599301824115572,6.063623775754656,5.7085977883566,631357.5809523809,7,E01003087,5,4,2,7,6,7,5.801405349682117,5.2926088540718474,5.597075538388614,4.80053042954412,5.538962873919257,6.065657044279164,5.698915560697687,800770.5948275862,8,6,4,1,8,6,7,1.0,1,1,0,-1,1,0,0
3019,5.640210085277316,5.116261079341551,5.850883625730684,4.9139477603043185,5.543424210970914,6.019767346261423,5.393552206739595,374388.7974683544,5,E01003088,2,8,5,6,5,2,5.649081970133433,4.974313112293801,5.75171814313749,4.914966868191231,5.413325780775489,5.95291080707457,5.465783848995116,487679.2073170732,6,1,7,4,5,4,3,1.0,1,-1,-1,-1,-1,-1,1
3020,5.4200685068008,5.258244489311078,5.53104435194523,5.116326433802963,5.445485042869498,5.743442397598827,5.355330383012054,70001.54128440368,2,E01003089,4,3,8,4,1,2,5.3596202886010715,5.140602063944959,5.5654562261160905,5.040906248130198,5.311640887748538,5.731624105783898,5.358958403895221,90655.33070866142,2,3,4,6,3,1,1,1.0,0,-1,1,-2,-1,0,-1
3021,5.632727507118867,4.979123730525792,5.877980481798404,4.933084671742448,5.529966563821953,5.9835995290881,5.5539712281984706,198056.2523364486,5,E01003090,1,8,5,6,4,5,5.489130300990606,5.032617587154195,5.7584677490137395,5.039175105296959,5.383710123724857,5.900080094903203,5.621740604861308,255551.58474576272,4,2,7,6,5,3,5,1.0,-1,1,-1,1,-1,-1,0
3022,5.732035921465966,5.008184002291772,5.828420796701985,4.807297837349676,5.499190130541401,6.02598548512305,5.6197795925601834,70003.30645161291,6,E01003091,1,8,3,5,5,6,5.689136175438762,4.872874908149242,5.841503081843257,4.858071779832244,5.4673877246677876,6.001579105854034,5.67378125153482,90622.859375,6,0,8,2,7,5,6,1.0,0,-1,0,-1,2,0,0
3023,5.790568973215835,5.223738609332044,5.638598378800668,4.815508298964297,5.557602384079124,5.90956130863931,5.520548139138245,68108.21800947867,7,E01003092,4,5,3,6,3,4,5.736774586071478,5.184485529070702,5.513861547006625,4.926882196809644,5.472313994559173,5.930372307233721,5.519618588073231,88300.14018691589,7,4,3,4,7,4,4,1.0,0,0,-2,1,1,1,0
3024,5.406029127538204,5.141405710950494,5.6891148686409,5.076738342642784,5.418676430359483,5.703461229801178,5.382336925715208,635755.0625,2,E01003093,3,6,8,3,0,2,5.343795696894328,4.967130030194919,5.6780568030145435,5.019672918650839,5.317888408899307,5.862713442908393,5.501492286721866,806169.7916666666,2,1,6,6,3,2,3,1.0,0,-2,0,-2,0,2,1
3025,5.841147932287765,5.015880506332606,5.926712730159498,4.83635589847826,5.629208394925889,6.19731048035295,5.629372745344083,619533.9726027397,7,E01003094,1,9,4,8,8,6,5.6972065176814795,4.927001226693392,5.878492426127195,4.837712364271283,5.493515029549599,6.17128025367856,5.87316657602787,782778.421875,6,1,8,2,7,8,9,1.0,-1,0,-1,-2,-1,0,3
3026,5.8303939930179665,5.08622023515534,5.757103809139185,4.855097708994882,5.48255154229047,5.990223466304311,5.6744186512210915,69669.78070175438,7,E01003095,2,7,4,5,4,7,5.653278631823404,5.141461397920336,5.755729051809462,4.989291666992127,5.367437890597752,5.98588773655513,5.7134245785455855,90141.71428571429,6,3,7,5,4,5,7,1.0,-1,1,0,1,-1,1,0
3027,5.656610898042129,4.905006382424952,5.885065529306056,4.819557254597292,5.546487545563003,6.0162885451720935,5.576708250126596,634183.6440677966,5,E01003096,0,8,3,6,5,5,5.642786062829863,4.810054589093216,5.9155100438652966,4.837552188857784,5.408140386023173,6.0679562421349,5.640212621146102,804251.6097560975,6,0,9,2,5,6,6,1.0,1,0,1,-1,-1,1,1
3028,5.514634810298322,5.217114944055856,5.616240117923323,4.896195469132389,5.454522435923657,5.883451705955597,5.331738082759352,223721.09638554216,3,E01003097,4,5,5,4,3,1,5.5450115904212,5.17655411362648,5.569044986367226,5.019134344160557,5.335709810256958,5.871281760931015,5.508695665001869,265666.0875,5,4,4,6,3,3,3,1.0,2,0,-1,1,-1,0,2
3029,5.521757376194,5.257316783070564,5.762618291378021,4.960489594936371,5.450491350889206,5.961583516001701,5.537444159388542,635431.0125,3,E01003098,4,7,6,4,4,5,5.513429191907247,5.184825177192688,5.808099330266317,4.8609092235565186,5.3916251150767005,5.919913721084595,5.62804684638977,805800.44,4,4,8,2,5,4,6,1.0,1,0,1,-4,1,0,1
3030,5.4724319444215,5.172511147073478,5.546401061302374,4.989881854411984,5.418846821982013,5.800700130541463,5.41962031983147,597150.694214876,3,E01003099,3,4,6,3,1,3,5.428793825422015,5.115228918620518,5.535786599772317,4.979928484133311,5.358330338341849,5.848184953417097,5.465086733443396,761215.5714285715,3,3,3,5,4,2,3,1.0,0,0,-1,-1,1,1,0
3031,5.61804058531235,4.889679030097764,5.873015623668144,4.8472672628945315,5.5183380246162415,5.994351004732066,5.68100457047594,632334.0,5,E01003100,0,8,4,6,4,7,5.592904590821082,4.93484970026238,5.840446838112765,4.853052565293718,5.458558634270069,5.990196690078854,5.728318138640057,801585.550387597,5,1,8,2,7,5,7,1.0,0,1,0,-2,1,1,0
3032,5.4447415449001175,5.13364651799202,5.6235300214202315,4.956297703363277,5.419582057882239,5.8899087111155195,5.468144570235853,543611.0925925926,3,E01003101,3,5,6,3,3,4,5.437177960689251,5.112281044324239,5.5540989729074335,5.04551639006688,5.290042679533999,5.75256807070512,5.439927160230457,690700.3760683761,3,3,4,6,2,1,2,1.0,0,0,-1,0,-1,-2,-2
3033,5.402647709442397,5.013529772475614,5.689140400644076,4.9939150921369,5.384084939956665,5.786470973895768,5.504669488486597,522350.7033898305,2,E01003102,1,6,6,2,1,4,5.459374735752742,5.006370590491728,5.696736043149775,4.896152291334037,5.349657941045183,5.761444864851056,5.489494153044441,667706.6136363636,3,2,6,3,4,1,3,1.0,1,1,0,-3,2,0,-1
3034,5.509584948167962,4.958402866024082,5.913146297810441,4.8633162934901355,5.4717998100539385,5.995733899585272,5.549743775594032,636007.0677966102,3,E01003104,1,8,4,4,4,5,5.550098107141607,4.861000974388683,5.956459879875183,4.8107128739356995,5.391644835472107,6.04454505443573,5.821242798777187,806480.4411764706,5,0,9,2,5,6,8,1.0,2,-1,1,-2,1,2,3
3035,5.626011698516374,5.108914155321023,5.803262086258721,4.693994235746639,5.59120456459596,5.974080597002482,5.545464515686035,521161.57731958764,5,E01003105,2,7,1,7,4,5,5.566719290974376,5.104293242915646,5.701480765919109,4.896026248460288,5.374872170961821,5.932502713832227,5.636579269891257,665255.1868131869,5,3,6,3,4,4,6,1.0,0,1,-1,2,-3,0,1
3036,5.740039776069949,4.823212418893371,5.899790691606926,4.742699379872794,5.588216784024479,6.079585301755655,5.721610231833025,621759.0303030303,6,E01003106,0,8,2,7,6,7,5.756660650077375,4.920981824976726,5.840596928179843,4.8367433837316565,5.502283846290366,6.029332762783014,5.713101742337051,791969.3786407767,7,1,8,2,7,6,7,1.0,1,1,0,0,0,0,0
3037,5.422445854434261,5.0440093711570455,5.756806546670419,4.858427470701712,5.476263571668555,5.820112987800881,5.574659505596867,590085.1777777778,2,E01003107,1,7,4,4,2,5,5.352056326595604,5.122678288331269,5.667722877881205,4.998246555632734,5.413473398127454,5.778994117222779,5.477948763691787,744326.1134751773,2,3,6,5,5,1,3,1.0,0,2,-1,1,1,-1,-2
3038,5.715562439979391,5.045112622545121,5.8555558184359935,4.749438339091362,5.61733874107929,6.02423081499465,5.675263343973363,629919.1276595745,6,E01003108,1,8,2,8,5,7,5.572757432335301,5.084306312234778,5.702086793748956,4.949677674393905,5.333645497497759,5.819457932522423,5.73438572883606,798783.3947368421,5,3,6,4,3,2,7,1.0,-1,2,-2,2,-5,-3,0
3039,5.40304660897295,5.2545883595442575,5.557863737855639,5.061923277979138,5.431235941017375,5.728959332995054,5.401168556774364,520723.89495798317,2,E01003109,4,4,8,3,1,2,5.497845656680365,5.149944236243728,5.57276856377177,5.018195240166936,5.372394532617862,5.771076737094099,5.505466520786285,664727.0474452554,4,4,4,6,4,1,3,1.0,2,0,0,-2,1,0,1
3040,5.473611490800977,5.128479924052954,5.764325726777315,4.837401910685003,5.455739480443299,5.849505485966802,5.579860132187605,629477.40625,3,E01003110,2,7,4,4,2,5,5.519509807546088,5.1178726059325195,5.7008720813913545,4.976132856193164,5.410698728358492,5.821410696557227,5.520882976816056,799586.0992907801,4,3,6,5,5,2,4,1.0,1,1,-1,1,1,0,-1
3041,5.829272072890709,5.199827465517767,5.593185433026018,4.656135250782144,5.702166302450772,5.954992688935379,5.621091238383589,553900.2068965518,7,E01003111,3,4,1,9,4,6,5.950355740154491,5.06547935219372,5.632873556193183,4.912893845754511,5.517586406539468,5.997927273021025,5.668667624978458,703386.2352941176,9,2,5,3,8,5,6,1.0,2,-1,1,2,-1,1,0
3042,5.138286303338551,5.297051539875212,5.425541662034535,5.152730030105228,5.369408795947121,5.558491940725418,5.183505293301174,520056.6095238095,0,E01003112,5,2,9,2,0,0,5.312403016365492,5.14482636978993,5.526995374606206,5.104991380984966,5.285614107663815,5.659735184449416,5.372180835558818,663909.1442307692,2,4,3,7,2,0,1,1.0,2,-1,1,-2,0,0,1
3043,6.059069452020857,4.927863997883267,6.0315675417582195,4.610159844822354,5.683170472251044,6.442967846658495,6.049516913625929,99521.44444444444,9,E01003113,0,9,0,9,9,9,5.899592607912391,4.969122827655137,5.906087937981192,4.730007654488689,5.5347100062803785,6.306180932305076,5.990740973540027,127179.71717171717,8,1,9,0,8,9,9,1.0,-1,1,0,0,-1,0,0
3044,5.762370531306122,5.074257069464886,5.852815888144753,4.772887498140335,5.555241161223614,6.233157983331969,5.764990568161011,99637.4696969697,6,E01003114,2,8,2,6,8,8,5.637118075204932,5.117868573769279,5.746272394622582,4.972269947978034,5.418321596539539,6.170632662980453,5.826195990693742,127315.03623188406,6,3,7,5,6,8,8,1.0,0,1,-1,3,0,0,0
3045,5.9668199465825005,4.945760103372427,6.050206968000719,4.643475222420859,5.631101588269214,6.395308327841592,5.782688754421848,99702.92307692308,8,E01003115,1,9,0,8,9,8,5.90848982334137,4.863303020943043,5.93825517421545,4.7503982394240625,5.513520737027013,6.315832157467687,5.738330612348956,127423.91860465116,8,0,9,1,8,9,7,1.0,0,-1,0,1,0,0,-1
3046,6.092833319607512,5.072868121210291,5.865250863264662,4.589934622369161,5.676770564155712,6.323510351081343,5.976489156796126,66148.27177700348,9,E01003116,2,8,0,9,9,9,5.856332950732288,5.123924932059119,5.805384933948517,4.799141904010492,5.418189820121317,6.26098099526237,5.922948083456824,85966.2794117647,8,3,8,1,6,9,9,1.0,-1,1,0,1,-3,0,0
3047,5.721343732347675,4.918919984032126,5.81110523962507,4.778381068332522,5.530454553809821,6.122491525668724,5.728989955256967,97379.6568627451,6,E01003117,0,7,2,6,7,8,5.6049533854360165,4.984632446454919,5.837921430753625,4.903877214763476,5.44601658012556,6.067056894302368,5.674242928753729,123166.58260869565,5,1,8,3,6,6,6,1.0,-1,1,1,1,0,-1,-2
3048,6.055676970826952,4.984210810378978,5.895588195637653,4.659119180942836,5.63197199921859,6.302405677343669,5.90500457114295,65553.61842105263,9,E01003118,1,8,1,8,9,9,5.942377710783923,4.86066374734596,5.985615375601215,4.6667845411065185,5.579817866101677,6.291676344694914,5.928379378201049,86561.74691358025,9,0,9,0,9,9,9,1.0,0,-1,1,-1,1,0,0
3049,6.118067602459475,4.914119004345626,5.92669178256028,4.634166572591384,5.682541027343531,6.278239416561538,5.869792687807152,71577.69064748201,9,E01003119,0,9,0,9,9,9,6.035002932168435,4.899642393208932,5.938058125799981,4.675803232020226,5.614523906638657,6.297288495561351,5.957822179448778,94045.65942028986,9,0,9,0,9,9,9,1.0,0,0,0,0,0,0,0
3050,5.9052203736215265,4.739766505529296,6.101872873756121,4.680925621176666,5.615600187823458,6.263263353761637,5.853492183505364,117754.30188679245,8,E01003120,0,9,1,8,8,9,5.825868667674666,4.712678909301758,5.992897073761756,4.773614580891714,5.583819650802292,6.18585467338562,5.848212780070906,146278.756302521,8,0,9,1,9,8,9,1.0,0,0,0,0,1,0,0
3051,5.795769294102986,5.078742892969222,5.851588124320621,4.719232896963756,5.578793485959371,5.994620476450239,5.605564318952107,65600.42857142857,7,E01003121,2,8,1,7,4,6,5.7416986003518105,4.932484000921249,5.734159700572491,4.829016547650099,5.457175068557262,6.107642933726311,5.706122901290655,85291.375,7,1,7,2,7,7,7,1.0,0,-1,-1,1,0,3,1
3052,5.349443558603525,5.198350564887126,5.594002754737933,5.014727848271529,5.272521355499824,5.848201318333547,5.368593561152617,65817.73958333333,1,E01003122,3,4,7,1,2,2,5.417229639856439,5.163064974441863,5.602999940253141,4.9546292413745014,5.229061034687779,5.899457262273421,5.418643391968911,85860.28947368421,3,4,5,4,1,3,2,1.0,2,1,1,-3,0,1,0
3053,5.798300648594762,5.07842801605259,5.8649013557949585,4.732764980814478,5.627751638223459,6.065680211728758,5.644087863398028,255859.1081081081,7,E01003123,2,8,2,8,6,6,5.7389635519547895,5.015416290543296,5.757188493555242,4.882569047537717,5.4828461213545365,5.995574344288219,5.610851017995314,334534.4636363636,7,2,7,3,7,5,5,1.0,0,0,-1,1,-1,-1,-1
3054,5.400805710113212,5.074733954586395,5.821272092322781,5.0285876973034584,5.410438224060894,5.83741433653113,5.487202858271664,620378.4246575342,2,E01003124,2,8,7,3,2,4,5.274972483879182,5.178414151435945,5.463360154047245,5.1834193046500046,5.246627563383521,5.696810760149142,5.383027034561809,806473.8902439025,1,4,2,8,2,0,1,1.0,-1,2,-6,1,-1,-2,-3
3055,5.47384022582661,5.289968253988208,5.661226211172162,5.0860570199561845,5.353537396951155,5.888436176560142,5.444788004412795,635513.303030303,3,E01003125,5,5,8,2,3,3,5.467585973739624,5.128481991291046,5.614433612823486,5.091766271591187,5.413757848739624,5.934318866729736,5.687543942928314,805880.4,4,3,5,7,5,4,7,1.0,1,-2,0,-1,3,1,4
3056,5.625871624797583,5.102583680301905,5.8096433617174625,4.894311910495162,5.474945344030857,5.978827901184559,5.586240677163005,511134.390625,5,E01003126,2,7,5,4,4,6,5.461125284046322,5.0762885685090895,5.760817413206224,4.948598999481697,5.3413920402526855,5.949076345988682,5.69377503147373,675250.6493506493,4,2,7,4,3,4,7,1.0,-1,0,0,-1,-1,0,1
3057,5.688812282350328,5.038558373186324,5.790950769848294,4.7988723264800175,5.487726587719387,6.08570048544142,5.645343556669023,635599.5222222222,5,E01003127,1,7,3,5,6,6,5.6330890146274015,4.993951456060687,5.847022470918674,4.8209404945373535,5.475016721243997,6.019956824848953,5.661654243191469,806048.0776699029,6,1,8,2,7,6,6,1.0,1,0,1,-1,2,0,0
3058,5.385265620979103,5.227522743714823,5.667002452386392,4.96433408195908,5.3766567690952405,5.84741117503192,5.510936023415746,427870.4324324324,2,E01003128,4,5,6,2,2,4,5.345716351344262,5.1258801015806785,5.591802226172553,5.080364395070959,5.220361574196521,5.881928791234523,5.559137198660109,566102.6419753087,2,3,4,7,1,3,4,1.0,0,-1,-1,1,-1,1,0
3059,5.685772995387807,4.953047807076398,5.921286922342637,4.794365540672751,5.511838750278248,6.089041650996489,5.737775679195629,635808.2588235295,5,E01003129,1,8,3,5,6,8,5.6925647258758545,4.932655381632375,5.8351122966179485,4.764112130626217,5.448186114594177,6.025497756161532,5.840363193344284,806302.021978022,6,1,8,1,6,6,9,1.0,1,0,0,-2,1,0,1
3060,5.964041051514652,4.868789971421618,5.9965949495998,4.6990401558919785,5.606824030569934,6.370551802696438,5.873904375854982,540780.3211009174,8,E01003130,0,9,1,7,9,9,5.788316002598515,4.864765794188888,6.065105579517506,4.7571329628979715,5.474906647646868,6.327592509764212,5.90902062036373,681040.4629629629,7,0,9,1,7,9,9,1.0,-1,0,0,0,0,0,0
3061,5.750802476641158,5.059140479900468,5.821646079211168,4.756159213227286,5.4674559714088975,6.129597624422798,5.682870408179054,194509.0,6,E01003131,2,8,2,4,7,7,5.743506074773855,5.0081573305458855,5.842515177562319,4.8688753095166435,5.4713748487932925,6.1046488219294055,5.821950039370306,255023.4,7,2,8,3,7,7,8,1.0,1,0,0,1,3,0,1
3062,6.107907567304723,5.187726932413438,5.688329988367418,4.579060167424819,5.80494338203879,6.217955432218663,5.72808079439051,631848.3764705883,9,E01003132,3,6,0,9,8,8,5.7881822229801925,5.348866813484279,5.5920251786023725,4.811355259226657,5.379756412286868,5.9669217570074675,5.512657245000203,801430.7931034482,7,7,4,2,4,4,3,1.0,-2,4,-2,2,-5,-4,-5
3063,6.0561994924777895,4.882429304161692,5.890953833494729,4.622215010286347,5.624464787118804,6.3399993055235075,5.917153528066185,628363.1300813009,9,E01003133,0,8,0,8,9,9,5.84374262245608,4.967815553638297,5.83333644732623,4.849008765019161,5.55794228970165,6.142479125043036,5.86505697562661,796857.5845070423,8,1,8,2,8,8,9,1.0,-1,1,0,2,0,-1,0
3064,6.069136277133343,4.977537613289029,5.849265058835347,4.640547332810421,5.612248677833407,6.422566509714313,5.981689198344362,620227.8529411765,9,E01003134,1,8,0,8,9,9,5.938166119835594,4.888487461480227,5.954273661700162,4.777998591553081,5.52702619379217,6.392886738343672,6.023565118963068,769325.509090909,9,0,9,1,8,9,9,1.0,0,-1,1,1,0,0,0
3065,6.151432163744087,4.609900746000818,6.19553265514144,4.49802891461246,5.6614521871130155,6.537266038986574,6.110550825854382,458996.5301204819,9,E01003135,0,9,0,8,9,9,6.249553496324563,4.629745171039919,6.161753862718992,4.480950349493872,5.6532802611966675,6.4959104091306274,6.1059544237354135,617468.6455696203,9,0,9,0,9,9,9,1.0,0,0,0,0,1,0,0
3066,6.316257838545175,4.905956354634515,5.96697055882421,4.543046475827009,5.76838276578092,6.395471605761298,5.875813904849962,155696.72413793104,9,E01003136,0,9,0,9,9,9,6.048234259454827,4.954460706208882,6.02418872180738,4.68063749765095,5.665017890930176,6.374010896682739,5.924743090177837,212254.55789473685,9,1,9,0,9,9,9,1.0,0,1,0,0,0,0,0
3067,5.768910137719886,5.278258939122045,5.636655472045721,4.869209551533987,5.56031753018845,6.068037713682929,5.541467328404272,632480.2209302326,6,E01003137,5,5,4,6,6,5,5.775912410081035,5.2573939284893,5.588840145053285,4.910601529208097,5.462980618380537,6.043187565273708,5.629178328947588,802122.7272727273,7,5,4,3,7,6,6,1.0,1,0,-1,-1,1,0,1
3068,6.398967800718365,4.810680859016649,6.070719812855576,4.449537846777174,5.687188685542405,6.552948409860784,6.168120665983721,70904.36363636363,9,E01003138,0,9,0,9,9,9,6.185526904306914,4.795550186383097,6.019364768998665,4.6489239523285315,5.61501509683174,6.492392067323651,6.139166758771529,97523.8947368421,9,0,9,0,9,9,9,1.0,0,0,0,0,0,0,0
3069,5.288826104038018,5.353024113276773,5.6164025885999695,4.998528231273998,5.399312969081658,5.885415810198824,5.388512418289815,234203.63636363635,1,E01003139,6,5,7,3,3,2,5.227895480687501,5.289592605145251,5.6195211645032535,5.1369508592808835,5.213838133655611,5.948348358029225,5.5824231583564,301091.54918032786,1,6,5,8,1,4,5,1.0,0,0,0,1,-2,1,3
3070,5.467852579979669,5.336633268992106,5.749476700737363,4.926247768175035,5.384424695514498,6.100493594578334,5.515159784044538,233699.84761904762,3,E01003140,6,7,5,2,6,4,5.301357814094477,5.223182389610692,5.676079934103447,5.1675687139494375,5.311398340944658,6.002381316402502,5.5086930603311774,300472.4298245614,2,5,6,8,3,5,3,1.0,-1,-1,-1,3,1,-1,-1
3071,5.522739167055808,5.214833217218888,5.70249723599962,4.986635196307474,5.412373898443112,6.067917652366575,5.571284499050172,322970.5123966942,3,E01003141,4,6,6,3,6,5,5.360044572353363,5.277417542934418,5.64050190448761,5.03049311876297,5.233271282911301,5.921555798053742,5.506442279815674,299342.98,2,6,5,6,1,4,3,1.0,-1,2,-1,0,-2,-2,-2
3072,5.3386610723458805,5.3372772347468596,5.58216091302725,5.0116836829827385,5.342399131793242,5.968683955761103,5.330987239113221,234817.21153846153,1,E01003142,6,4,7,2,4,1,5.201427058836,5.268068424368327,5.508899076850013,5.150322820233033,5.248859059494154,5.925981425606044,5.430821439861196,301999.16814159293,1,6,3,8,2,4,2,1.0,0,0,-1,1,0,0,1
3073,5.544873405780111,5.319946882980211,5.609443526182856,5.071883747620242,5.522363954356739,6.0114913029330115,5.367761488471713,227702.7232142857,4,E01003143,6,5,8,6,5,2,5.339334153703281,5.189742808895452,5.561383025986808,5.042753037597452,5.349549056163856,6.036413595080376,5.562843216317041,292819.1875,2,4,4,6,4,6,4,1.0,-2,-2,-1,-2,-2,1,2
3074,6.014590381548323,5.174012229874216,5.632202407409405,4.679261513825121,5.654598169285675,6.243817245138103,5.828270483119734,420759.6206896552,8,E01003144,3,5,1,8,8,9,5.924309934407157,5.081350077167417,5.633902878306358,4.793105501168187,5.560833838297706,6.213586660661462,5.778273604362677,317196.20494699647,9,2,5,1,8,8,8,1.0,1,-1,0,0,0,0,-1
3075,5.994397028632786,5.127578220160111,5.905145481358404,4.764663215305494,5.641271572527678,6.3727710765341055,5.837682633814604,118364.57391304348,8,E01003145,2,8,2,8,9,9,5.882321210402362,5.028039843406317,5.81551922267338,4.767345464454507,5.49256403266259,6.285667887273824,5.932112988435997,151893.40566037735,8,2,8,1,7,9,9,1.0,0,0,0,-1,-1,0,0
3076,5.3266454333752655,5.365095271473438,5.594143411754507,5.136615859723724,5.341103043176432,5.93765778457169,5.275598363538759,138042.09734513273,1,E01003146,6,4,9,2,3,1,5.318550172498671,5.26990055936878,5.581144472299996,5.198398108199491,5.245703656794661,5.91124960325532,5.539410983101797,179225.77966101695,2,6,4,9,2,3,4,1.0,1,0,0,0,0,0,3
3077,5.81718041644833,5.195550854613141,5.863927158882947,4.696527254290697,5.551590283711751,6.261130990051642,5.745722322929196,228500.73983739837,7,E01003147,3,8,1,6,8,8,5.71596197783947,5.102323782630265,5.814007891342044,4.889908413402736,5.493938530795276,6.234877669252455,5.747062258422375,289849.421875,7,3,8,3,7,9,8,1.0,0,0,0,2,1,1,0
3078,6.0624642667316255,5.076523565110707,5.9170907088688445,4.550575290407453,5.63645266578311,6.333346589406331,5.9697895356587,349474.2571428571,9,E01003148,2,8,0,8,9,9,5.875950904453502,5.123773886876948,5.778599512343313,4.819241239744074,5.5458634904786654,6.237285625700857,5.81282505568336,447084.2745098039,8,3,7,2,8,9,8,1.0,-1,1,-1,2,0,0,-1
3079,5.886701812062944,5.30539608172008,5.56333497592381,4.760934707096645,5.571191544192178,6.110256566320147,5.743921190500259,599892.8571428572,7,E01003149,5,4,2,7,7,8,5.761503678560257,5.156227711836497,5.69968516031901,4.891172569990158,5.527820020914078,6.143010755379994,5.789479614297549,753044.3791666667,7,4,6,3,8,8,8,1.0,0,-1,2,1,1,1,0
3080,5.9266760603326265,5.130389718735804,5.699968296973432,4.766259316538201,5.551464851762428,6.057809239528218,5.731816305488836,208744.82786885247,8,E01003150,2,6,2,6,6,8,5.861159931529652,5.166344956918196,5.647753695811122,4.887912732510527,5.487528697518278,6.143322745630564,5.742144493032093,255971.76446280992,8,4,5,3,7,8,7,1.0,0,2,-1,1,1,2,-1
3081,5.99272422454296,5.25062484618945,5.805770229070615,4.699359556039174,5.731990037820278,6.122738874875582,5.740328687887925,360639.6538461539,8,E01003151,4,7,1,9,7,8,5.925628561973571,5.111723477840424,5.7679753017425535,4.746005098819733,5.593526669740677,6.133571181297302,5.825099971294403,404404.01,9,3,7,1,9,8,8,1.0,1,-1,0,0,0,1,0
3082,5.896135143543544,5.010367769159768,5.79003781080246,4.663702811849745,5.596509528787513,6.257008667054929,5.784343264604869,545691.3881578947,7,E01003152,1,7,1,7,8,8,5.819986646892103,5.052706825221243,5.771020936819673,4.792496442063454,5.493880315060996,6.202223100545216,5.76350854657179,718818.0920245398,8,2,7,1,7,8,8,1.0,1,1,0,0,0,0,0
3083,5.7551381784481,5.019479604867788,5.787768206753573,4.817486535061847,5.5292517103991665,6.0969236342461555,5.753988906577393,178815.7912087912,6,E01003153,1,7,3,6,6,8,5.632816763406389,5.05652288372597,5.762042778261592,5.0053895792264615,5.4551075362087635,5.9734424151731345,5.693831522813004,245527.23595505618,6,2,7,5,6,5,7,1.0,0,1,0,2,0,-1,-1
3084,5.5406939215385,5.316995137012922,5.492928518698766,4.929699568794324,5.4561819055905705,5.841889775716341,5.335164459852072,629196.7980769231,4,E01003154,5,3,5,4,2,2,5.451154875325727,5.303784476744162,5.395675983514872,5.071332803717604,5.406865558108768,5.849403183739464,5.352560849877091,793816.0630630631,3,6,1,7,5,2,1,1.0,-1,1,-2,2,1,0,-1
3085,5.637340083008721,5.139373822817727,5.748025392729138,4.775702501100207,5.536257497848026,6.158728885272192,5.58762195091399,253745.81746031746,5,E01003155,3,7,2,6,7,6,5.436664230510837,5.038573038382609,5.714240746419938,4.895162330299128,5.298664810227566,6.040468754338437,5.68459309906256,320164.0983606557,3,2,7,3,3,6,7,1.0,-2,-1,0,1,-3,-1,1
3086,6.109204354385535,5.011550534516573,5.8629473224282265,4.63778559366862,5.63086724281311,6.4289176389575005,5.902020240823428,66949.38541666667,9,E01003156,1,8,0,8,9,9,6.0321726659511,4.949685915987542,5.902936420542129,4.7159397411853705,5.540968382612188,6.404530941171849,5.985584311028744,87054.29787234042,9,1,9,0,8,9,9,1.0,0,0,1,0,0,0,0
3087,5.935347047059432,4.949897249885227,5.916157000997792,4.661084389686584,5.597787842543229,6.3554987347644305,5.863163162314374,67382.59130434782,8,E01003157,1,8,1,7,9,9,5.704490423202515,4.9259927373821455,5.765318563428976,4.737987189979877,5.455643118438074,6.225923305850918,5.871006670644728,87594.83898305085,7,1,7,0,6,9,9,1.0,-1,0,-1,-1,-1,0,0
3088,6.354971391567285,4.833899905716163,6.098630856776583,4.480002313420393,5.845016431117403,6.608637719914533,6.033888029015583,67239.26086956522,9,E01003158,0,9,0,9,9,9,6.239837680544172,4.825825281195588,5.940626642206213,4.534034556084936,5.707040281086178,6.560193035628769,5.999682474922348,87191.26373626373,9,0,9,0,9,9,9,1.0,0,0,0,0,0,0,0
3089,5.8752587038217134,5.291992080580328,5.657884204510561,4.6883234854825995,5.726339903074441,6.108718675436433,5.493262861192841,65933.63917525773,7,E01003159,5,5,1,9,6,4,5.714314231665238,5.269546044391134,5.554454021868499,4.910106838267782,5.505164454294287,6.04048549817956,5.527106110945992,85621.02608695652,7,6,4,3,8,6,4,1.0,0,1,-1,2,-1,0,0
3090,5.688646790492966,5.375798047307026,5.55669235177787,4.925301728478397,5.652438272912819,5.923924112894449,5.298394826521356,66222.10843373495,5,E01003160,6,4,5,8,3,1,5.487972025121196,5.308096485191516,5.47823007990805,4.986747864926799,5.357045683967933,5.958224813589889,5.429033236557178,86045.80898876404,4,6,2,5,4,4,2,1.0,-1,0,-2,0,-4,1,1
3091,6.128934925252741,5.096029316837138,5.900751796635714,4.620824992656708,5.7365565570918,6.432468980550766,5.84751087020744,67007.14772727272,9,E01003161,2,8,0,9,9,9,6.074671948893687,5.025377257486408,5.9969098487596835,4.57574914010723,5.581939123989491,6.480448050445386,5.947805270720064,87108.93258426966,9,2,9,0,9,9,9,1.0,0,0,1,0,0,0,0
3092,5.867394904295604,5.112765353586939,5.668726106484731,4.694611772894859,5.673924257357915,6.092124021715588,5.607626678215133,65203.51388888889,7,E01003162,2,5,1,9,6,6,5.730441093444824,5.174455830584401,5.623544361280358,4.895292681196461,5.497274594462437,6.08319586256276,5.689648247283438,84819.47826086957,7,4,5,3,7,7,7,1.0,0,2,0,2,-2,1,1
3093,5.965331378735994,5.231700603899203,5.698246416292693,4.6891537143995885,5.707041276128669,6.225655544745295,5.722795735064306,65615.40789473684,8,E01003163,4,6,1,9,8,8,5.812770559106554,5.3444399212087905,5.644624618121556,4.852497728381838,5.558228013345174,6.131017616816929,5.7620934741837635,85403.12142857142,8,7,5,2,8,8,8,1.0,0,3,-1,1,-1,0,0
3094,5.642637030921713,5.057495945561541,5.847871659445937,4.814406093019638,5.4797897504193935,6.005791384808338,5.697154374888344,625598.8832116788,5,E01003164,2,8,3,5,5,7,5.558469489829181,5.006021435130132,5.762614333466308,5.0085448508393275,5.345277421278496,5.956008486551781,5.559967632163061,793625.5616438356,5,2,7,5,4,4,4,1.0,0,0,-1,2,-1,-1,-3
3095,5.8865603100169785,5.069982250531514,5.820043935920253,4.716048170219768,5.616273106950702,6.2336495464498345,5.804914567506675,621054.3409090909,7,E01003165,2,7,1,8,8,8,6.029863310508987,5.001864258123904,5.916201606088755,4.684303583741999,5.588456483114333,6.2800385935776895,5.891443412320143,787807.2448979592,9,1,9,0,9,9,9,1.0,2,-1,2,-1,1,1,1
3096,5.7541026582931005,4.992803098103187,5.936204626573531,4.798945003381655,5.549069644352577,6.13133988966489,5.755926441213938,626453.3296089385,6,E01003166,1,9,3,6,7,8,5.791124441817,4.824381991334864,5.912296377645957,4.8528525913083875,5.503130819346453,6.135518370447932,5.788309155283748,794372.1351351351,7,0,9,2,7,8,8,1.0,1,-1,0,-1,1,1,0
3097,5.839920496028629,5.171039124655593,5.74997733460098,4.736147377660366,5.498919800982449,6.171925255509674,5.650158368173193,621157.7595628415,7,E01003167,3,7,2,5,7,7,5.85261360498575,5.0102837036817505,5.8015770154121595,4.756791378901555,5.42205879443731,6.166190944573818,5.745313857151912,787952.8615384615,8,2,8,1,6,8,8,1.0,1,-1,1,-1,1,1,1
3098,5.445820066134135,5.4344979778925575,5.3591941626866655,5.080270859400431,5.345492300987243,5.75405081431071,5.259913763999939,620678.5333333333,3,E01003168,7,1,8,2,1,1,5.35719141075688,5.368074613232767,5.40976805456223,5.162652029145148,5.222192668145703,5.76629812102164,5.35768473340619,787246.0322580645,2,7,1,8,1,1,1,1.0,-1,0,0,0,-1,0,0
3099,6.191317053498893,4.945866416240561,5.924192667007446,4.582502448969874,5.707666839402298,6.335843451269742,5.947281819376452,628021.6896551724,9,E01003169,1,8,0,9,9,9,6.083313066482544,4.982107390403748,5.957696905136109,4.696765398025513,5.539730828285217,6.318073150634766,5.868319495201111,797256.448,9,1,9,0,8,9,9,1.0,0,0,1,0,-1,0,0
3100,6.161717541962392,4.944822430234602,5.820341474250288,4.630880079810928,5.618105667998738,6.330122464838841,5.916168948453308,620543.2176656151,9,E01003170,1,7,0,8,9,9,6.066552560013461,4.989464323204684,5.841110091611563,4.66267641768398,5.541602602206081,6.286421293235687,5.989404062190688,787051.1024096386,9,1,8,0,8,9,9,1.0,0,0,1,0,0,0,0
3101,6.0579216179338475,4.83930079450885,6.005268721904569,4.682518455588702,5.662605068058643,6.350655027963583,5.800056801258939,634282.6699029126,9,E01003171,0,9,1,8,9,8,5.880848735269874,4.928181790342235,5.917938832080726,4.790922154079784,5.562934774341005,6.16279572429079,5.747360360742819,804303.6868686868,8,1,9,1,8,8,8,1.0,-1,1,0,0,0,-1,0
3102,5.760570618144253,5.152053985679359,5.631650217792444,4.783387023105956,5.521873674894634,6.086566853941533,5.641725924977085,629951.2105263158,6,E01003172,3,5,2,6,6,6,5.635925164093843,5.134036207521284,5.479582883216239,5.00014394199526,5.434375461694357,5.857673158516755,5.490652116569313,798953.9054054054,6,3,2,5,6,2,3,1.0,0,0,-3,3,0,-4,-3
3103,5.862952586957964,4.925914187552565,5.90952726743989,4.732496853602135,5.585191686274642,6.351774656166465,5.679995756028062,633469.2288135593,7,E01003173,0,8,2,7,9,7,5.776787232915196,4.9748165585579125,5.817086703186735,4.8003632048948095,5.4306681287398035,6.220859796629039,5.726244876144129,803617.4495412844,7,1,8,1,6,9,7,1.0,0,1,0,-1,-1,0,0
3104,5.525945372748793,5.247598311357331,5.5620087792998865,4.858209754291334,5.452757680625246,5.9068655361209,5.404272373308215,628242.6052631579,3,E01003174,4,4,4,4,3,2,5.414691333888007,5.228280913634379,5.475472010549952,5.041186903343826,5.291297000939728,5.830384772331988,5.452287361270091,796875.8606557377,3,5,2,6,2,2,2,1.0,0,1,-2,2,-2,-1,0
3105,5.652391148269723,5.311995357548425,5.608622461283972,4.91963183770486,5.511683349215656,6.071592971819256,5.523863954281588,631637.6697247706,5,E01003175,5,5,5,5,6,4,5.589413150593087,5.297108236286375,5.536921758342673,5.006043212281333,5.336463148947115,6.056356507318991,5.573279548574377,800922.1574074074,5,6,3,5,3,6,5,1.0,0,1,-2,0,-2,0,1
3106,5.734523139101394,5.129097747041824,5.7614529944480735,4.794235905434223,5.544199337350562,6.035761777390825,5.503389135320136,634109.6808510638,6,E01003176,2,7,3,6,5,4,5.560938933185327,5.130882431413526,5.5943751847632575,4.913803888258533,5.401740525370446,5.927281633715763,5.510652058592466,804146.4018691588,5,3,4,3,5,4,3,1.0,-1,1,-3,0,-1,-1,-1
3107,5.919643831725168,4.938060616502668,5.960415604090927,4.741819870353925,5.628494432657072,6.044092534792306,5.596507935240718,632133.8811881188,8,E01003177,0,9,2,8,5,6,5.72997890767597,4.903320861998059,5.878192363466535,4.7757359902064005,5.511549037978763,6.015508560907273,5.712742099307833,801738.3333333334,7,1,8,1,8,5,7,1.0,-1,1,-1,-1,0,0,1
3108,6.290788527373429,4.85222800223382,5.9581476620265414,4.641849160194397,5.759359548380087,6.398421387096028,5.9872693963103245,634430.8351648352,9,E01003178,0,9,0,9,9,9,6.1194939057032265,5.003756076759762,6.010350675053067,4.589691248204973,5.64463197655148,6.298524083031548,6.030402535862393,804553.5666666667,9,1,9,0,9,9,9,1.0,0,1,0,0,0,0,0
3109,6.011379255188836,4.78936454322603,5.86997730202145,4.759855700863732,5.768359621365865,6.182844135496351,5.865328152974446,632470.1111111111,8,E01003179,0,8,2,9,8,9,5.597274597301039,4.973563277444174,5.5944243198217345,5.038354931875717,5.489704082178515,5.967079678247141,5.4512835657873815,803132.8604651163,5,1,4,6,7,4,2,1.0,-3,1,-4,4,-2,-4,-7
3110,5.677044501974563,5.16985659362856,5.6705098152160645,4.779971672483712,5.468568095490952,5.991191938888928,5.523495631769669,627225.4958677687,5,E01003180,3,6,2,4,4,4,5.6155183501541615,5.103001452051103,5.660954160615802,4.867000604048371,5.452646363526583,5.9596970453858376,5.582488525658846,795496.0078125,5,3,6,3,6,4,5,1.0,0,0,0,1,2,0,1
3111,5.727793828133614,4.836817960585317,5.9068652622161375,4.8010650507865416,5.6649752393845585,6.075114338628707,5.678493042146006,633008.2258064516,6,E01003181,0,8,3,8,6,7,5.819817334886581,4.848678231239319,5.894666857189602,4.828113612674532,5.547786144983201,6.086909585528904,5.87441803349389,803015.0158730159,8,0,8,2,8,7,9,1.0,2,0,0,-1,0,1,2
3112,5.88488827985226,5.046730631566876,5.9053176121361926,4.725373243272995,5.535107310674365,6.093919790849722,5.725365007245863,627144.444015444,7,E01003182,1,8,2,6,6,8,5.772917412008558,5.031322947570255,5.784367408071246,4.8688821426459725,5.510153126716614,6.076895621844701,5.775527181795665,795416.2928571429,7,2,7,3,8,7,8,1.0,0,1,-1,1,2,1,0
3113,5.80657288217053,5.122148236048591,5.752584378743909,4.702399467684559,5.576678787310099,6.0141116982882785,5.596881963543056,628448.0618556701,7,E01003183,2,7,1,7,5,6,5.776853866629548,5.00399953847403,5.723319140109387,4.928048357858763,5.423194209297935,5.9779875199873365,5.62820043013646,797250.7802197802,7,1,7,4,6,5,6,1.0,0,-1,0,3,-1,0,0
3114,5.573577725526058,5.3699665575316455,5.459335659489487,5.019254323207971,5.348923791538585,5.865855751615582,5.257744438720472,631078.0,4,E01003184,6,2,7,2,2,1,5.278365548451742,5.286572360992432,5.393326467937893,4.992770298322042,5.342336331473456,5.828997378879123,5.43707554075453,800291.6444444444,1,6,1,5,4,2,2,1.0,-3,0,-1,-2,2,0,1
3115,6.008777939356291,4.8619730365582,6.086473312133398,4.642636150885851,5.730925040367322,6.273404619632623,5.833876946033576,634903.0769230769,8,E01003185,0,9,0,9,8,9,5.885793096059329,4.893048862358192,5.954214371644057,4.707104425925713,5.650639199591303,6.119382988322865,5.678874108698461,805158.5584415584,8,0,9,0,9,7,7,1.0,0,0,0,0,0,-1,-2
3116,5.79398941720715,5.093538327071503,5.7817062112211275,4.792955141031105,5.573386722848616,6.039409395392615,5.6053023911614455,634821.6030534351,7,E01003186,2,7,3,7,5,6,5.790530644614121,4.996894160221363,5.832923131427545,4.860437263702524,5.545930604139964,6.065952920365608,5.711536599986855,805159.2126436782,7,1,8,2,8,6,7,1.0,0,-1,1,-1,1,1,1
3117,5.458616624487207,5.40598520446331,5.357729654362861,5.054609468642702,5.291006447152888,5.733444487794917,5.24355892805343,628653.5212765958,3,E01003187,7,1,7,1,1,1,5.302820489262089,5.2944573877435746,5.488409160664587,5.118009572679346,5.374919589721795,5.806101224639199,5.40549670566212,797275.3712121212,2,6,2,7,4,2,2,1.0,-1,-1,1,0,3,1,1
3118,5.950115774498611,4.965725079911654,5.770038831429403,4.650435092019253,5.6121262331477935,6.050532911644607,5.592618397024811,629123.6229508197,8,E01003188,1,7,0,8,5,6,5.7508827447891235,5.021864260452381,5.772891099902167,4.769775865734488,5.56457963888196,6.002098021299942,5.726151963938838,798104.9710144928,7,2,7,1,9,5,7,1.0,-1,1,0,1,1,0,1
3119,5.69310180891573,5.372311598335216,5.537324288312127,4.958726088205974,5.527163007680108,6.0645448709625045,5.429909175517512,277163.49019607843,5,E01003189,6,3,6,6,6,3,5.501685722145492,5.396801121934446,5.456169104147814,5.130827349103139,5.3180551664558,6.004168536134823,5.544929255982359,356604.8143712575,4,8,2,8,3,5,4,1.0,-1,2,-1,2,-3,-1,1
3120,5.344549393435137,5.497784814156524,5.342521258997261,5.128982276544658,5.314792929986202,5.729799956356714,5.230158186833793,280845.5,1,E01003190,8,1,8,1,1,1,5.262624953082416,5.478609623270554,5.338737098741731,5.241149032963868,5.158851354191992,5.712435561742742,5.26422530138343,361102.4769874477,1,9,1,9,0,0,0,1.0,0,1,0,1,-1,-1,-1
3121,5.574848625166663,5.438178822912019,5.3932354388565855,4.987317869375492,5.422026488287695,5.9714329283812955,5.473489487993306,276084.4224137931,4,E01003191,7,1,6,3,4,4,5.354524577310843,5.387452570966972,5.3963840691618215,5.092042042303455,5.241457637890365,5.955991839253625,5.544864204502845,354631.1782945736,2,8,1,7,1,4,4,1.0,-2,1,0,1,-2,0,0
3122,5.900509214200893,5.415560441858628,5.325058029479339,4.916941215511129,5.551048475153306,5.902640026657521,5.455173464382396,262112.66386554623,8,E01003192,7,1,5,6,3,3,5.801370962584529,5.352247819362447,5.335525675042594,4.915504890657121,5.400902447997364,5.945096973315287,5.599033339942012,337427.81712062255,8,7,1,4,5,4,5,1.0,0,0,0,-1,-1,1,2
3123,5.459908721763964,5.4512136892087195,5.380281660598137,5.02351500671034,5.361746079659875,5.879951135271546,5.414671520277254,281065.24277456646,3,E01003193,8,1,7,2,3,3,5.276100667763729,5.445982466546857,5.346068735025367,5.2418897267507045,5.122060409614018,5.776632091220544,5.3678489363923365,361692.4132653061,1,8,1,9,0,1,1,1.0,-2,0,0,2,-2,-2,-2
3124,5.790304055316843,5.2944740674478545,5.609011200692156,4.84613260176542,5.523761499699929,6.076149206367328,5.5196816252289915,277843.55395683454,6,E01003194,5,5,4,6,6,4,5.649615374704202,5.260055753919813,5.470472213294771,4.965344164106581,5.4272991716861725,6.031818946202596,5.621216450300482,357391.9513888889,6,5,2,5,6,6,5,1.0,0,0,-3,1,0,0,1
3125,5.521042745504806,5.255545014765725,5.64782109011465,5.077399978886789,5.478230383858752,6.10841672100238,5.456841559552434,278403.82089552237,3,E01003195,4,5,8,4,6,3,5.420462107833694,5.2187407148234985,5.658200418247896,5.005248395835652,5.382762595134623,6.055817370905595,5.543501799597459,358077.3455882353,3,5,6,5,5,6,4,1.0,0,1,1,-3,1,0,1
3126,5.516997491241132,5.4472823729590765,5.46835123294245,4.9590886982660445,5.4774307687446555,5.950024671655483,5.452064538758899,277176.94708994706,3,E01003196,8,2,6,4,4,3,5.4262888485735115,5.311484342271632,5.452906318987258,5.1115191193542096,5.347004733904444,5.9400103399247834,5.4595480759938555,356595.202020202,3,6,2,7,4,4,3,1.0,0,-2,0,1,0,0,0
3127,5.7251376945700425,5.380211718930494,5.548167701535577,4.9176314997193,5.504286468429053,6.024106835358895,5.600567439258499,277518.6845637584,6,E01003197,7,4,5,5,5,6,5.500508973859761,5.402754969792824,5.5183343756688785,5.036180693809301,5.349551145344565,6.015951168047239,5.56408438208985,357046.9520547945,4,8,3,6,4,5,4,1.0,-2,1,-1,1,-1,0,-2
3128,6.133989936427066,5.164064727331462,5.6499809358353,4.663181061135199,5.716108860826134,6.0835716338982255,5.59333934909419,271125.2631578947,9,E01003198,3,5,1,9,6,6,5.892558496031496,5.206399329006672,5.657376223140293,4.744404339955913,5.51488564742936,6.057575979166561,5.6609253825412855,349131.25,8,4,6,1,8,6,6,1.0,-1,1,1,0,-1,0,0
3129,5.923221600283483,5.300052158392159,5.519130877628448,4.721713937771548,5.642548284712871,5.93208080036625,5.486239942016115,271947.24203821656,8,E01003199,5,3,1,8,3,4,5.886637891245167,5.220530338454664,5.560354170046355,4.821658034073679,5.56765085493612,5.996337643840857,5.623593634332132,350105.783625731,8,5,4,2,9,5,6,1.0,0,0,1,1,1,2,2
3130,5.888063863996582,5.632271675796775,5.20563288140686,4.861747916761812,5.4414111214639975,5.763544490009477,5.1835345852347245,268150.67365967366,7,E01003200,9,0,4,4,1,0,5.889115891157889,5.539144786493961,5.230695882972045,4.900192192425031,5.479840849502457,5.863706188799334,5.3888314829625,344918.373549884,8,9,0,3,7,2,1,1.0,1,0,0,-1,3,1,1
3131,6.033216808834215,5.079066083379035,5.733165673095814,4.662467744228613,5.582940538434217,6.201541641332807,5.75203573877794,273531.8321167883,8,E01003201,2,6,1,7,8,8,5.896584619938488,4.977136544778314,5.808287269632581,4.728609734857586,5.465709313540391,6.162465572357178,5.827996787890582,352001.8098591549,8,1,8,0,7,8,8,1.0,0,-1,2,-1,0,0,0
3132,5.904647693037987,5.293029409917918,5.638938933610916,4.688715439628471,5.686995252966881,6.0992888537320225,5.540587091987783,269951.8693181818,8,E01003202,5,5,1,9,6,5,5.938400596380234,5.253485474475594,5.652677667695422,4.803581038186716,5.586232082095257,6.130929515805355,5.662523716688156,347720.97093023255,9,5,5,1,9,8,6,1.0,1,0,0,0,0,2,1
3133,5.592391793351425,5.219489910728053,5.6009119121651905,4.904324434932909,5.520346198583904,5.963625476234838,5.430437921222888,271281.9894736842,4,E01003203,4,4,5,6,4,3,5.376258217927181,5.227484369518781,5.609261859547008,5.015758716698849,5.396157117805096,5.824320518609249,5.38802515135871,349192.30303030304,2,5,5,6,5,2,1,1.0,-2,1,1,1,-1,-2,-2
3134,6.061431094578334,5.588533803394863,5.201611607415336,4.861025100094931,5.599755726541791,5.885302712236132,5.329312848193305,273018.1785714286,9,E01003204,9,0,4,7,3,1,6.027665872504746,5.5110997117084,5.3778432987738345,4.83989603795867,5.645507380582284,6.026478518610415,5.423876613810442,351498.5869565217,9,9,1,2,9,6,2,1.0,0,0,1,-2,2,3,1
3135,5.723689092122592,5.187074171579801,5.519185381669264,4.867360835808974,5.506357402067918,5.979509966190045,5.40655440550584,273747.0307692308,6,E01003205,3,3,4,5,4,3,5.540964989435105,5.290925498519625,5.56805621158509,5.047649119581495,5.392655903384799,5.8682145192509605,5.533673764694305,352259.4761904762,5,6,4,6,5,3,4,1.0,-1,3,1,2,0,-1,1
3136,6.2578183180756035,5.259905252191755,5.587928608059883,4.609543138908015,5.841014252768622,6.144392288393444,5.6596662898858385,272646.25,9,E01003206,4,4,0,9,7,7,6.230776878883098,5.163657129221949,5.635080834092765,4.6214800892205075,5.718343734741211,6.207139870216107,5.742742067369922,350892.6620689655,9,4,5,0,9,8,7,1.0,0,0,1,0,0,1,0
3137,5.129262792376371,5.389161936365641,5.456937945806063,5.130838166062649,5.286868738440367,5.570311690752323,5.209284249406594,285749.51923076925,0,E01003207,7,2,8,1,0,0,5.286460616588593,5.152071299552918,5.521999878883362,5.191744134426117,5.315367288589478,5.686129577159882,5.369619590044022,367382.24,1,4,3,8,3,0,1,1.0,1,-3,1,0,2,0,1
3138,5.565109071466658,5.142165948284997,5.671887363327874,4.957085455788507,5.460581391387516,5.849208037058513,5.471707322862414,286570.7888888889,4,E01003209,3,6,6,4,2,4,5.499231114431664,5.062672184573279,5.7802995487495705,4.854435858903108,5.4352975046193155,6.039816613550539,5.654557242437646,368331.8796296296,4,2,7,2,6,6,6,1.0,0,-1,1,-4,2,4,2
3139,5.811720023497692,5.1221224497695,5.6886964601706405,4.8778175681994105,5.51092428199494,5.972657914978365,5.491453614024167,286815.32596685085,7,E01003210,2,6,4,5,4,4,5.619871524485146,5.059146804925872,5.7000717628292925,4.859798112148192,5.377036359833508,5.963252549636655,5.637036616627763,368689.53170731704,6,2,6,2,4,4,6,1.0,-1,0,0,-2,-1,0,2
3140,6.105527678839595,5.022054886646408,5.7997468186797,4.621602971776784,5.663283605369733,6.140016348241902,5.697694196975489,287318.45323741005,9,E01003211,1,7,0,8,7,7,5.8235910311848125,5.028551998592558,5.740334722460533,4.782825046656083,5.394820633388701,6.0358197989106985,5.716217403509179,369210.231292517,8,2,7,1,5,6,7,1.0,-1,1,0,1,-3,-1,0
3141,5.628989884048511,5.108800560046154,5.713404127746631,4.838975044572429,5.469806939173656,6.12897585607638,5.6314944917229335,287488.19108280254,5,E01003212,2,6,4,4,7,6,5.644783225765934,5.025661969184876,5.731346571886981,4.870250589759261,5.377182388305664,6.129917153605708,5.611050611072116,369444.5925925926,6,2,7,3,4,7,5,1.0,1,0,1,-1,0,0,-1
3142,6.145573708177344,5.080657234221149,5.768854600520222,4.686969147138069,5.65332514230459,6.1569262487025345,5.819021347110257,288189.1779141104,9,E01003213,2,7,1,8,7,9,5.968027717845384,5.01223981796309,5.810617570267167,4.74513700812362,5.483095087284266,6.175044709859892,5.910679241945577,370211.738372093,9,2,8,1,7,8,9,1.0,0,0,1,0,-1,1,0
3143,5.472028607952184,5.229046193690135,5.639368044918981,4.9350570830805545,5.374915853656572,5.885790954376089,5.4434236216134035,288466.8879310345,3,E01003214,4,5,6,2,3,3,5.391707733154297,5.170359972000122,5.689251317977905,4.973512781143189,5.311165969848632,5.881167541503906,5.4926475887298585,370513.328,3,4,6,5,3,3,3,1.0,0,0,1,-1,1,0,0
3144,5.691384928567069,5.053890488728755,5.738610183491426,4.82032755443028,5.448676836590807,5.9112754629439666,5.433338254439731,285691.9075630252,5,E01003215,1,7,3,4,3,3,5.5277429776226015,5.004684847035854,5.735297494655033,4.919160534152024,5.488255116579344,5.9411180465341475,5.530963510060482,367275.06474820146,4,1,7,4,7,4,4,1.0,-1,0,0,1,3,1,1
3145,6.122718889236451,5.03587917804718,5.908688601493836,4.672551414489746,5.62764660358429,6.47382719039917,5.984292662620544,276582.8,9,E01003216,1,8,1,8,9,9,6.163677422623885,4.92022327686611,5.953508167936091,4.697878945292088,5.61228743143249,6.523714607222038,6.011690750456693,355836.2192982456,9,1,9,0,9,9,9,1.0,0,0,1,-1,1,0,0
3146,5.815168558467518,5.155018280852925,5.803488822416826,4.7730769677595655,5.456946216930042,6.432809172977101,5.801705767891624,275704.85454545455,7,E01003217,3,7,2,4,9,8,5.787297359397335,5.16770375544025,5.8002278535596785,4.8470476933064,5.459610794821093,6.237540568074873,5.758020604810407,354743.48387096776,7,4,8,2,7,9,8,1.0,0,1,1,0,3,0,0
3147,5.995647671517362,5.129465906807546,5.857106602593754,4.695259615276637,5.624252889933211,6.511180974124523,6.0558637581514505,275163.9213483146,8,E01003218,2,8,1,8,9,9,5.98206038500673,5.1125663185632355,5.850596533026747,4.913332893002417,5.534594079499604,6.305972629977811,5.94851509089111,354053.688172043,9,3,8,3,8,9,9,1.0,1,1,0,2,0,0,0
3148,5.843756215803085,5.132786017079507,5.744057884523945,4.805270160398176,5.59378661417192,6.299626579592305,5.9118659542452905,275636.7612903226,7,E01003219,3,7,3,7,9,9,5.837515523854424,5.100356491173015,5.788762622019824,4.9529176473617555,5.547271546195535,6.268684887886048,5.796324896111208,354668.2,8,3,8,4,8,9,8,1.0,1,0,1,1,1,0,-1
3149,5.982623253319715,5.150104741792421,5.872788798164677,4.729722020593849,5.662904612115912,6.262669498856003,5.8446173579306215,272826.4121621622,8,E01003220,3,8,2,8,8,9,5.817584973765958,5.124634405105344,5.862810091818533,4.912117710421162,5.544425699787755,6.228292414449876,5.851553626214304,351112.0193548387,8,3,8,3,8,9,9,1.0,0,0,0,1,0,1,0
3150,5.903963233033816,5.209142064054807,5.712726811567943,4.893274859421783,5.51620250609186,6.215253430936071,5.756828447182973,276773.3263888889,8,E01003221,4,6,5,5,8,8,5.681167790919174,5.2007547307897495,5.543089092513661,4.956415974799498,5.411474772441534,6.188434179918266,5.693185054225686,356154.4074074074,6,4,3,4,5,8,7,1.0,-2,0,-3,-1,0,0,-1
3151,5.932406864949127,5.297117679866393,5.804838614677315,4.869922830987332,5.536752241760937,6.347561505303454,5.920807449675318,273410.2313432836,8,E01003222,5,7,4,6,9,9,5.894722976992207,5.119651643499251,5.783946969816761,4.974717305552575,5.587163854029871,6.21721608984855,5.866972702164804,351637.4435483871,8,3,7,5,9,8,9,1.0,0,-2,0,1,3,-1,0
3152,5.643252822376738,5.177687456943845,5.685765082404117,4.788285094619598,5.443727785308889,6.286247648648768,5.869579006361481,276419.2013422819,5,E01003223,3,6,3,4,9,9,5.440715563439188,5.154025353136516,5.793691270408177,5.0226464214779085,5.402992434444881,6.161196988962946,5.8288577908561345,355725.9345238095,3,4,8,6,5,8,8,1.0,-2,1,2,3,1,-1,-1
3153,5.931458688249775,5.044993725477481,5.886449479589276,4.647999942302704,5.5711821644913915,6.494007797802196,6.020625659063751,275573.50980392157,8,E01003224,1,8,0,7,9,9,5.806516010736682,5.123682905718224,5.8783373119904825,4.887567187092968,5.498855809575503,6.282314408685743,5.9473221855065255,354581.3298969072,8,3,8,3,7,9,9,1.0,0,2,0,3,0,0,0
3154,5.81999958262724,5.204367716773217,5.831524386125452,4.7244139058249335,5.582979178228298,6.342250623622863,5.735301692946618,290482.65546218486,7,E01003225,4,8,1,7,9,8,5.667902802561854,5.100049825401993,5.720972776412964,4.85160307841258,5.476666786649206,6.109099072379035,5.648871066334011,372662.6216216216,6,3,7,2,7,7,6,1.0,-1,-1,-1,1,0,-2,-2
3155,5.629740947857499,4.97875202819705,5.860517738386989,4.774147582240403,5.571669911965728,6.223307782784104,5.694236407056451,291032.34375,5,E01003226,1,8,2,7,8,7,5.3983027990047745,5.029457327035757,5.774040761360755,4.944522003944104,5.34551864862442,6.054574630810664,5.594218534689683,373675.2846153846,3,2,7,4,4,6,5,1.0,-2,1,-1,2,-3,-2,-2
3156,5.9136818484436695,5.120115572600056,5.731569062034003,4.7531665949512725,5.540761855008791,6.29663595192724,5.798110144601451,287804.9496402878,8,E01003227,2,6,2,6,9,8,5.698073609835571,5.156182256009844,5.742240746815999,4.812775928941038,5.3939784715573,6.164374200834168,5.782327193352911,369942.99305555556,6,4,7,2,5,8,8,1.0,-2,2,1,0,-1,-1,0
3157,6.023485163510856,4.991579972081265,5.891875147819519,4.673109641519644,5.647927311517424,6.368855795617831,5.791232982934532,290308.2966101695,8,E01003228,1,8,1,8,9,8,5.815640756487847,4.9680110067129135,5.869139967362086,4.705341307322184,5.467410862445831,6.242062638203303,5.746093307932218,372834.075,8,1,8,0,7,9,8,1.0,0,0,0,-1,-1,0,0
3158,5.317631063570503,5.356187097898877,5.503680827963443,5.057637705147721,5.320348356516306,5.8166945581217755,5.3060782656414816,283125.58778625954,1,E01003229,6,3,8,1,2,1,5.2103963604995185,5.259532551254545,5.44234105178288,5.121989031348909,5.150198892184666,5.704054953370775,5.299378030640739,364025.6642857143,1,5,2,8,0,0,0,1.0,0,-1,-1,0,-1,-2,-1
3159,5.850644605143087,5.218016945398771,5.668718214635248,4.7968767497922995,5.556216936845046,6.097946588809673,5.689573663097995,281867.965034965,7,E01003230,4,5,3,6,6,7,5.616546378597136,5.155355209688986,5.6442759190836265,4.922539411821673,5.366343869701509,5.988271079524871,5.530086177395236,362477.10967741936,5,4,5,4,4,5,4,1.0,-2,0,0,1,-2,-1,-3
3160,5.713503016125072,5.085033600980585,5.84839552749287,4.80282984863628,5.530541085113178,6.118527529456399,5.624932898174633,289682.2090909091,6,E01003231,2,8,3,6,7,6,5.606699356218663,5.054815520115985,5.745815577545787,4.853828872122416,5.4357208061993605,6.028027990969216,5.591835991153872,371997.5853658537,5,2,7,2,6,6,5,1.0,-1,0,-1,-1,0,-1,-1
3161,5.7477214375099575,5.137867424395178,5.748585278337652,4.766741231664435,5.4939974151648485,6.198927035579434,5.72647069336532,290659.24025974027,6,E01003232,3,7,2,5,8,8,5.624110880421429,5.011293339293178,5.734155406312245,4.911356938321416,5.40555805185946,6.140710346582459,5.696277008550923,373193.7195121951,6,2,7,3,5,8,7,1.0,0,-1,0,1,0,0,-1
3162,5.853852488050525,5.097958303937976,5.766023643864881,4.696751616945202,5.526777036238037,6.276875041475232,5.809224991190353,290236.26174496644,7,E01003233,2,7,1,6,8,8,5.69632517678397,5.093054777554103,5.767527360916137,4.834692768369402,5.4053289270401,6.163615486281259,5.76945259639195,372690.6285714286,6,3,7,2,5,8,8,1.0,-1,1,0,1,-1,0,0
3163,5.598444080952579,5.372721457631333,5.5036801182249055,4.916437068075504,5.44671454744519,5.981631734836027,5.55341320142806,256870.6540880503,4,E01003235,6,3,5,4,4,5,5.595813746558887,5.310584584427946,5.532026179009976,4.98675369017617,5.42066726871043,5.9466434976908085,5.489182662697478,330673.31284916203,5,6,3,5,6,4,3,1.0,1,0,0,0,2,0,-2
3164,5.519220085968649,5.4297595185444765,5.598043963425141,4.984905795943468,5.4366997883732155,6.071066799020409,5.5237637623808435,267878.8872180451,3,E01003236,7,4,6,3,6,4,5.398226597013265,5.38933171582048,5.611258307512659,5.12746252717763,5.374626015224596,5.9521231338055465,5.436503640056527,344372.4452554745,3,8,5,8,4,4,2,1.0,0,1,1,2,1,-2,-2
3165,5.471342533353775,5.49511199432706,5.451390404549856,4.98981873951261,5.308240545174432,5.9404757760819935,5.501671659567999,268823.34126984124,3,E01003237,8,2,6,1,4,4,5.342389133241442,5.432224100662602,5.545178911752171,5.12916827450196,5.241044846673806,5.861554558078448,5.507638172970878,346112.97222222225,2,8,3,8,1,2,3,1.0,-1,0,1,2,0,-2,-1
3166,5.603582567638821,5.47782538033495,5.551697466108534,4.9819812738534175,5.455461487625584,6.064678235487505,5.597227616743608,270188.0606060606,4,E01003238,8,4,6,4,6,6,5.372275721246951,5.315395562448234,5.518545908348583,5.005708848204568,5.360548944116752,6.04460153401455,5.480673268576648,347976.33644859813,2,6,3,5,4,6,3,1.0,-2,-2,-1,-1,0,0,-3
3167,5.5693868328543275,5.40648029030872,5.481740823312967,5.09614518009314,5.4090379466529654,5.976619159474092,5.526321679604154,272839.6302521008,4,E01003239,7,2,8,3,4,5,5.320901958838753,5.39269182647484,5.446898498396942,5.113143669522327,5.248276728650798,5.8630762134773144,5.426130988459656,351362.6956521739,2,8,2,7,2,2,2,1.0,-2,1,0,-1,-1,-2,-3
3168,5.520231846995002,5.466354378117811,5.452757553766237,5.033729666031447,5.375332775531999,5.938415445737391,5.521192740273956,266047.9463087248,3,E01003240,8,2,7,2,4,4,5.380875507457144,5.30713338419895,5.497898479436068,5.055422294059856,5.276585412505489,5.908453754130626,5.469605006627589,343190.39597315434,2,6,3,6,2,3,3,1.0,-1,-2,1,-1,0,-1,-1
3169,5.5623945435845705,5.346627387655786,5.565283374614026,4.860956109431853,5.433933461286935,6.049817264798176,5.560275728444019,272713.5481927711,4,E01003241,6,4,4,3,5,5,5.464127865102556,5.305394671360651,5.532260362969504,4.987336576647229,5.243033228317897,6.025025710794661,5.595476841264301,351124.9944444444,4,6,3,5,1,6,5,1.0,0,0,-1,1,-2,1,0
3170,5.4407664030345515,5.312201620927498,5.514530133845201,5.030147372786678,5.39264123653298,5.925515212229828,5.545829723130411,265039.32089552237,2,E01003243,5,3,7,3,3,5,5.304034065317224,5.23944954695525,5.562571209448355,5.072710108757019,5.225402111477322,5.971755894908199,5.65520483829357,339258.35555555555,2,5,4,7,1,5,6,1.0,0,0,1,0,-2,2,1
3171,5.128663521186978,5.441316931855445,5.277014512641757,5.262416767139061,5.170981720382092,5.587798843196794,5.22869879357955,279220.39215686277,0,E01003244,7,0,9,0,0,0,5.171567843884838,5.282664479041586,5.467384788454796,5.204365287508283,5.071391387861603,5.648348321720046,5.5123312521953975,359268.8163265306,0,6,2,9,0,0,3,1.0,0,-1,2,0,0,0,3
3172,4.918722486228086,5.466559975334768,5.331672099199188,5.421933298700311,5.171317776937164,5.534547770960947,5.059689766905281,292608.2921348315,0,E01003245,8,1,9,0,0,0,4.955861447999875,5.3735266625881195,5.466697673002879,5.3028984777629375,5.0775474309921265,5.664670355618,5.115120964745681,375637.65625,0,7,2,9,0,0,0,1.0,0,-1,1,0,0,0,0
3173,5.174432395288608,5.298122083580734,5.343757189360241,5.152389167139194,5.305976177221977,5.614370972518153,5.2280569748590455,280933.7046979866,0,E01003246,5,1,9,1,0,0,5.156582048961094,5.282047154562814,5.488286624635969,5.120805194037302,5.279919289180211,5.704019455909729,5.35250622681209,361265.4,0,6,2,8,2,0,1,1.0,0,1,1,-1,1,0,1
3174,5.433548101873109,5.354654895536827,5.470098016840039,5.037570494593996,5.315502694158843,5.826424025224917,5.366828840790373,286798.26515151514,2,E01003247,6,2,7,1,2,2,5.4929979980414645,5.2475096562229995,5.543070576715131,4.91557991335578,5.250063957897484,5.95143733295143,5.520832711077751,368502.47517730494,4,5,3,4,2,4,4,1.0,2,-1,1,-3,1,2,2
3175,5.510085559472805,5.385998563068669,5.458187136223645,5.0406156632958385,5.385819542698744,5.794322176677425,5.327271274434842,279893.8292682927,3,E01003248,7,2,7,2,1,1,5.409513296530797,5.30556720495224,5.460311928162208,5.016400357393118,5.339086949825287,5.831878840006315,5.493422128604009,359955.72307692305,3,6,2,6,3,2,3,1.0,0,-1,0,-1,1,1,2
3176,5.33398679853643,5.313595621331224,5.428576960147006,5.03471786304585,5.441687826971406,5.750085724210276,5.431731176607817,278775.3883495146,1,E01003249,5,2,7,4,1,3,5.310603143052852,5.32345217339536,5.489522693005014,5.135539415034842,5.236336979460209,5.806513692470307,5.483566137070351,358558.1808510638,2,7,2,8,1,2,3,1.0,1,2,0,1,-3,1,0
3177,5.366224529681268,5.399006528513772,5.336403523946737,5.113490612475903,5.339097843541728,5.638988519643808,5.330528342878663,279000.06493506493,2,E01003250,7,1,8,2,0,1,5.280780006006274,5.244598595393186,5.5402817064627055,5.108015005299122,5.369766690138447,5.7587115971339236,5.360690925162651,358889.5780346821,1,5,3,7,4,1,1,1.0,-1,-2,2,-1,2,1,0
3178,5.25312266117189,5.41654520499997,5.462151009862016,5.087336560574974,5.289638911805501,5.783106213662682,5.387743039828975,280082.5243902439,1,E01003251,7,2,8,1,1,2,5.328625612788731,5.2656848152478535,5.481847467687395,5.123426632086436,5.171863873799642,5.796382300059,5.321783187654283,360221.8888888889,2,6,2,8,0,1,1,1.0,1,-1,0,0,-1,0,-1
3179,5.326326586165518,5.409280297891149,5.595569021296951,5.044783023168456,5.345612753112361,5.8378784476586105,5.277561720812096,280338.5471698113,1,E01003252,7,4,7,2,2,1,5.400343970818953,5.281941218809648,5.591890980980613,5.1110603419217195,5.357621227611195,5.86752477125688,5.464349100806496,360545.94545454544,3,6,4,7,4,3,3,1.0,2,-1,0,0,2,1,2
3180,5.417397253317375,5.2648510198070575,5.5071714055048275,5.0481730152482855,5.34449673270526,5.733946405044974,5.342393301121176,280693.0753424658,2,E01003253,5,3,7,2,1,2,5.311384068085597,5.22615595582204,5.513932563555547,5.181014059445797,5.331260858437954,5.696799947665288,5.230511167874703,361091.92307692306,2,5,3,8,3,0,0,1.0,0,0,0,1,1,-1,-2
3181,5.866177540856438,5.242399284646318,5.6285100137865225,4.791228353010641,5.556324405927916,6.07466434143685,5.679113772753123,286545.06486486486,7,E01003254,4,5,3,6,6,7,5.73986761312227,5.284937850204674,5.627229467598168,4.813116194750812,5.418537078676997,6.0337452836938805,5.685996787612503,367954.0864864865,7,6,5,2,6,6,7,1.0,0,2,0,-1,0,0,0
3182,5.725466199741242,5.117257304252333,5.692827593748737,4.8206430104128115,5.523124231654368,5.893800667137097,5.439857749422645,283972.99363057327,6,E01003255,2,6,3,6,3,3,5.693964798748493,5.029058835655451,5.766066265106201,4.846631421893835,5.530478425323963,5.9528903543949125,5.53902145922184,365050.56875,6,2,7,2,8,4,4,1.0,0,0,1,-1,2,1,1
3183,5.672947747366769,5.226270850499471,5.574894653047834,4.90592375369299,5.501063383193243,5.912839610236031,5.540221425465175,284139.4857142857,5,E01003256,4,4,5,5,3,5,5.642391321354342,5.23581612199769,5.545936446440847,4.935523830858388,5.512383604408207,5.978635542374804,5.573023122952397,365313.5939849624,6,5,3,4,8,5,5,1.0,1,1,-1,-1,3,2,0
3184,5.9289999350462805,5.302197335970284,5.420820278696494,4.732358394282879,5.61192256861394,5.987359858975552,5.548534125384718,287388.1683168317,8,E01003257,5,2,2,8,4,5,5.959454791075518,5.330155666182641,5.511731535399041,4.725440926292316,5.587881509949561,5.993108063328023,5.591951866539157,368357.04761904763,9,7,3,0,9,5,5,1.0,1,2,1,-2,1,1,0
3185,5.742952940075896,5.415468041286912,5.47441017904947,4.901155201501624,5.550136355466621,5.90511585668076,5.463650176691455,295547.27906976745,6,E01003258,7,2,5,6,3,3,5.697552055712567,5.290342777770086,5.533311862819242,4.855807761482845,5.495058977051286,5.947962716715225,5.483825317281761,379813.72185430466,6,6,3,2,7,4,3,1.0,0,-1,1,-3,1,1,0
3186,5.563275524929388,5.2293679046986705,5.5290637674616345,4.854563829614155,5.39199895912142,5.890769764558593,5.474644449219775,285554.6119402985,4,E01003259,4,3,4,3,3,4,5.538727371356426,5.20705275505017,5.603586371892538,4.946762619110254,5.342952061922122,5.834568361441295,5.497335049586418,367075.25,4,5,5,4,4,2,3,1.0,0,1,2,0,1,-1,-1
3187,5.823092875720786,5.21327365816926,5.579207813139442,4.832151134237111,5.528685406815234,6.080449179779712,5.641398974459806,289677.81294964027,7,E01003260,4,4,4,6,6,6,5.726700748970259,5.214648017242773,5.579230605666317,4.905338649429492,5.470918086037707,6.080989832308755,5.692274371189858,372023.85074626864,7,5,4,3,7,7,7,1.0,0,1,0,-1,1,1,1
3188,5.939522057771683,5.148076596669853,5.6776015451177955,4.679696028120816,5.590037651360035,6.204860728234053,5.715416992083192,291452.7734375,8,E01003261,3,6,1,7,8,7,5.765905122105166,5.193983538545293,5.618009527810186,4.908290592886561,5.420448865821894,6.0916980273432015,5.795385641159771,374197.5755395683,7,4,5,3,6,7,8,1.0,-1,1,-1,2,-1,-1,1
3189,5.994448044326868,5.132837371879749,5.84179529179348,4.676635080508971,5.693836346101225,6.292723355668314,5.767526720347029,287570.2921348315,8,E01003262,3,8,1,9,9,8,5.760372771157159,5.14857614401615,5.657539803572376,4.931035279023527,5.447064031254161,6.043612374199761,5.589583134410357,369891.55555555556,7,4,6,4,6,6,5,1.0,-1,1,-2,3,-3,-3,-3
3190,5.81442166129245,5.380812470671497,5.59414465819733,4.850115117392963,5.55982609564745,6.020381357096419,5.537582968609242,263306.0253164557,7,E01003263,7,4,4,6,5,5,5.640413960257729,5.297285957650824,5.533881634146303,4.971516208334283,5.376175786112691,5.990592420756162,5.568891417849195,339063.6153846154,6,6,3,5,4,5,4,1.0,-1,-1,-1,1,-2,0,-1
3191,5.671885107762247,5.345905407357611,5.544767373174594,4.901056666400551,5.5406718398984625,6.029436572480597,5.597569506471328,260639.8232044199,5,E01003264,6,4,5,6,5,6,5.528675887163947,5.350775884179508,5.543265425457674,4.942568722191979,5.372423602552975,6.057533105681924,5.639951598644257,335813.27647058823,4,7,3,4,4,6,6,1.0,-1,1,-1,-1,-2,1,0
3192,5.6643488345475035,5.39803798959173,5.567507141623004,4.853145756598177,5.437387283506064,6.014902803404578,5.394295451969936,260993.2844827586,5,E01003265,7,4,4,4,5,2,5.634695047640618,5.325553866743132,5.553213967621781,4.9341000345827055,5.4905283287281295,6.101093563414712,5.467444560000005,336229.9236641221,6,7,4,4,7,7,3,1.0,1,0,0,0,3,2,1
3193,5.213023055244136,5.504657227445293,5.279430967730445,5.125514411442989,5.293497704976314,5.727525506470655,5.207140196819563,260936.7162162162,0,E01003266,8,0,8,1,1,0,5.262592492460394,5.471296667241726,5.379760186688429,5.103285529986531,5.335589953020317,5.787600514029159,5.294167856780851,336219.2925170068,1,9,1,7,3,1,0,1.0,1,1,1,-1,2,0,0
3194,5.555086506651594,5.401481345876471,5.446950523884265,4.853109621382379,5.45821039862447,6.121666649719337,5.615183256663285,261079.1948051948,4,E01003267,7,2,4,4,7,6,5.593997491649324,5.372118683680435,5.483579961800136,4.945347260843756,5.3957879455543,6.074146769529471,5.527887250748149,336401.34969325154,5,7,2,4,5,7,4,1.0,1,0,0,0,1,0,-2
3195,5.674910437981814,5.153952701202291,5.693275947444486,4.916924727673562,5.5251138605029375,6.110885676958703,5.595339429299563,269038.92052980134,5,E01003268,3,6,5,6,7,6,5.559888960998182,5.222799278408116,5.659142495579802,5.003060690240364,5.365576015042432,6.027595012863247,5.646326554303913,346434.6358381503,5,5,6,5,4,6,6,1.0,0,2,0,0,-2,-1,0
3196,5.742021759636968,5.402254048011286,5.574962929856006,4.889407512095334,5.597223688372605,6.079160745195348,5.709755508162135,266940.8417266187,6,E01003269,7,4,5,7,6,7,5.669818956763656,5.3253502881085435,5.563914106510303,4.948016652354488,5.460426674948798,6.020823628814132,5.6653486816971395,343574.0814814815,6,7,4,4,7,6,6,1.0,0,0,0,-1,0,0,-1
3197,5.649392112441685,5.167499839395717,5.58052562976229,4.85055173739143,5.503009064473968,6.10331184103869,5.600453204002934,268092.5724637681,5,E01003270,3,4,4,5,6,6,5.417387314290808,5.228610752412937,5.643142964215887,4.985297687901746,5.319421955403065,6.027710436174534,5.737593454802596,345039.75167785236,3,5,5,5,3,6,7,1.0,-2,2,1,1,-2,0,1
3198,5.966154643318109,5.231292077846694,5.635638678283022,4.723679964479647,5.590724081323858,6.183674110655199,5.7487011896936515,263205.3859649123,8,E01003271,4,5,1,7,8,8,5.700931241956808,5.35291870115167,5.579700589179993,4.937476040953297,5.411830121177738,6.099246724177215,5.810317799196405,338664.8220338983,7,7,4,4,5,7,8,1.0,-1,3,-1,3,-2,-1,0
3199,5.798141407745856,4.997763020020944,5.882373721511276,4.64813976265766,5.49578524629275,6.25734520179254,5.723630828989877,289356.5462962963,7,E01003272,1,8,0,5,8,8,5.7041984334722295,4.9133806572304115,5.861581952722223,4.7790815948366046,5.43302029639751,6.165627372157466,5.826638142267863,371480.36036036036,7,1,8,1,6,8,8,1.0,0,0,0,1,1,0,0
3200,5.722739871205954,5.12796831233748,5.656882710497955,4.807287442273107,5.465389060563054,6.174459066884271,5.562999323524278,285425.0775862069,6,E01003273,2,5,3,4,7,5,5.678642539041383,5.134358317724296,5.614848939435823,4.957532624048846,5.32545995925154,6.091042744261878,5.573015440787588,367071.95535714284,6,3,5,4,3,7,5,1.0,0,1,0,1,-1,0,0
3201,5.776966619491577,5.094162647247314,5.904463302612305,4.721348336219788,5.504424831390381,6.223085988998413,5.720217761039734,289591.936,6,E01003274,2,8,1,5,8,7,5.680488475469443,5.08034035059122,5.742416943953588,4.808824369540582,5.413048459933354,6.163168960351211,5.798654977174905,372069.45384615386,6,2,7,2,5,8,8,1.0,0,0,-1,1,0,0,1
3202,5.537179708480835,5.315647939644237,5.371654180016848,4.996177035983246,5.37444262929482,5.860141133317853,5.408223734043612,290492.603960396,4,E01003275,5,1,6,2,2,3,5.397523024567851,5.399251968772323,5.425427552726534,5.1224329438474445,5.246440843299583,5.88883274572867,5.459162406347416,373005.98148148146,3,8,2,8,2,3,3,1.0,-1,3,1,2,0,1,0
3203,5.988779456162256,5.202792155348565,5.582146004704405,4.722768659926643,5.6355172297186105,6.0943087772889575,5.638368929220626,289603.87603305787,8,E01003276,4,4,1,8,6,6,5.807850030675593,5.10176892360384,5.618147661496406,4.844554440745749,5.424846519486176,6.081700932530678,5.705687269007312,371958.2970711297,8,3,5,2,6,7,7,1.0,0,-1,1,1,-2,1,1
3204,6.25478994718162,4.89202836508392,6.021430756456109,4.6010324903713755,5.705268790644984,6.4293445746103925,5.9600406872328895,288285.0430107527,9,E01003277,0,9,0,9,9,9,6.179522772168005,4.775641394215961,6.064959478932757,4.561943754207256,5.519664282022521,6.483058147652205,6.067154748495235,370400.011627907,9,0,9,0,8,9,9,1.0,0,0,0,0,-1,0,0
3205,5.885218705574092,5.029761209105053,5.817414181075827,4.657164871257587,5.595242839660088,6.243887286986748,5.748427329272249,287500.63503649633,7,E01003278,1,7,1,7,8,8,5.808438908642736,5.001770311388476,5.805793760562765,4.76636380327159,5.387311211125604,6.146266348608609,5.785528929480191,369308.77931034483,8,1,8,1,5,8,8,1.0,1,0,1,0,-2,0,0
3206,5.927118171816287,5.025693662270256,5.915937989691029,4.668052680596062,5.6078771093617314,6.431863566066908,5.797968348212864,279756.74782608694,8,E01003279,1,8,1,7,9,8,5.834074060432613,4.92505272384733,5.776478759944439,4.807381991297007,5.421103357337415,6.348089097067714,5.90368143375963,359198.4765625,8,1,7,1,6,9,9,1.0,0,0,-1,0,-1,0,1
3207,5.688468504795986,5.368727881296546,5.581764807743308,4.801649989280025,5.540043385682908,6.007273203503769,5.599920185266343,268908.83185840707,5,E01003280,6,4,3,6,5,6,5.665622536462682,5.257414451082244,5.644458255695023,4.85223161810227,5.493120601159016,6.032825200612308,5.6938521998529215,346294.7251908397,6,5,5,2,7,6,7,1.0,1,-1,1,-1,1,1,1
3208,5.649236444007145,5.302107109112686,5.591695137238235,4.84330897518758,5.49351481708248,6.073928286520283,5.564151965500264,270234.3370786517,5,E01003281,5,4,4,5,6,5,5.51713089310393,5.233787856539902,5.618282678175945,4.996423587507131,5.329772769188394,6.008283238021695,5.493687202127612,347975.6785714286,4,5,5,5,3,5,3,1.0,-1,0,1,1,-2,-1,-2
3209,5.753836075737052,5.128771167095393,5.694667149896491,4.77474277150141,5.532253137190048,6.07850084076189,5.6028390902362455,272260.70547945204,6,E01003282,2,6,2,6,6,6,5.737320450180811,5.099227864691552,5.750818076708638,4.885692554162749,5.451636193491888,6.099850771274973,5.70490395515523,350507.43262411345,7,3,7,3,6,7,7,1.0,1,1,1,1,0,1,1
3210,5.677901511807596,5.2031186265330165,5.746230608417142,4.751834707106314,5.458499703099651,6.175830229636161,5.690834896795211,270643.07096774195,5,E01003283,4,7,2,4,7,7,5.727816611711233,5.037913596703231,5.858138242382213,4.88586459642539,5.412500600873327,6.17729244495462,5.800409229255162,348499.10429447854,7,2,8,3,5,8,8,1.0,2,-2,1,1,1,1,1
3211,5.745353949546814,5.058006672859192,5.80507463645935,4.754634959220886,5.520726890563965,6.215084119796753,5.740887752532959,271598.12,6,E01003284,2,7,2,6,8,8,5.7742675922535085,5.022631703482734,5.838431916413484,4.783250655951323,5.363258156070003,6.185287343131171,5.8396040227678085,349736.4666666667,7,2,8,1,4,8,9,1.0,1,0,1,-1,-2,0,1
3212,5.756198590671694,5.267699770025305,5.73169568583772,4.858305361625311,5.565370285833204,6.015736576673147,5.479368218699017,269357.88513513515,6,E01003285,5,6,4,7,5,4,5.655103178893995,5.156224946555851,5.7152334009326475,4.904171768974209,5.473363001391573,5.994307675451602,5.558956241457717,346931.5534591195,6,4,7,3,7,5,4,1.0,0,-1,1,-1,0,0,0
3213,5.647125064409696,5.290069287556868,5.641235109475943,4.938841133851271,5.45084167443789,5.93243887424469,5.471134163783147,269490.3076923077,5,E01003286,5,5,6,4,3,4,5.589671325989259,5.1683508188296585,5.6597535228117914,4.944204161564509,5.345288551770723,5.993033681160364,5.626758014544462,346986.141025641,5,4,6,4,4,5,6,1.0,0,-1,1,-2,0,2,2
3214,5.908952405958464,5.105593558513757,5.807244318904298,4.657932125438343,5.526436519622803,6.245947246118026,5.759195411566532,270952.9212121212,8,E01003287,2,7,1,6,8,8,5.94147528817014,5.039487764602754,5.879702992555572,4.698802784448716,5.473450274729148,6.247332359232554,5.932359246219077,348964.7012195122,9,2,8,0,7,9,9,1.0,1,0,1,-1,1,1,1
3215,5.634958243047869,5.274358866988002,5.575785549105825,4.9465466600817605,5.5008435595679925,5.843119995014088,5.444616745452623,272345.70945945947,5,E01003288,5,4,6,5,2,3,5.584118029513917,5.155870260356308,5.677186591284616,4.979085385025321,5.398140100689678,5.999507973720501,5.456522703944863,350585.1168831169,5,4,6,5,5,5,3,1.0,0,-1,2,-1,0,3,0
3216,5.505485102909954,5.21345907700162,5.691376044970601,4.953022664334593,5.384122043096719,5.9397445255968755,5.510049721773933,272678.8991596639,3,E01003290,4,6,6,2,4,4,5.639018229816271,5.126841068267822,5.651156431695689,5.007509881517161,5.412257232873336,5.932172545142795,5.675894857489545,350979.06086956523,6,3,5,5,5,4,6,1.0,3,-1,-1,-1,3,0,2
3217,6.118850339290708,5.185358304385991,5.729351926219556,4.634772589040357,5.684584080710891,6.178954712180204,5.780892996824989,274309.3798449612,9,E01003291,3,6,0,9,7,8,5.9154797451836725,5.141204070193427,5.672265020438603,4.835233851841518,5.479567096914564,6.096993112564087,5.706538936921528,354759.5071428571,8,3,6,2,7,7,7,1.0,-1,0,0,2,-2,0,-1
3218,5.719000031637109,5.057642456759577,5.905659153150475,4.724475713398146,5.52305529013924,6.239657248621402,5.6754133369611655,272744.8608695652,6,E01003292,2,8,1,6,8,7,5.688177847280735,5.027551677168869,5.744414740461644,4.926941614810044,5.358739478801324,6.0305721604727145,5.567204938671453,351093.44715447153,6,2,7,4,4,6,4,1.0,0,0,-1,3,-2,-2,-3
3219,5.97400816177067,5.0046973751302355,5.9202723586768435,4.67911117014132,5.5955257436685395,6.3563946663287645,5.843417591170261,274204.8859649123,8,E01003293,1,8,1,7,9,9,5.7784824782768185,5.030017421308872,5.85951602142469,4.826686471964406,5.448298022810337,6.263133751607574,5.728280244675358,352253.2831858407,7,2,8,2,6,9,7,1.0,-1,1,0,1,-1,0,-2
3220,5.719483991609002,5.181928656397075,5.663403705958903,4.812528466656261,5.43998074357527,6.121624459315391,5.702983132244027,271595.01459854015,6,E01003295,3,5,3,4,7,7,5.608169593883835,5.162863876073415,5.724132572421591,4.938939272902394,5.323697474166637,6.026567260727628,5.650671147208177,349667.64122137404,5,4,7,4,3,6,6,1.0,-1,1,2,1,-1,-1,-1
3221,5.108804881572723,5.417962649546632,5.354426963613667,5.2233296271857865,5.248173157556342,5.620752040399324,5.142640587933567,278984.31651376147,0,E01003296,7,1,9,0,0,0,5.1727495383456406,5.224536696278242,5.489015579223633,5.155412605559208,5.202180703797663,5.706886529447548,5.395348584984403,358189.8047808765,0,5,2,8,1,0,2,1.0,0,-2,1,-1,1,0,2
3222,5.157494957558811,5.633147863671184,5.074501878581941,5.258734930306673,5.33822681941092,5.4110643127933145,4.984309739433229,292989.15625,0,E01003297,9,0,9,2,0,0,5.367230690043906,5.4972036743756405,5.294009986871518,5.162032148112422,5.320483333575799,5.666275372416337,5.243896202271029,376147.3602484472,2,9,0,8,3,0,0,1.0,2,0,0,-1,1,0,0
3223,5.293784589426858,5.496833854062217,5.286007731301444,5.117577055522374,5.2688962187085835,5.564149958746774,5.182922916752951,282652.6285714286,1,E01003298,8,0,8,1,0,0,5.246409975089036,5.384772162932854,5.289644612894429,5.132508666484387,5.204814313294052,5.80761887810447,5.1737672802689785,363432.0779220779,1,8,0,8,1,2,0,1.0,0,0,0,0,0,2,0
3224,5.365426761905352,5.195670636494954,5.621760000785192,5.07059138417244,5.324822649359703,5.739897533257802,5.3242472817500435,285424.76666666666,2,E01003299,3,5,8,1,1,1,5.399162477157155,5.146304324025014,5.706572333320242,4.966642702212099,5.271935113140794,5.859468006696857,5.516046866041715,366931.7950819672,3,4,6,5,2,2,4,1.0,1,1,1,-3,1,1,3
3225,5.370684107144673,5.502878915518522,5.406311516960462,5.058560283233722,5.2933170186976595,5.81893199433883,5.2767605148255825,283487.1458333333,2,E01003300,8,1,8,1,2,1,5.253299721965083,5.457208617969796,5.3608813396206605,5.152386571522112,5.221644381682078,5.742691748672062,5.248551210871449,364888.85185185185,1,8,1,8,1,1,0,1.0,-1,0,0,0,0,-1,-1
3226,5.539506346948685,5.460080842817983,5.4463303175664715,5.068390927007122,5.486753058048986,5.881935002342347,5.435456857565911,286819.01612903224,4,E01003301,8,2,8,5,3,3,5.555165733470291,5.391216680651805,5.54976282354261,5.048754577753974,5.371815403953928,5.966548970488251,5.5688478526521905,368622.4344262295,5,8,4,6,4,4,4,1.0,1,0,2,-2,-1,1,1
3227,5.52327208148623,5.258275241527743,5.614086088624973,4.982775483316588,5.525488140513596,5.8285848261083215,5.376461427188614,291337.87378640776,3,E01003302,4,5,6,6,2,2,5.385013319411367,5.261356377376701,5.503392982033064,4.99833985994447,5.346412528235957,5.820335721069911,5.402482622074631,374399.4716981132,3,5,3,5,4,2,2,1.0,0,1,-2,-1,-2,0,0
3228,5.323181697028748,5.291634791074915,5.4792192083724,5.061563770187662,5.315628637024697,5.708568002949369,5.216903021995058,284276.46276595746,1,E01003303,5,2,8,1,0,0,5.284910671340609,5.169752739586876,5.594647158696813,5.045098242829147,5.296195290042359,5.79148231142933,5.394366271287492,365487.3349514563,1,4,4,6,2,1,2,1.0,0,-1,2,-2,1,1,2
3229,5.264600726080612,5.263727463467021,5.495257063650749,5.1252061523182295,5.261741296506264,5.6262474227959,5.235455100804987,282611.71126760566,1,E01003304,5,3,8,1,0,1,5.226324894545991,5.1165533426367205,5.637615122912843,5.065358041981121,5.270346027097585,5.69722122616238,5.2926048040390015,363606.8333333333,1,3,5,7,2,0,0,1.0,0,-2,2,-1,1,0,-1
3230,5.476683625910018,5.263112825817532,5.619692373275757,5.059773731231689,5.446040561464097,5.833772979842292,5.397467593352,288104.81111111114,3,E01003305,5,5,8,4,2,2,5.5540101904618115,5.119617399416472,5.726975232676456,4.892073386593869,5.3508303491692795,5.956511008112054,5.595464100335773,370252.4947368421,5,3,7,3,4,4,5,1.0,2,-2,2,-5,0,2,3
3231,5.801217861713901,4.978640265041782,5.843524475251475,4.799930536939252,5.6697556145729555,6.294415183605686,5.759716468472635,282729.5483870968,7,E01003307,1,8,3,8,9,8,5.680509357767947,4.960555205450339,5.8065089881420135,4.79357027481584,5.407177032793269,6.225819794570699,5.756432100253947,363548.17647058825,6,1,8,1,5,9,8,1.0,-1,0,0,-2,-3,0,0
3232,5.8294402173728,5.130139374535931,5.799527353491665,4.74958510635313,5.57565900708033,6.2818209573257064,5.783061483674798,280326.2231404959,7,E01003308,2,7,2,7,9,8,5.62443271120086,5.076778127946927,5.782516079094574,4.851687405855601,5.403923670754178,6.1271128909278465,5.807010401296251,360431.0458015267,6,2,7,2,5,7,8,1.0,-1,0,0,0,-2,-2,0
3233,5.854574882984162,5.370110035936038,5.569723572333654,4.780116439859072,5.6110519707202915,6.003744145234426,5.456374044219653,283203.8416666667,7,E01003309,6,4,2,8,5,3,5.796762850051536,5.257562311072099,5.563555348188357,4.866971929270522,5.501717280624504,6.062084929387372,5.528331619456298,364128.67669172934,7,5,4,3,7,6,4,1.0,0,-1,0,1,-1,1,1
3234,5.766733326644541,5.189453576212731,5.591910863591131,4.91539401874364,5.567929907379863,5.984210063363904,5.561242868967145,283359.5140186916,6,E01003310,3,4,5,7,4,5,5.584939357824624,5.249517218209803,5.582972058095038,4.995416544377804,5.362868310883641,5.930554736405611,5.496573368087411,364345.8203125,5,5,4,5,4,4,3,1.0,-1,2,0,0,-3,0,-2
3235,5.84917081772596,5.214273575393633,5.810145263014169,4.8001619214299085,5.569311158410434,6.270283418140192,5.764555857099336,281763.6609195402,7,E01003311,4,7,3,7,8,8,5.649241260807924,5.112643479096769,5.694870874135181,4.954687907238199,5.396652389656413,6.190183348125881,5.7343958489822615,362240.4646464646,6,3,6,4,5,8,7,1.0,-1,-1,-1,1,-2,0,-1
3236,5.760960339672035,5.214862487382359,5.745076081819004,4.7988256679640875,5.610380045241779,6.179876367251079,5.598952509462833,282650.75694444444,6,E01003312,4,7,3,8,7,6,5.616531760632237,5.1631300532365145,5.70994900299024,4.938876626612265,5.388611881038811,6.0520761858058885,5.656131998647617,363418.5,5,4,6,4,5,6,6,1.0,-1,0,-1,1,-3,-1,0
3237,5.836842956214116,5.305518573728101,5.595656101731048,4.8096200022204165,5.636073131670897,5.975485152211682,5.586612191693536,283323.5632183908,7,E01003313,5,4,3,8,4,6,5.692385609616938,5.241455872034289,5.5186072403622655,4.891640081848066,5.430030279552813,5.909217416625662,5.487864886362528,364337.5257731959,6,5,3,3,6,3,3,1.0,-1,0,-1,0,-2,-1,-3
3238,6.196303496969507,4.9911141940887935,5.927419015701781,4.579971279235596,5.788222820200819,6.439859354749639,5.948953464944312,281619.1382978723,9,E01003314,1,9,0,9,9,9,6.0009083232364135,4.92633166828671,5.898954586939769,4.710094542116733,5.597996632258098,6.3619323657439635,5.997308634422921,362353.35135135136,9,1,9,0,9,9,9,1.0,0,0,0,0,0,0,0
3239,5.850938315244065,5.1433360748684285,5.8317989836034085,4.707268315492217,5.5455242800958375,6.130118139011344,5.674115333360495,283336.5154639175,7,E01003315,3,8,1,6,7,7,5.7062080453853214,5.105506019932883,5.770132208357052,4.807496170608365,5.46763386531752,6.060825471975366,5.638933038224979,364306.28571428574,7,3,7,1,7,6,6,1.0,0,0,-1,0,1,-1,-1
3240,5.840357868567757,5.078662743775741,5.849727570492289,4.812368697705476,5.576304858663808,6.270844450204269,5.859421449122221,282763.05217391305,7,E01003316,2,8,3,7,8,9,5.7278626686936125,5.04432643006701,5.808524559397216,4.89035372996549,5.404973814246851,6.247804858268948,5.861470172164637,363579.6972477064,7,2,8,3,5,9,9,1.0,0,0,0,0,-2,1,0
3241,5.757259161201949,5.257652220037794,5.565898445463672,4.833064806215542,5.566407380030327,6.07221338552298,5.465923542828904,283336.2268041237,6,E01003317,4,4,4,7,6,4,5.585463692656661,5.240473838506547,5.544313291532803,4.940433981144323,5.416862349594589,6.002412386700115,5.530369764935654,364804.3230088496,5,5,3,4,5,5,4,1.0,-1,1,-1,0,-2,-1,0
3242,5.531238549887532,5.119235677550537,5.747759220576046,4.960863842506601,5.446501408562516,5.959932840231693,5.533673370125318,281345.23232323234,3,E01003318,2,7,6,4,4,5,5.60333758221859,5.089423308532203,5.656884606945457,4.998398779681995,5.38850349159332,6.002572327709654,5.721289418530806,361350.8086124402,5,3,6,5,5,5,7,1.0,2,1,-1,-1,1,1,2
3243,5.691394770631985,5.211618948955925,5.717818907329014,5.028093743080995,5.447870075702667,6.220272392642741,5.759725632716198,275660.7346938776,5,E01003319,4,6,7,4,8,8,5.481033403958593,5.105669241930757,5.673002819929804,5.111637139958995,5.315984982464995,6.014729116644178,5.5955036750861575,354803.85714285716,4,3,6,7,3,5,5,1.0,-1,-1,0,0,-1,-3,-3
3244,5.71766771511598,5.145625052126971,5.752519512718374,4.940847379240123,5.518599686297503,6.176783139055425,5.671764804558321,275598.875,6,E01003320,3,7,6,6,7,7,5.50688816798039,5.156317749084571,5.624538132777581,4.994588650189913,5.272556742032369,6.0602481701435185,5.663549970357846,354639.1538461539,4,4,5,5,2,6,6,1.0,-2,1,-2,-1,-4,-1,-1
3245,5.706012502960537,5.145559408353723,5.794588696438333,4.870967201564623,5.470407899566319,6.133910687073417,5.667410535397737,278343.93913043477,5,E01003321,3,7,4,4,7,7,5.652874118804932,5.078977434158325,5.778101150512695,4.932172185897827,5.361131420135498,6.085646077156067,5.711519823074341,357827.928,6,2,7,4,4,7,7,1.0,1,-1,0,0,0,0,0
3246,5.895829780386128,5.038974231536235,5.877490159568437,4.740406080123481,5.534308130588006,6.293721885856138,5.870284850444269,290798.7339449541,7,E01003322,1,8,2,6,9,9,5.6471155610510975,4.947677795479938,5.819553906355447,4.797879315004116,5.458628429629939,6.200868315813018,5.784277518590291,373362.9918699187,6,1,8,1,7,8,8,1.0,-1,0,0,-1,1,-1,-1
3247,5.82637482881546,5.1360539808869365,5.817517212033271,4.722334523499012,5.517260891199112,6.301265946030616,5.842210367321968,273862.75,7,E01003323,3,7,1,5,9,9,5.893307331836585,5.114473023197868,5.893902211478262,4.748171770211422,5.522598754275929,6.298307361024799,5.754267073038853,352465.98484848486,8,3,8,1,8,9,8,1.0,1,0,1,0,3,0,-1
3248,5.328218261937837,5.191065989636086,5.713310989173683,4.952455124339542,5.356261987943907,5.965974975276637,5.428143162985106,290825.36486486485,1,E01003324,3,6,6,2,4,3,5.338448466289611,5.118628506149564,5.698938585463024,5.0257473275775,5.259700448740096,5.854443780013493,5.402012129624684,373512.63095238095,2,3,6,6,2,2,2,1.0,1,0,0,0,0,-2,-1
3249,5.902086464726195,4.940528554575784,5.9163890493159395,4.767627512922092,5.552278933476429,6.372644675021269,5.927894685949598,276543.5918367347,8,E01003325,0,8,2,6,9,9,5.844018566111724,5.008650871614615,5.902829483151436,4.873864731440942,5.5769290799895925,6.360323056578636,5.884028336654107,355172.15625,8,2,9,3,9,9,9,1.0,0,2,1,1,3,0,0
3250,5.542992346627372,5.112804165340605,5.69754703158424,4.8760986873081755,5.495453582491193,6.0932249818529405,5.524455786886669,265276.8095238095,4,E01003326,2,6,4,5,6,4,5.477767101004104,5.196260093657439,5.642624811692671,4.926319401126262,5.318422736215197,6.027208152881339,5.50871627291372,342155.7438016529,4,4,5,4,3,6,3,1.0,0,2,-1,0,-2,0,-1
3251,5.752812106088297,5.053610706171453,5.86355497347598,4.806484272937901,5.554537577344882,6.16781599474269,5.748039029291924,269593.5761589404,6,E01003327,1,8,3,6,7,8,5.640181641980826,5.019765617617642,5.815139865300742,4.8525248098086164,5.412419074989227,6.153629878917372,5.720299397606447,347377.4518072289,6,2,8,2,5,8,7,1.0,0,1,0,-1,-1,1,-1
3252,5.830999096919751,5.192422529746747,5.580862904417104,4.810012835880806,5.459693213988995,6.000988779396846,5.533359489564238,274618.0172413793,7,E01003328,3,4,3,4,5,5,5.806547303830296,5.162586709684577,5.706345116796572,4.814555808532337,5.43114527591989,6.091284442539058,5.694800967027333,354495.53719008266,8,4,6,2,6,7,7,1.0,1,1,2,-1,2,2,2
3253,5.819651912129115,5.252901272168235,5.682356334867931,4.859629249761975,5.542469026550414,6.136934331485203,5.637826869412074,284092.09523809527,7,E01003329,4,6,4,6,7,6,5.63590432344562,5.24981197562531,5.675433324201264,4.91096290619704,5.441254771538895,6.102001416422155,5.666614612523657,365224.9124087591,6,5,6,3,6,7,6,1.0,-1,1,0,-1,0,0,0
3254,5.89784326242364,5.359263723311217,5.366856617340143,4.8560003845588025,5.528215710667596,5.839327121126479,5.396446069081624,295746.1376811594,7,E01003330,6,1,4,6,2,2,5.95412752142659,5.29683142606123,5.460960902549602,4.8573588177009865,5.494966664432008,5.968584694980104,5.447396374778983,379651.22839506174,9,6,2,2,7,5,2,1.0,2,0,1,-2,1,3,0
3255,5.709042833911048,5.394737993125562,5.5380280437292875,4.857139078555284,5.533479165147852,5.99047334547396,5.380402997688011,286194.537037037,6,E01003331,7,3,4,6,4,2,5.535110500805518,5.396601634867051,5.505821748691447,5.016567002324497,5.4162273284266975,5.888936519622803,5.461090944269124,368902.20588235295,4,8,3,6,5,3,3,1.0,-2,1,0,2,-1,-1,1
3256,5.999380475503427,5.270298025343153,5.5827763036445335,4.658392437299093,5.670467242488154,6.069084879204079,5.609018573937592,291989.8888888889,8,E01003332,5,4,1,8,6,6,5.819903312058284,5.214583913211165,5.554743355718152,4.822471879268515,5.560227547020748,6.034138748563569,5.556692657799556,375858.35172413796,8,5,4,2,8,6,4,1.0,0,0,0,1,0,0,-2
3257,5.789565738943434,5.207579820426469,5.751434045968597,4.770221699144423,5.564826347164272,6.1225689465237645,5.66427929745507,279451.0,6,E01003333,4,7,2,7,7,7,5.5645606693099525,5.16732884388344,5.7206989339753695,4.855047328799379,5.382785769069896,6.016156138158312,5.607721978542852,359588.4117647059,5,4,7,2,5,5,5,1.0,-1,0,0,0,-2,-2,-2
3258,5.642576789433977,5.202517373371968,5.68279303702633,4.79056270249122,5.495332153497544,5.92011817366676,5.4274815141627215,283891.65486725664,5,E01003334,3,6,3,5,3,3,5.593391095991615,5.151071929245544,5.693775384546184,4.849791180315635,5.433426648592778,5.925663779965408,5.549380400197969,364994.08633093524,5,4,6,2,6,4,4,1.0,0,1,0,-1,1,1,1
3259,5.881162186081593,5.171580305466285,5.830796292194953,4.746523146445934,5.725688771559642,6.335376115945669,5.757879949533022,282979.0,7,E01003335,3,8,2,9,9,8,5.638584520733147,5.192189959057591,5.666000539796395,4.852257205728899,5.388505509025173,6.125565507955718,5.700555307823315,363824.20175438595,6,4,6,2,5,7,7,1.0,-1,1,-2,0,-4,-2,-1
3260,5.616786301750498,5.309506910363424,5.488877542240104,4.906620206292143,5.532672749352209,5.888560764568368,5.394531182407104,289025.7010309278,4,E01003336,5,3,5,6,3,2,5.363853279027071,5.270753179896961,5.466440799019553,5.020813753388145,5.379021412676031,5.779099056937477,5.258149442889474,371119.60909090907,2,6,2,6,4,1,0,1.0,-2,1,-1,1,-2,-2,-2
3261,5.438802427715725,5.3663492154593415,5.412795700208105,4.997500285957798,5.3925795807982935,5.685999179127241,5.218690600058045,289805.7373737374,2,E01003337,6,2,7,3,0,0,5.333143446180555,5.297365496856997,5.3640913686367,5.071524344309412,5.226846912894586,5.679763995035731,5.192554727949277,372149.9797979798,2,6,1,7,1,0,0,1.0,0,0,-1,0,-2,0,0
3262,5.310962646694507,5.335318089541742,5.582271888094433,5.024437553801779,5.414681485143759,5.726950790922521,5.2451974547515485,285745.3813559322,1,E01003338,6,4,7,3,1,1,5.3429535531357635,5.134995202090116,5.650718647361602,4.97725046081031,5.295879693639359,5.795722273372164,5.3912822328157874,367312.3087248322,2,3,5,5,2,1,2,1.0,1,-3,1,-2,-1,0,1
3263,5.6471655666828156,5.285811092817422,5.6446645025051,4.892502444260048,5.508115628452012,5.951634399818651,5.321473275170182,286416.01515151514,5,E01003339,5,5,5,5,4,1,5.369242166319201,5.293956536439158,5.573649669847181,5.000540376670899,5.319392307150748,5.850880765145825,5.390048167397899,368169.87903225806,2,6,4,5,3,2,2,1.0,-3,1,-1,0,-2,-2,1
3264,5.980504479752966,4.925366270973022,5.905352560870619,4.716322880193411,5.638287236891597,6.184359395360372,5.925381617373731,286416.1084337349,8,E01003340,0,8,1,8,8,9,5.924474577540937,4.902708745521048,5.986618871274202,4.769010034592255,5.488615080066349,6.2208838747895285,5.920625509127326,368155.902173913,9,0,9,1,7,9,9,1.0,1,0,1,0,-1,1,0
3265,6.260370003140491,5.008038767006086,5.895645983841108,4.551344858563465,5.671844158483588,6.381783734197202,5.9185826972774835,286851.8369565217,9,E01003341,1,8,0,8,9,9,6.039518285304942,4.956400240989441,5.8570109073151935,4.696014898888608,5.562701509353962,6.279982120432752,5.853370798395035,368653.8617021277,9,1,8,0,8,9,9,1.0,0,0,0,0,0,0,0
3266,5.949147629737854,5.17226180934906,5.723628566741944,4.7664698753356936,5.561257806777954,6.194741419792175,5.650791224479676,288112.344,8,E01003342,3,6,2,6,8,7,5.862848962310457,5.090275043118609,5.730634974737237,4.878386006738148,5.4640112514913515,6.1422300651995805,5.671042399684878,370166.503649635,8,3,7,3,7,8,6,1.0,0,0,1,1,1,0,-1
3267,5.7171947956085205,5.207763450301212,5.678667464981908,4.831790396700734,5.53505059040111,6.091511889644291,5.559820033933805,287110.2173913043,6,E01003343,4,6,4,6,6,5,5.510726568745632,5.197041896044039,5.681741001559239,4.938661326380337,5.397920603845634,5.913456379198561,5.474196825541702,368959.9411764706,4,4,6,4,5,3,3,1.0,-2,0,0,0,-1,-3,-2
3268,5.711970054019581,5.125845867937262,5.793763663552024,4.827496669509194,5.523588887127963,6.176749574054371,5.693150190873579,287501.4909090909,6,E01003344,2,7,3,6,7,7,5.715991948590134,5.023750501449662,5.781920341530231,4.876727672538372,5.440627832605381,6.168882579514475,5.698358646546952,369418.0505050505,7,2,7,3,6,8,7,1.0,1,0,0,0,0,1,0
3269,5.521402059839322,5.23190993643724,5.574236436532094,4.94321192915623,5.4041375403220835,6.010125637054443,5.444431011493389,288337.96153846156,3,E01003345,4,4,6,3,5,3,5.354040226766041,5.2262853877885,5.601189809186118,5.040697246789932,5.28773193189076,5.955489131382533,5.469149093968528,370280.5571428572,2,5,4,6,2,4,3,1.0,-1,1,0,0,-1,-1,0
3270,5.562063504854838,5.372320811483595,5.442094582451714,4.946786529223124,5.442384712431166,5.9791088422139484,5.4964950842327545,270531.56,4,E01003346,6,2,6,4,4,4,5.579643707477908,5.340266873937776,5.461700813650625,4.990932747203871,5.407492978232248,5.943658431984743,5.489944563409076,348329.7606177606,5,7,2,5,5,4,3,1.0,1,1,0,-1,1,0,-1
3271,5.517253398895264,5.403842128878054,5.489038923512334,4.845042446385259,5.438127353916998,5.9969419520834215,5.533182726735654,272404.3043478261,3,E01003347,7,3,4,4,4,5,5.445508344753368,5.41824299150759,5.538699770832921,4.988327294856578,5.420289110493016,5.983775287061124,5.498598772126275,350567.64864864864,3,8,3,5,6,5,3,1.0,0,1,0,1,2,1,-2
3272,5.556432065210845,5.2598387975441785,5.502387387501566,4.878645464621092,5.372587173863461,6.049372196824927,5.64755655025181,276019.6157894737,4,E01003348,4,3,4,2,5,7,5.485965667214504,5.156767629468164,5.627987632086111,4.968155987872634,5.3865975690442465,6.022526724393978,5.733102006135985,355175.511627907,4,4,5,5,5,6,7,1.0,0,0,2,1,3,1,0
3273,5.436659895855447,5.498145590657773,5.5740409788878065,4.927600553761358,5.447762859385946,6.153276926538219,5.51774133288342,269039.9130434783,2,E01003349,8,4,5,4,7,4,5.308860219441927,5.393132149518191,5.594709192003522,5.0683993350018515,5.357776303867717,6.008337869748964,5.403779312804505,346406.021978022,2,8,4,7,4,5,2,1.0,0,0,0,2,0,-2,-2
3274,5.529496646696521,5.411469773900125,5.4587341902717466,4.902277131234446,5.348429846186792,5.961085379123688,5.522611681492098,275003.0483870968,3,E01003350,7,2,5,2,4,4,5.465993596826281,5.314448503085545,5.462394570452826,5.010127762385777,5.365173384121486,5.918369838169643,5.366282051801681,353861.21428571426,4,6,2,6,4,4,1,1.0,1,-1,0,1,2,0,-3
3275,5.704615954611753,5.3864667463946985,5.506493410548648,4.860444631930944,5.538673001366693,5.967646588344832,5.542851486721554,269745.7702702703,5,E01003351,7,3,4,6,4,5,5.665649970372518,5.347420730374076,5.574802395069238,4.967362939408331,5.52413511095625,5.987435346299952,5.418633591045033,347462.82575757575,6,7,4,5,8,5,2,1.0,1,0,1,1,2,1,-3
3276,5.558562313217714,5.257584535931966,5.560040916304991,4.873613371906511,5.405236435223775,5.994217255029334,5.566546558615673,276472.8253012048,4,E01003352,4,4,4,3,4,5,5.370043896430031,5.231780493059638,5.595429349212007,5.039468039347473,5.294120558147324,6.026345398172986,5.693669120692674,355773.86033519555,2,5,4,6,2,6,7,1.0,-2,1,0,2,-1,2,2
3277,5.726394180553715,5.256889293833477,5.649621890230876,4.840744284304177,5.535507262043836,6.146824421533724,5.676242807434827,274590.8682926829,6,E01003353,4,5,4,6,7,7,5.571360042784363,5.153163228649646,5.6805142988450825,4.9327049646526575,5.367178619839251,6.132508751004934,5.758838406763971,353541.6015625,5,4,6,4,4,8,8,1.0,-1,0,1,0,-2,1,1
3278,5.656681590220508,5.3124244998483094,5.479273533821106,4.905100441680235,5.474045184079339,6.040301552940817,5.641028353045969,269880.8294117647,5,E01003354,5,2,5,4,5,6,5.654255308682406,5.216851461537277,5.548919177508052,4.973678262927864,5.45240374531927,6.053596212894102,5.670541715018357,347502.917721519,6,5,4,5,6,6,6,1.0,1,0,2,0,2,1,0
3279,5.5401985502243045,5.051248565673828,5.738482807159424,4.873758199691772,5.428501254081726,6.112915878295898,5.529992706298828,244127.336,4,E01003355,1,7,4,3,7,5,5.49838733291626,5.103762645721435,5.756520473480225,4.9578645086288455,5.338754258155823,6.02272130393982,5.564607630729675,313826.992,4,3,7,4,3,6,4,1.0,0,2,0,0,0,-1,-1
3280,5.452749854889675,5.290651470274475,5.546725034713745,5.05513498083276,5.31538700998126,5.894262395687957,5.3150419827124376,244100.81094527364,3,E01003356,5,4,7,1,3,1,5.475829849243164,5.263542224764824,5.477175722718239,5.04811788380146,5.282249643206597,5.952693884372711,5.459085105657578,313731.655,4,6,2,6,2,4,3,1.0,1,1,-2,-1,1,1,2
3281,5.1104848756702665,5.516859279313219,5.252265422169222,5.1617266951350995,5.187468510155284,5.617552578449249,5.1114697210285645,242560.24311926606,0,E01003357,8,0,9,0,0,0,5.1992670889187576,5.49076773708028,5.283566838368437,5.144194926086225,5.1380767167959,5.674951517044153,5.240504245112713,311566.7368421053,1,9,0,8,0,0,0,1.0,1,1,0,-1,0,0,0
3282,5.547249502426869,5.051741112728377,5.785845733977653,4.838881179287627,5.536311230143985,6.119408330401859,5.515408552176243,177331.92567567568,4,E01003358,1,7,4,6,7,4,5.527420942244992,5.087287191421755,5.767314849361297,4.953590481512008,5.406880523312476,6.01105248543524,5.547771771492497,226670.29677419356,4,3,7,4,5,5,4,1.0,0,2,0,0,-1,-2,0
3283,5.363212937778897,5.279707707299126,5.545231660207112,4.8811701827579075,5.383739565036915,6.02625434840167,5.36571315129598,212428.9037037037,2,E01003359,5,4,4,2,5,2,5.326659542063008,5.279851243979689,5.5176490407059156,4.986687471901161,5.277252299198206,5.9258002215537475,5.408978876860245,272190.847826087,2,6,3,5,2,4,2,1.0,0,1,-1,1,0,-1,0
3284,5.694519957875817,4.982663607209679,5.856657970242384,4.665071941972748,5.5469843721002094,6.173064476106225,5.541374427516286,186039.0487804878,5,E01003360,1,8,1,6,7,5,5.52651192143906,5.0608292670212975,5.655493582865988,4.8619055128836814,5.423402070075042,5.976670842762141,5.450701914092367,239393.63565891472,4,2,5,2,6,5,2,1.0,-1,1,-3,1,0,-2,-3
3285,5.775745585229662,5.17714891632398,5.697768978277842,4.835251193576389,5.585063460138109,6.217952553431193,5.713998666736814,246012.80555555556,6,E01003361,3,6,4,7,8,7,5.626959657669067,5.15712641954422,5.711278079748154,4.84996564924717,5.452258170247078,6.214697115421295,5.797420784831047,316275.055,6,4,6,2,6,8,8,1.0,0,1,0,-2,-1,0,1
3286,5.939519330594667,5.26896863223533,5.693499697030648,4.730189096292801,5.7988085492828185,6.318786917353523,5.766253774688089,247216.12426035502,8,E01003362,5,6,2,9,9,8,5.886795192294651,5.135693232218425,5.713879777325524,4.827260434627533,5.677736356523302,6.365285001860725,5.895053478082021,317806.5333333333,8,3,6,2,9,9,9,1.0,0,-2,0,0,0,0,1
3287,5.806155089493636,5.290902376174927,5.737908445871794,4.776440715396797,5.659758559950105,6.224172585613125,5.6902879515847005,247656.63186813187,7,E01003363,5,7,2,8,8,7,5.644885500756706,5.1564562858604805,5.811440860352865,4.917420609695156,5.573885565850793,6.277044828345136,5.874315572947991,318382.18292682926,6,4,8,4,9,9,9,1.0,-1,-1,1,2,1,1,2
3288,5.70661151961775,5.274631164721306,5.752248734038397,4.7706818438523655,5.696696158276488,6.2330273476657485,5.762733282632386,248884.56291390728,5,E01003364,5,7,2,9,8,8,5.718542406956355,5.091715041134092,5.861513171758917,4.958289640645186,5.633082023925251,6.3165201677216425,5.852513662642902,320012.0208333333,7,3,8,4,9,9,9,1.0,2,-2,1,2,0,1,1
3289,5.870111644268036,5.143649612367153,5.735632540285588,4.70442368760705,5.635095898807049,6.286116801202297,5.841198796778917,246789.69375,7,E01003365,3,6,1,8,9,9,5.720277105167413,5.051481521053678,5.799247415202438,4.871023875133247,5.554812399445066,6.260408460714255,5.959678040947884,317334.6560509554,7,2,8,3,8,9,9,1.0,0,-1,2,2,0,0,0
3290,5.547521825347628,5.455936878919601,5.422950021567798,4.845806858369282,5.442299962753341,5.989127584866115,5.444914734079724,247044.0892857143,4,E01003366,8,2,4,4,4,3,5.752976851548977,5.388315142271761,5.418636517610379,4.912788062038536,5.438912246755497,5.997276678056774,5.684954985173163,317682.1736526946,7,8,1,3,6,5,7,1.0,3,0,-1,-1,2,1,4
3291,5.3812315065109315,5.344029123681064,5.431407775396503,5.039854784883878,5.295033384853764,5.860196441527934,5.319680058538681,221353.63035019455,2,E01003367,6,2,7,1,2,1,5.331475720770897,5.294771966434294,5.500822462862538,4.984085540617666,5.231150301714098,5.88273375457333,5.517942971760227,290845.54032258067,2,6,3,5,1,3,4,1.0,0,0,1,-2,0,1,3
3292,5.5820733920524,5.308373332807892,5.639922364761955,4.8424587696790695,5.509062406263854,6.055923868166773,5.428130410219493,234487.4144736842,4,E01003368,5,5,4,5,6,3,5.430385419300625,5.320338724421806,5.472582941152612,5.059732703935532,5.297323816487578,5.934164841969808,5.428886167857112,303833.8163265306,3,7,2,6,2,4,2,1.0,-1,2,-3,2,-3,-2,-1
3293,5.752439846383765,5.053449949051472,5.756366640963453,4.637494508256304,5.515670835971832,6.227164818885479,5.584827448459381,101804.22340425532,6,E01003369,1,7,0,5,8,6,5.740220614101576,4.9763403185035875,5.766364486321159,4.763258547886558,5.398183268049489,6.24874264260997,5.6475922504197,129932.75,7,1,7,1,5,9,6,1.0,1,0,0,1,0,1,0
3294,5.731893626370824,5.100192286914453,5.7620427465080315,4.771720268672571,5.536985478006807,6.1818791206618,5.568937070387647,102632.18796992481,6,E01003370,2,7,2,6,7,5,5.69206075896235,5.027232274413109,5.765200253795175,4.808488039409413,5.448468099622166,6.143878146129496,5.635721055023811,130960.5955882353,6,2,7,2,6,8,6,1.0,0,0,0,0,0,1,1
3295,5.974687396889866,5.075140069026758,5.80764640911971,4.65089741909858,5.6545922472925465,6.3973517417907715,5.845913894105665,101501.93069306931,8,E01003371,2,7,0,8,9,9,5.740988052252567,5.1582743435194995,5.7960195324637676,4.783676868737346,5.521026734149817,6.248585209702,5.6967926458878955,131290.59595959596,7,4,8,1,8,9,7,1.0,-1,2,1,1,0,0,-2
3296,5.441356762717752,5.266294240951538,5.56660371948691,4.936487664895899,5.4384016205282775,5.821895975225112,5.354290282025056,120550.38823529411,2,E01003372,5,4,6,4,2,2,5.4416244786272765,5.310419510769588,5.554836706448627,4.965529704606661,5.301698092491396,5.88932615710843,5.392780878210581,155876.5483870968,3,6,4,5,3,3,2,1.0,1,1,0,-1,-1,1,0
3297,5.193612039667888,5.49069747299824,5.296738869935563,5.104107765318121,5.326287769576878,5.802096565950264,5.152470775020933,239069.0,0,E01003373,8,0,8,1,1,0,5.2752534095372,5.386578851771132,5.359576454786497,5.144955049051303,5.2914067016583735,5.750683503730275,5.187250337868093,307436.4205607477,1,8,1,8,2,1,0,1.0,1,0,1,0,1,0,0
3298,5.816092808757509,5.1810322412422725,5.677764878102711,4.771579137018748,5.569631445407867,6.146783089637756,5.6750964139189035,239809.4714285714,7,E01003374,3,6,2,7,7,7,5.808905877120106,5.105676686510127,5.675866916670022,4.851186312682239,5.591317564037674,6.089671309112657,5.668863586500182,308400.60283687944,8,3,6,2,9,7,6,1.0,1,0,0,0,2,0,-1
3299,5.52378162687475,5.565179357962175,5.154936991388148,5.0348729495568705,5.37698073127053,5.691027311195027,5.1646647143363955,241133.86363636365,3,E01003375,9,0,7,2,0,0,5.5263974253648245,5.524987942058276,5.1505253492227565,5.024639353837842,5.227119447553859,5.6870464431304555,5.258463073400111,310037.00653594773,4,9,0,6,1,0,0,1.0,1,0,0,-1,-1,0,0
3300,5.570579472710104,5.423459815823175,5.425351833985522,4.911976841540119,5.396886381448484,5.965868425525092,5.492979969074524,239208.71895424835,4,E01003376,7,2,5,3,4,4,5.481490475566764,5.306618514029603,5.450107345455571,4.992349709335127,5.347267602619372,6.005521811937031,5.700170047973332,307578.5460526316,4,6,2,5,4,5,7,1.0,0,-1,0,0,1,1,3
3301,5.279742997222477,5.521195740169949,5.283044705126021,5.140844839149051,5.325986364152697,5.7386038144429525,5.279120225376553,239219.5888888889,1,E01003377,8,0,9,1,1,1,5.167205679707411,5.454372272258851,5.3246513648730955,5.210963166341549,5.242505713206966,5.791137613901278,5.364391783388649,307555.5,0,8,1,9,1,1,1,1.0,-1,0,1,0,0,0,0
3302,5.381392807145662,5.394228220740451,5.430504546135286,5.0065873355805115,5.400032167193256,5.852748366850841,5.248461444921132,238697.77215189874,2,E01003378,7,2,7,3,2,1,5.397175559963006,5.294443848340408,5.47054106860921,4.98593027436215,5.377693685932436,5.894411544868912,5.418317446674126,306975.2028985507,3,6,2,5,4,3,2,1.0,1,-1,0,-2,1,1,1
3303,5.5076385671442205,5.385287734595212,5.606807695735585,4.846849988807332,5.420766274495558,5.959822910482234,5.290110661766746,238115.5181818182,3,E01003379,7,4,4,3,4,1,5.455040944616,5.209382598598798,5.636310521761576,4.987532988190651,5.386875783403714,5.854675732056299,5.362116779883703,306269.23333333334,3,5,5,5,5,2,1,1.0,0,-2,1,1,2,-2,0
3304,6.081216844793868,5.119957796514851,5.810522788191495,4.62828859074475,5.727767160494033,6.357460477580763,5.781765818595886,246599.87671232875,9,E01003380,2,7,0,9,9,8,5.869592944174323,5.13373775609577,5.797816212850672,4.726674325593555,5.6205166387193985,6.309353576361678,5.829808929494319,317077.80916030536,8,3,8,0,9,9,8,1.0,-1,1,1,0,0,0,0
3305,5.861446194761381,5.1943293274856925,5.7927147215745585,4.68892380759472,5.625056270539291,6.239234935580276,5.640820053618724,247710.93700787402,7,E01003381,3,7,1,8,8,6,5.715570025556669,5.125666039196525,5.6271883624745165,4.772056882775675,5.460873996178935,6.104433383528642,5.561234688195657,318463.6299212598,7,3,5,1,7,7,4,1.0,0,0,-2,0,-1,-1,-2
3306,5.8527623775902144,5.221193482022767,5.819931391182296,4.616831200932144,5.638596840954702,6.3506901482923315,5.589039284154909,247519.24770642203,7,E01003382,4,7,0,8,9,6,5.902679516718938,5.0713215712662585,5.856588085929116,4.699736986841474,5.650302208386934,6.3014410983075155,5.700376366520976,318146.3076923077,8,2,8,0,9,9,7,1.0,1,-2,1,0,1,0,1
3307,5.463957508171306,5.108657167939579,5.817689884410185,4.90097278917537,5.475557236110463,6.026529877326068,5.407183096689336,148319.16470588234,3,E01003383,2,7,5,4,5,3,5.433472797191343,5.063554789100945,5.713428654484242,4.93708146750594,5.379010175193488,5.92425868231491,5.567909722887604,191134.0,3,2,6,4,4,4,4,1.0,0,0,-1,-1,0,-1,1
3308,5.903802234752505,5.0437767669266345,5.835187079859715,4.597322828629437,5.67700473467509,6.2808531499376485,5.5968472490123675,235216.9705882353,8,E01003384,1,8,0,9,9,6,5.733125714498145,5.093683036688332,5.799598967917611,4.760431545917119,5.452631120369813,6.1593908884814965,5.628098302912489,301207.1775700935,7,3,8,1,6,8,6,1.0,-1,2,0,1,-3,-1,0
3309,6.16010799528896,5.0071309234785,5.883874604667443,4.615429881690205,5.809546798899554,6.321336875791135,5.764279758584673,246022.76811594202,9,E01003385,1,8,0,9,9,8,6.031946270433191,5.038983589982333,5.856973190830178,4.613792085484283,5.674865449944588,6.308378978951336,5.905990090272198,316275.3630136986,9,2,8,0,9,9,9,1.0,0,1,0,0,0,0,1
3310,5.428404171735246,5.426021044617457,5.506715133490152,4.9952522026782,5.336234400603945,5.89322645301061,5.4093490278484015,237088.57615894038,2,E01003386,7,3,6,2,3,3,5.439903666435833,5.144593172509905,5.64024922545527,5.0130342773988215,5.431672160054596,5.97358806872032,5.398774742240637,305015.2042253521,3,3,5,6,6,5,2,1.0,1,-4,2,0,4,2,-1
3311,5.438231808139432,5.5022473358338875,5.323925067532447,5.028267085936761,5.368148873698327,5.823983203211139,5.291439081776526,236857.63225806452,2,E01003387,8,1,7,2,2,1,5.434628680730477,5.349151278153444,5.420860603069648,5.0566602769570475,5.354327963712888,5.826291937094468,5.3391339251628285,304674.71794871794,3,7,1,6,4,2,1,1.0,1,-1,0,-1,2,0,0
3312,5.441050152886998,5.29835260998119,5.61615164713426,4.921806199081017,5.426297881386497,5.98296209898862,5.427942408756777,237429.34848484848,2,E01003388,5,5,5,3,4,3,5.374831435033831,5.162797096422163,5.6039941007808105,5.028938088376643,5.367131804005575,5.90947529623064,5.3934944565013305,305432.4491525424,2,4,5,6,4,3,2,1.0,0,-1,0,1,1,-1,-1
3313,5.661571747094542,5.267852260838801,5.525941886494508,4.87859015728361,5.469557000764051,6.025787984905531,5.393892296594591,237541.61809045225,5,E01003389,5,3,4,4,5,2,5.511287755436367,5.1801393528779345,5.534448226292928,4.978714676698049,5.381468957000308,5.891391340229246,5.393932472334968,305559.68888888886,4,4,3,5,5,3,2,1.0,-1,-1,0,1,1,-2,0
3314,4.972530505141696,5.375689868991439,5.4352210566804215,5.274653165727048,5.214524157949396,5.669890444020967,5.307956296044427,237791.5945945946,0,E01003390,6,2,9,0,0,1,5.105939943539469,5.252781279777226,5.499749811072099,5.133396669438011,5.262514517495506,5.744038133244765,5.416472391078346,305827.80263157893,0,5,3,8,2,1,2,1.0,0,-1,1,-1,2,1,1
3315,5.093279014399022,5.681197197348983,5.312004807554645,5.095605788407503,5.257841713634538,5.557326371287123,4.9049295407754405,236444.95061728396,0,E01003391,9,1,8,0,0,0,5.064523774566072,5.585155075246638,5.122977802247712,5.28399224172939,5.043416091890046,5.497616160999645,4.937513069673018,304057.3181818182,0,9,0,9,0,0,0,1.0,0,0,-1,1,0,0,0
3316,5.675624491395177,5.3465626755276245,5.452967094408499,4.888864731466448,5.559285772813333,6.018367836604247,5.4395439890590875,235458.6418918919,5,E01003392,6,2,5,6,5,3,5.7324159222763855,5.202482681769829,5.585821323580556,4.985239748830919,5.546836266269931,6.079390635738125,5.58355999379963,304169.35714285716,7,4,4,5,8,7,5,1.0,2,-2,2,0,2,2,2
3317,5.88251679284232,4.899427892196746,6.00233934322993,4.754677162283943,5.6066167922247026,6.373807762350355,5.729018618663152,102492.78571428571,7,E01003393,0,9,2,7,9,8,5.898365051188367,4.7043303378084875,6.051220285131576,4.652910053730011,5.459810694481464,6.379997243272498,5.732952750743704,136300.17021276595,8,0,9,0,7,9,7,1.0,1,0,0,-2,0,0,-1
3318,5.458463000145969,5.143275633553006,5.750977328281529,4.816586091028934,5.458546731645698,6.154086221922312,5.340710757583972,220866.33774834438,3,E01003394,3,7,3,4,7,2,5.398097978447968,5.059872463814117,5.747763462786405,4.9021187893249705,5.349201997870919,6.047180811564128,5.510937557280439,290537.6289308176,3,2,7,3,4,6,3,1.0,0,-1,0,0,0,-1,1
3319,5.734182720524924,5.066520805869784,5.843372699192592,4.76401613014085,5.6224625536373685,6.303602760178702,5.595953592232296,236683.87857142856,6,E01003395,2,8,2,8,9,6,5.447611952420347,5.15805258958236,5.640987571722232,5.069082574814743,5.350813228891503,6.063175467970948,5.486085611840953,304587.099378882,3,4,5,7,4,6,3,1.0,-3,2,-3,5,-4,-3,-3
3320,6.106127794398818,4.869247943855996,6.130273577778838,4.503291828687801,5.6358778864838355,6.568739264510398,5.6343344283658405,100748.43023255814,9,E01003396,0,9,0,8,9,6,6.025664451610611,4.780465818313231,6.055428591119238,4.56710531625403,5.427252166242485,6.54586554148111,5.7866937151874405,128626.18072289157,9,0,9,0,6,9,8,1.0,0,0,0,0,-2,0,2
3321,5.790551815392836,5.020609836533384,5.900586164222573,4.703794854991841,5.548586645216312,6.358845116957179,5.496841385679425,113430.88679245283,7,E01003397,1,8,1,6,9,4,5.775910544184457,4.986582924834395,5.842583930597896,4.737459063529968,5.446234854976688,6.26662865993196,5.61825580301538,151809.66371681416,7,1,8,0,6,9,5,1.0,0,0,0,-1,0,0,1
3322,5.697394948671846,5.130587072933421,5.738037163720412,4.774160194922896,5.519411830341115,6.153740085223141,5.437738040790839,178456.22794117648,5,E01003398,2,7,2,6,7,3,5.7242138000635,5.010474860668182,5.798732198201693,4.862546302722051,5.441971920086787,6.214663944794581,5.60849638902224,217570.53846153847,7,2,8,2,6,8,5,1.0,2,0,1,0,0,1,2
3323,5.9683985369546075,5.14871009271972,5.8183450090641875,4.684800626063834,5.695288531634272,6.333380000931876,5.831315866538456,247057.45918367346,8,E01003399,3,7,1,9,9,9,5.806342005729675,5.141273223928043,5.766121960112026,4.761463069490024,5.546773861561503,6.242942096931594,5.792916774749756,317708.25,8,3,7,1,8,9,8,1.0,0,0,0,0,-1,0,-1
3324,5.974226573239202,5.032999835152557,5.9179462349933125,4.7273130624190625,5.553005718666574,6.2600843284441074,5.790141758711441,102358.58695652174,8,E01003400,1,8,2,6,8,8,5.8511864084134,4.977021365714588,5.83012627697677,4.775189650144508,5.517974143405612,6.121743169619883,5.82251542334934,130514.70503597123,8,1,8,1,8,7,8,1.0,0,0,0,-1,2,-1,0
3325,5.799959945499449,5.057509020755165,5.750696288015609,4.689497539871617,5.651371629614579,6.071534889981263,5.744730951194477,102098.02255639098,7,E01003401,2,7,1,8,6,8,5.699899409679657,5.079309843956156,5.671161031046657,4.879894369882895,5.544802572710294,6.066810284945982,5.6775394771116,130355.19858156028,6,2,6,3,8,6,6,1.0,-1,0,-1,2,0,0,-2
3326,5.900735927827703,5.047175910487865,5.825905231559801,4.687715380446716,5.668248034123355,6.189154770389293,5.809035539627075,103290.03773584905,8,E01003402,1,8,1,8,8,8,5.710125978835329,5.053467955417975,5.6988978078979216,4.806664875167573,5.559640715935987,6.105455826856419,5.736361340134444,131663.53892215568,7,2,6,1,8,7,7,1.0,-1,1,-2,0,0,-1,-1
3327,5.998346357810788,5.270303469605562,5.73032410551862,4.683068835880698,5.678816729929389,6.119120858064512,5.736261294382374,127923.89634146342,8,E01003403,5,6,1,9,7,8,5.812629185224834,5.150887098925852,5.610765879614311,4.762071504230388,5.575322978677805,6.1028683603855605,5.74676671781038,163298.47953216374,8,4,5,1,9,7,8,1.0,0,-1,-1,0,0,0,0
3328,6.0159609119097395,5.097349114585341,5.789023290600693,4.661730900145414,5.736154886714199,6.174991643219664,5.868287103217945,238180.56140350876,8,E01003404,2,7,1,9,7,9,5.8539794707951485,5.236775625241946,5.650918534357253,4.81979559300697,5.590935597681019,6.0613027451789545,5.685932376613356,308652.84246575343,8,5,5,2,9,6,7,1.0,0,3,-2,1,0,-1,-2
3329,5.130243280051667,5.557993543000869,5.306849044782144,5.178700603820659,5.222818090591901,5.7031714585092335,5.081240325062363,238275.1913580247,0,E01003405,9,0,9,0,0,0,5.110401084687974,5.365455229414834,5.366379546456867,5.15217298997773,5.172190573480394,5.731916104422675,5.313225005732642,306450.89444444445,0,7,1,8,0,1,1,1.0,0,-2,1,-1,0,1,1
3330,5.4036851483996555,5.424059730945247,5.409254657159938,5.047559825500639,5.350089380056551,5.9477332629779776,5.497399059852751,238405.50495049506,2,E01003406,7,1,7,2,4,4,5.379904820475468,5.2793606256329735,5.5714793177538136,5.057092374147371,5.324111826198045,6.008101385693218,5.569929199163304,306685.18604651163,2,6,4,6,3,5,4,1.0,0,-1,3,-1,1,1,0
3331,5.181539260107895,5.478993327453218,5.379419974211989,5.151323782986608,5.225966355923949,5.7128843336269775,5.22963665682694,238774.49137931035,0,E01003407,8,1,9,0,0,1,5.171363262569203,5.35488869061991,5.408233149712827,5.154470865466013,5.19894615642163,5.799233254264383,5.467592025003514,307050.82352941175,0,7,1,8,1,1,3,1.0,0,-1,0,-1,1,1,2
3332,5.5151598208787425,5.406897754069195,5.502406848187478,4.877620519391749,5.454841838767197,5.942149651761087,5.52140204874885,239270.8940397351,3,E01003408,7,3,4,4,4,4,5.418612597035427,5.382630497801538,5.450411060277154,5.043058368894789,5.287321541823593,5.910476022296482,5.478331435739604,307660.2549019608,3,8,2,6,2,3,3,1.0,0,1,-1,2,-2,-1,-1
3333,5.3535690248435275,5.36978223898732,5.533033764954155,4.873246340041465,5.387626514367178,5.993019376240723,5.4740138256803474,237866.04255319148,2,E01003409,6,3,4,3,4,4,5.316054051848734,5.225155310266337,5.520431176872011,5.0516413268010325,5.2606919783695485,5.918094548450154,5.471686047353562,305979.40127388533,2,5,3,6,2,3,3,1.0,0,-1,0,2,-1,-1,-1
3334,5.33638100538935,5.361271469365983,5.461571860881079,5.045817345380783,5.31392246059009,5.9675459152176265,5.50070845371201,238680.58333333334,1,E01003410,6,2,7,1,4,4,5.364204761561226,5.260595603550182,5.583246665842393,5.024437929602231,5.340583363701316,6.03557069161359,5.580660365609562,306951.8588235294,2,5,4,6,3,6,5,1.0,1,-1,2,-1,2,2,1
3335,5.456996452498745,5.369334429115444,5.46546729199298,5.014746772004412,5.400285845453089,5.978198449332993,5.318176531172418,235925.0779220779,3,E01003411,6,2,7,3,4,1,5.253803507593654,5.303825650439166,5.430460085004768,5.063403781628448,5.237582365138419,5.9210184308506495,5.393237575588611,303361.38255033555,1,6,2,7,1,4,2,1.0,-2,0,0,0,-2,0,1
3336,5.470036971725915,5.449124023318291,5.449265136530525,5.017634665495471,5.444723308086395,5.924635131108134,5.35560646025758,236398.26315789475,3,E01003412,8,2,7,4,3,2,5.412378903203362,5.394875999265069,5.473978593845495,5.064931475876162,5.323952959687918,5.955067404164564,5.2877742828138725,304062.61744966445,3,8,2,7,3,4,0,1.0,0,0,0,0,-1,1,-2
3337,5.293191626562295,5.416587084743148,5.5182435850725104,5.124237232174433,5.3817085864696095,5.946150348541584,5.46658851068916,234078.95744680852,1,E01003413,7,3,8,2,4,4,5.291810083228189,5.2572213435495225,5.580882649969411,5.115794071474591,5.268545559934668,5.932383442247236,5.461044175399317,300997.2297297297,1,5,4,7,2,4,3,1.0,0,-2,1,-1,0,0,-1
3338,5.4340970206395385,5.332761354365592,5.583111059867729,5.0917979640475775,5.381446850501884,6.013628758953116,5.395547724039541,234327.8757062147,2,E01003414,6,4,8,2,5,2,5.242660635156058,5.265361972845318,5.594956637731666,5.176883260409038,5.268557818209539,6.017757824861286,5.660633708609909,301128.92349726777,1,6,4,8,2,5,6,1.0,-1,0,0,0,0,0,4
3339,5.5434758531765675,5.285387342370401,5.653391960098988,5.018551662212282,5.447425326024454,6.074326368767445,5.39865796960245,235097.41732283463,4,E01003415,5,5,7,4,6,2,5.38058640991432,5.21532716612885,5.628287089043769,5.14195211901181,5.236069803652556,6.065012207929639,5.497654685939568,302223.44202898553,2,5,5,8,1,6,3,1.0,-2,0,0,1,-3,0,1
3340,5.499413554261371,5.280925066732779,5.58595914957,5.06232684269184,5.436018804224526,6.05812471959649,5.415009815518449,236560.13414634147,3,E01003416,5,4,8,3,6,3,5.259784550551909,5.280293107032776,5.575227845145996,5.0999950795288544,5.313896366630692,5.956297462963196,5.405595600605011,304310.6686746988,1,6,4,7,3,4,2,1.0,-2,1,0,-1,0,-2,-1
3341,5.720430989381744,5.246007859997633,5.647332656674269,4.887424445733791,5.614161464644641,6.102152845917678,5.659678087001893,250294.88292682928,6,E01003417,4,5,5,8,6,7,5.542971389281317,5.2675930317201765,5.572526237507558,5.068520364366047,5.439381262799001,5.993671567946518,5.622812261853193,322011.1968911917,5,6,4,7,6,5,5,1.0,-1,2,-1,2,-2,-1,-2
3342,5.642794224849114,5.242667700694158,5.688757507617657,4.901251761729901,5.6383742479177625,6.147285921757038,5.691070401668549,250540.37692307692,5,E01003418,4,6,5,8,7,7,5.57061416387558,5.115882408618927,5.652751379013061,5.022668300469716,5.450344769159953,6.0442756684621175,5.725944126447041,322331.41333333333,5,3,5,6,6,6,7,1.0,0,-1,-1,1,-2,-1,0
3343,5.526346781674554,5.35237126936887,5.51305191784619,4.919192048955091,5.520737841167552,6.001792277881806,5.5400605341967415,250222.4064171123,3,E01003419,6,3,5,6,5,5,5.404431167805549,5.317274250016354,5.496368985955078,5.077761136069157,5.336149646504091,5.883240829599966,5.603294566126153,321972.8316831683,3,6,3,7,3,3,5,1.0,0,0,0,2,-3,-2,0
3344,5.687534412011406,5.156719807757447,5.7737035088191755,4.896000678965588,5.586291587905379,6.166115801855429,5.674794444974685,251017.17880794703,5,E01003420,3,7,5,7,7,7,5.475496341387431,4.99801811615626,5.6299154742558795,5.150349955558777,5.392297809123993,6.032215719223022,5.6517073718706765,323065.7866666667,4,1,5,8,5,6,6,1.0,-1,-2,-2,3,-2,-1,-1
3345,5.5363616943359375,5.3455830677181275,5.6054140151815215,4.942702240977727,5.541438488250083,6.0959105593092895,5.530097162469905,249269.3120567376,4,E01003421,6,4,6,6,6,5,5.583996988259829,5.2159501275955105,5.659195929001539,4.989690303038328,5.565541501228626,6.206968313608414,5.719450904772832,320501.5256410256,5,5,6,5,9,8,7,1.0,1,-1,2,-1,3,2,2
3346,5.590317038175102,5.2745220182097965,5.547100385772848,5.040577612747656,5.529877099478356,6.036132614189219,5.643340487346471,249808.4906542056,4,E01003422,5,4,7,6,5,6,5.4701207882256675,5.294883551936464,5.513744286474237,5.106963209694412,5.4323306368087145,6.029507584983322,5.698460995243286,321294.86294416245,4,6,3,7,6,6,7,1.0,0,1,-1,0,0,1,1
3347,6.114682951911551,5.023395969242346,5.9083522206447165,4.632576919969965,5.562312589317072,6.319013914123911,5.807882961679677,245985.9344262295,9,E01003423,1,8,0,7,9,8,5.98784729468921,4.916731528014191,5.9285510473014895,4.698930967937816,5.552528100565445,6.282584377556793,5.802574320272966,316357.12396694213,9,1,9,0,8,9,8,1.0,0,0,1,0,1,0,0
3348,6.191477721078055,5.124207765715463,5.871322056906564,4.570567090170724,5.821079725537981,6.310985201426915,5.85663660117558,244462.6857142857,9,E01003424,2,8,0,9,9,9,5.989318462065708,5.119273583830139,5.833475254200123,4.666773574587739,5.766292460170793,6.391605803995956,5.992918601742497,314318.4691358025,9,3,8,0,9,9,9,1.0,0,1,0,0,0,0,0
3349,6.019146917856228,5.113938097368207,5.89441596555431,4.662173508203518,5.717636390736229,6.391426312296014,5.8475497061746164,245208.04678362573,8,E01003425,2,8,1,9,9,9,5.927178442148873,5.061394398383673,5.849728390656782,4.754977509461714,5.643809056413766,6.4352561597666025,5.98683619960237,315310.453038674,9,2,8,1,9,9,9,1.0,1,0,0,0,0,0,0
3350,5.756288248736684,5.291771626472473,5.6788624606481415,4.83734616942522,5.606927232044499,6.134798716335762,5.7310908974670784,244021.4243902439,6,E01003426,5,6,4,7,7,8,5.666859993680578,5.2013175824626545,5.669109499845349,4.818594656518249,5.572099583559349,6.171115066184372,5.8624084313384826,313733.68852459016,6,4,6,2,9,8,9,1.0,0,-1,0,-2,2,1,1
3351,5.407026038979584,5.389552899689044,5.481751769781113,5.080387204323175,5.357865636078817,5.860096813372846,5.42906370590318,245697.820754717,2,E01003427,7,2,8,2,2,3,5.411305327687347,5.205835395737698,5.4736850669509485,5.07356485985873,5.279277630542454,5.924687359416694,5.584406025577009,315833.5350877193,3,4,2,7,2,4,5,1.0,1,-3,0,-1,0,2,2
3352,6.312433782665209,5.088779646774818,5.82144540068747,4.511486906429817,5.869942918591116,6.274171320871375,5.8855663209125915,245105.36781609195,9,E01003428,2,8,0,9,8,9,6.169451298172941,5.084148144599089,5.785464982396548,4.5181001596844075,5.713469749258966,6.239184718771079,5.939215092929368,315146.6082474227,9,3,7,0,9,9,9,1.0,0,1,-1,0,0,1,0
3353,5.532043956762908,5.144728412691331,5.677208973871951,4.967167381419252,5.492485248489885,6.151737183135077,5.4340261884083025,235604.2119205298,3,E01003429,3,6,6,5,7,3,5.254591540414459,5.09171624937836,5.533600157620955,5.080621168321493,5.308278280861524,6.0445729396781145,5.525802359289052,302253.47959183675,1,3,3,7,3,6,4,1.0,-2,0,-3,1,-2,-1,1
3354,4.96088890620132,5.682157411504147,5.146383485687313,5.275655379046255,5.086921363624175,5.452072115976419,4.785159619886484,234083.70895522388,0,E01003430,9,0,9,0,0,0,4.983009567131868,5.506055169277363,5.206436426789911,5.210602423092267,4.981643901214944,5.4655283528405265,5.009506203032829,300742.30630630633,0,9,0,9,0,0,0,1.0,0,0,0,0,0,0,0
3355,5.203384388839045,5.416994939888677,5.445134885849491,5.1352708868442045,5.315464767717546,5.760663158470584,5.2336873556337045,234078.00806451612,0,E01003431,7,2,8,1,1,1,5.123095356432119,5.364650505825989,5.371267799147986,5.232094036905389,5.169282675685739,5.695466211863926,5.221969591047531,300788.0902255639,0,7,1,9,0,0,0,1.0,0,0,-1,1,-1,-1,-1
3356,5.586914607292212,5.409621283052048,5.352008355988397,4.942986359918751,5.405661925601499,5.9321181255838145,5.456317960928028,236030.99033816427,4,E01003432,7,1,6,3,3,3,5.571805507758928,5.319959383844678,5.3301826083594985,5.021133263254426,5.283574019624887,5.970609004380273,5.57795796042583,303051.0,5,7,1,6,2,5,5,1.0,1,0,0,0,-1,2,2
3357,5.354333773971124,5.273233669814064,5.432147121325331,5.081103006825177,5.31918328662106,5.891852333035532,5.30322827730637,235110.8864628821,2,E01003433,5,2,8,1,3,1,5.246502840960467,5.198968317283033,5.428372723084909,5.2205709812572465,5.135346660398161,5.833317946995237,5.435042415626746,302172.68724279833,1,4,2,9,0,2,2,1.0,-1,-1,0,1,-1,-1,1
3358,5.60624728173566,5.211893303262675,5.623736320829099,4.848863450296086,5.5290601692316725,6.170378001921016,5.444206922332202,238766.20245398773,4,E01003434,4,5,4,6,7,3,5.30129718295927,5.1972404204733005,5.442634205508038,5.148616941963754,5.169284777912667,5.998930438747251,5.55966565570211,307173.65040650405,2,4,2,8,0,5,4,1.0,-2,0,-3,4,-6,-2,1
3359,5.699055522296562,5.454353726472977,5.218491180260294,4.912865360407358,5.3975393726078735,5.842274889925519,5.328927184379152,239781.330472103,5,E01003435,8,0,5,3,2,1,5.688823543393049,5.412314791536127,5.291301917108855,4.974703264850404,5.410480446058282,5.893651654280307,5.359825175207572,308465.4248927039,6,8,0,5,5,3,1,1.0,1,0,0,0,2,1,0
3360,5.780298952261607,5.519147133827209,5.334876521428426,4.823143249352773,5.457369709014893,6.056226727167766,5.568923237323761,241528.62,6,E01003436,8,1,3,4,6,5,5.654977633242021,5.461198437632176,5.368033494865685,4.975170099944399,5.403316657794149,6.000235287766707,5.730961943927564,310523.7368421053,6,8,1,5,5,5,7,1.0,0,0,0,2,1,-1,2
3361,5.6817915467589115,5.370168974701787,5.548178217220754,4.878029550185226,5.5336796006126585,6.01682894106762,5.598589571988638,241164.6807511737,5,E01003437,6,4,4,6,5,6,5.55990500299676,5.289658183611713,5.522944346214961,5.002374930289185,5.438843780929602,6.09570341087082,5.771630159280832,310083.97572815535,5,6,3,5,6,7,8,1.0,0,0,-1,1,0,2,2
3362,5.641493208152204,5.508956563374228,5.4235646823221,4.878196225678625,5.395673287801506,5.970900653807585,5.544601107431838,242113.85950413224,5,E01003438,8,2,4,3,4,5,5.397596519081681,5.349132158138134,5.424942986170451,5.060084397704513,5.2330904669231835,6.005358425776164,5.623579810283802,311241.5925925926,3,7,2,6,1,5,6,1.0,-2,-1,0,2,-2,1,1
3363,5.578302835340554,5.392744779586792,5.522301312893798,4.945149355689011,5.453431862222272,5.987865097778665,5.516091544749373,242698.87005649717,4,E01003439,7,3,6,4,4,4,5.55700066941125,5.379158138093494,5.477132563363938,4.971585669971648,5.390472673802149,5.999661463782901,5.586159215654646,312056.6476190476,5,8,2,5,5,5,5,1.0,1,1,-1,-1,1,1,1
3364,5.5756710857325205,5.378184208980185,5.4622762947413275,4.953209306463341,5.442716601956097,5.952580617342381,5.478119609672899,240600.40462427746,4,E01003440,6,2,6,4,4,4,5.395090639591217,5.379451234450285,5.480730889172389,5.08228115377755,5.262651751781332,5.896338912262314,5.5116305577343905,309316.7183908046,3,8,2,7,2,3,3,1.0,-1,2,0,1,-2,-1,-1
3365,5.376211006093669,5.46313565163999,5.467277191780709,5.012951784037255,5.274625489035168,5.931565558588183,5.296292309825485,240544.51351351352,2,E01003441,8,2,7,1,3,1,5.300048515714448,5.3344794996853535,5.50461996670427,5.068684247444416,5.177319955825806,5.879464188937483,5.3434544333096206,309280.66896551725,1,7,3,7,1,3,1,1.0,-1,-1,1,0,0,0,0
3366,6.160896547138691,5.145799665153026,5.70188273191452,4.60266869738698,5.758426941931248,6.107148848474026,5.728152529895306,246706.4375,9,E01003442,3,6,0,9,6,8,5.83600102294059,5.20926425073828,5.599317334947132,4.826689969925654,5.5428650577863054,6.062964552215168,5.726535007357597,317275.4464285714,8,5,4,2,8,6,7,1.0,-1,2,-2,2,-1,0,-1
3367,6.046878379444744,5.187485500130543,5.82023803993713,4.743852955657382,5.646817955859872,6.195084922535475,5.8858410542787505,247708.22093023255,9,E01003443,3,7,2,8,8,9,5.962810012698173,5.125561287254095,5.783308106660843,4.757202865183354,5.566750651597976,6.248579306900501,5.96347489207983,318470.5875,9,3,7,1,9,9,9,1.0,0,0,0,-1,1,1,0
3368,6.026556781666008,5.290493377668415,5.696138035037561,4.694443766942281,5.655768403036152,6.225645006773714,5.745718116531829,173704.28143712576,8,E01003444,5,6,1,8,8,8,5.860772484227231,5.194872658503683,5.676059106776589,4.801018925089585,5.632565019005224,6.137881748927267,5.754141384676883,241635.16315789474,8,4,6,1,9,8,8,1.0,0,-1,0,0,1,0,0
3369,5.762487037471994,5.44505611550871,5.544329056664119,4.895696225620451,5.478613946172926,5.982374779131047,5.557527474625401,26187.248677248677,6,E01003445,7,3,5,5,4,5,5.694451489851843,5.354831356907365,5.531089939288239,4.97403237653609,5.4453966172773445,6.030840392136455,5.614354951464715,33330.2736318408,6,7,3,5,6,6,5,1.0,0,0,0,0,1,2,0
3370,5.581197599321603,5.246214497089386,5.674544067680836,4.894859706610442,5.463211192190647,6.003072595596313,5.49837663769722,248450.35,4,E01003446,4,6,5,4,5,4,5.446121996802253,5.12099113399918,5.58168694844117,5.015001204207137,5.389602736524633,5.9212073094136,5.4436067987132715,319557.7297297297,3,3,4,6,5,4,2,1.0,-1,-1,-2,1,1,-1,-2
3371,5.160102209559193,5.712545932994948,5.001097808833475,5.254122783740361,5.097888851607287,5.479096223910649,5.015251568622059,89872.66203703704,0,E01003447,9,0,9,0,0,0,5.291269796379542,5.616793522390268,5.005435211678683,5.244507483506607,5.110092345940864,5.59264364080914,5.209011670391439,107466.86016949153,1,9,0,9,0,0,0,1.0,1,0,0,0,0,0,0
3372,5.7697167581653,5.420297882571724,5.530117347373725,4.89699980116779,5.518463935170855,6.080392338474344,5.54536351357928,245284.3602484472,6,E01003448,7,3,5,6,6,5,5.712235595403093,5.290453056940872,5.533506100097399,4.874071235737104,5.445840962147445,6.150977970509047,5.71682666325837,315602.0168539326,7,6,3,3,6,8,7,1.0,1,-1,0,-2,0,2,2
3373,5.669725207887458,5.31750015182608,5.567583446671977,4.934760150824778,5.466713235223081,6.070505912487324,5.559334668182057,249207.08875739644,5,E01003449,5,4,5,4,6,5,5.597554036756841,5.239322444287742,5.599891588455293,4.973144523254255,5.352984310650244,6.044446703864307,5.617893005289683,320445.6646341463,5,5,4,5,4,6,5,1.0,0,0,0,0,0,0,0
3374,5.755400983910811,5.4082647326745485,5.46592317443145,4.928914884203358,5.488748599039881,6.086610052146409,5.522759470500444,249892.4605263158,6,E01003450,7,2,5,5,6,4,5.561415530789283,5.327222814098481,5.435803779478996,4.990269967817491,5.38303039381581,6.001148362313548,5.5730930451423895,321713.91612903227,5,7,2,5,5,5,5,1.0,-1,0,0,0,0,-1,1
3375,5.700643249750137,5.355964422225952,5.5380630022287365,4.831528868675232,5.577328750491143,6.141073205471039,5.601548591852188,249851.18,5,E01003451,6,3,4,7,7,6,5.632659879246273,5.187151684632172,5.525023564776859,4.910951308301978,5.423801373791051,6.071522103773581,5.604114246368408,321321.91891891893,6,4,3,3,6,7,5,1.0,1,-2,0,-1,-1,0,-1
3376,5.7026352782115755,5.5085170185454535,5.454276055933159,4.937406162792277,5.451824893461209,5.922097229511938,5.418388440787235,249512.8831775701,5,E01003452,8,2,6,4,3,3,5.651131198869497,5.324598100513079,5.4105883848045675,4.962859444708621,5.350568137462671,5.982950290797446,5.606928432722227,320969.5308056872,6,7,1,4,4,5,5,1.0,1,-1,-1,-2,0,2,2
3377,5.5864272019902215,5.350978142902499,5.601372654320763,4.917784370359827,5.486825678192202,6.114649108198822,5.59021978690976,245283.87704918033,4,E01003453,6,4,5,5,7,6,5.555718107149005,5.264734031632543,5.490222970023751,5.009369974955916,5.416265336796641,6.122613377869129,5.712028787471354,315378.96875,5,6,2,6,5,7,7,1.0,1,0,-2,1,0,0,1
3378,6.268142365492308,5.049786791205406,5.920398730498094,4.607297238249045,5.798829420254781,6.422244246189411,5.998638631059573,102394.50961538461,9,E01003454,1,8,0,9,9,9,6.15571547689892,4.97008924143655,5.901599945340838,4.654362342471168,5.632330735524495,6.380745983123779,6.06612606048584,130641.72380952381,9,1,9,0,9,9,9,1.0,0,0,1,0,0,0,0
3379,5.70917330733661,5.322218615433266,5.553336959460686,4.793313030538888,5.379787286807751,6.004575472453545,5.506874103998316,100279.7672413793,6,E01003455,6,4,3,2,5,4,5.604783185174532,5.368386216252763,5.365697630097933,4.877925079559612,5.325853597337955,5.9382757382972216,5.513123641504306,128127.98130841121,5,7,1,3,3,4,3,1.0,-1,1,-3,0,1,-1,-1
3380,5.92251871628304,5.008099316734157,5.891700349441947,4.64431167547017,5.704782812562708,6.262162104044875,5.856870591640472,102756.22602739726,8,E01003456,1,8,0,9,8,9,5.8122681090786195,5.067210170873411,5.821842179936208,4.845200985100619,5.555269993794192,6.174538045931774,5.746325561195422,131060.19108280254,8,2,8,2,8,8,8,1.0,0,1,0,2,-1,0,-1
3381,6.155832165419453,5.051056841407159,6.122725038817435,4.467044202968328,5.733265965875953,6.613732711233274,5.899643428397901,102592.78787878787,9,E01003457,1,9,0,9,9,9,5.807965504435392,4.9324085884369335,5.824640122743753,4.746421628273451,5.573251017011129,6.3339868027430315,5.727356757108982,130835.24038461539,8,1,8,1,9,9,7,1.0,-1,0,-1,1,0,0,-2
3382,5.810365073315732,5.099278402758074,5.869545902217831,4.679310001768507,5.564517199456155,6.305795837093044,5.671766574318345,101429.05405405405,7,E01003458,2,8,1,7,9,7,5.639581203460693,5.025304388999939,5.7564506451288855,4.844704064726829,5.4465089778105416,6.151256247361501,5.662430300315221,129409.725,6,2,7,2,6,8,6,1.0,-1,0,-1,1,-1,-1,-1
3383,5.621502935451312,5.2691226658159795,5.612842956598658,4.850705358233765,5.439443074873764,6.109229535081961,5.534505456903555,102051.22627737226,5,E01003459,5,5,4,4,6,5,5.454597688522659,5.2140571630301595,5.587606452092403,4.9673937989884065,5.346524110361307,6.062879129618156,5.582252223952477,130251.64705882352,3,5,4,5,4,6,5,1.0,-2,0,-1,1,0,0,0
3384,6.063225192832468,5.415145908979545,5.37854938817801,4.746574374667385,5.624151450948309,5.944069419588361,5.424339626666,101255.61152882206,9,E01003460,7,1,2,8,4,3,6.050598871900633,5.3672578321042845,5.41103506418629,4.782881973522089,5.567336949685429,5.981415151173193,5.514851128807244,128535.85681293302,9,7,1,1,9,5,3,1.0,0,0,0,-1,1,1,0
3385,5.904133514871875,5.0907089663940726,5.718335788226822,4.7622870964911375,5.656559927949628,6.08882907756324,5.759021784495381,100203.8640776699,8,E01003461,2,6,2,8,6,8,5.790087569591611,5.0994860820992045,5.674202482644902,4.791744747827219,5.507001589065374,6.081807962683744,5.770221840503604,127683.51627906977,7,3,6,1,8,7,8,1.0,-1,1,0,-1,0,1,0
3386,5.999105938925193,5.287578935233446,5.565042531261077,4.687985963546312,5.633029115887789,6.0842261623877745,5.738776837977079,165221.0673076923,8,E01003462,5,4,1,8,6,8,5.82742800052501,5.315043816881731,5.553272300022693,4.765398492005246,5.55004577942131,6.065738466652957,5.680381353729027,226453.79752066114,8,6,4,1,8,6,7,1.0,0,1,0,0,0,0,-1
3387,6.0968482406799405,5.273805051200134,5.691396749625771,4.622503094080478,5.724466994657355,6.247157051064874,5.8371650054629916,24241.20338983051,9,E01003463,5,6,0,9,8,9,5.879959988182988,5.260177578049144,5.589264786106416,4.80447426335565,5.554446055971343,6.1306445667113385,5.670980143135991,26600.591954022988,8,5,4,1,8,8,6,1.0,-1,0,-2,1,-1,0,-3
3388,5.975049193365028,5.371498611677124,5.382505624409181,4.730599033545299,5.737856292580983,5.9099821308291105,5.57045338634985,96369.24096385542,8,E01003464,6,1,2,9,3,5,5.937246978621591,5.360217690806497,5.419433834539219,4.8311055641282685,5.573863456872377,5.923896933143789,5.556183862415227,123137.25852272728,9,7,1,2,9,4,4,1.0,1,1,0,0,0,1,-1
3389,6.053303328582219,5.23918074795178,5.5525197148323056,4.615153304168156,5.735042071342468,6.035434670107705,5.772841693673815,95910.93214285714,9,E01003465,4,4,0,9,5,8,6.011455671373769,5.266343934069701,5.553320860950709,4.710920301750577,5.607719000855055,6.050869006512349,5.703041642354424,122943.70110701107,9,6,4,0,9,6,7,1.0,0,2,0,0,0,1,-1
3390,5.754564734329855,5.293767173487441,5.814173556808242,4.759069856844451,5.653391924119534,6.249522630433391,5.697214893828657,248601.27819548873,6,E01003466,5,7,2,8,8,7,5.548201497816882,5.213853808428278,5.674016191469913,5.00471921630253,5.527780610204532,6.164177829856115,5.663089475884343,319514.821192053,5,5,6,5,8,8,6,1.0,-1,0,-1,3,0,0,-1
3391,5.894328682510941,5.312063108550178,5.706289699342515,4.71080246148286,5.712597975907502,6.228965393702189,5.686120100374575,248042.88148148148,7,E01003467,5,6,1,9,8,7,5.82851142912918,5.188552578043494,5.719776418638525,4.827578754898925,5.599553888628942,6.266170925235156,5.885153865221865,319037.73913043475,8,4,7,2,9,9,9,1.0,1,-1,1,1,0,1,2
3392,5.793124602121465,5.214950955965939,5.771155138226116,4.764797315878027,5.5767803086954,6.3202740252017975,5.661107519093682,220438.66176470587,7,E01003468,4,7,2,7,9,7,5.622418535574702,5.096130549452687,5.706782121694725,4.868136622523534,5.47361458166865,6.223666809897386,5.782593582422678,262975.213740458,6,3,6,3,7,9,8,1.0,-1,-1,-1,1,0,0,1
3393,5.1932639502129465,5.5541884100662084,5.331874256988741,5.223573417596097,5.223607701513003,5.756518861032882,5.28061839600779,12167.16037735849,0,E01003469,9,1,9,0,1,1,5.127797913448564,5.476834645045215,5.218087918799499,5.34765676794381,5.1182584844786545,5.742902693563495,5.299571187845592,15871.702586206897,0,9,0,9,0,1,0,1.0,0,0,-1,0,0,0,-1
3394,5.3330730823370125,5.364074763884911,5.5355865307343315,5.011878304603773,5.334873326008136,5.978806580030001,5.437612946216877,30302.189743589744,1,E01003470,6,3,7,2,4,3,5.271798981985914,5.331864052409426,5.415402049318366,5.150993337871832,5.156191031867211,5.897335448396316,5.48503913299753,43577.908256880735,1,7,1,8,0,3,3,1.0,0,1,-2,1,-2,-1,0
3395,5.828998199428421,5.305420420974134,5.58811066093215,4.81815090093268,5.630835675331483,6.166939327515752,5.726150881095105,245781.93373493975,7,E01003471,5,4,3,8,7,8,5.633286446868302,5.2209977325565085,5.542104726779961,4.940925062059642,5.41649751891633,6.0698205139822585,5.573749565792655,306926.1017964072,6,5,3,4,5,7,5,1.0,-1,0,-1,1,-3,0,-3
3396,6.549071585690534,4.6781468803499955,6.242780232135161,4.293085742879797,5.794503797719508,6.844527918615459,6.141780973952494,97228.92592592593,9,E01003472,0,9,0,9,9,9,6.271535671071002,4.646314302557393,6.110839442202919,4.349035565790377,5.600288089952971,6.652876308089809,6.081314681391967,124467.1447368421,9,0,9,0,9,9,9,1.0,0,0,0,0,0,0,0
3397,6.16020412374251,4.879304019531401,6.0233878570027874,4.587286238623138,5.635264814490139,6.4296398375293995,5.888485890803951,98082.0495049505,9,E01003473,0,9,0,8,9,9,5.924531710775275,4.811419149239858,5.900080618105437,4.670569050730321,5.502794119349697,6.361515195746171,5.846670803270842,125301.77192982456,9,0,9,0,7,9,9,1.0,0,0,0,0,-1,0,0
3398,6.198109662020078,5.22345612318285,5.659424567735323,4.62772116609799,5.7476823163288895,6.220190753218948,5.899163101309089,98115.60752688172,9,E01003474,4,5,0,9,8,9,6.073300289536665,5.204688484797221,5.602372100967133,4.714244869654764,5.622343197554171,6.144610811850268,5.9157877839254045,125450.5508982036,9,4,4,0,9,8,9,1.0,0,0,-1,0,0,0,0
3399,5.2411678931147785,5.449524453415494,5.320309121993809,5.157902108434959,5.256586483254056,5.722308523056843,5.193674815069769,96677.2439862543,1,E01003475,8,1,9,0,1,0,5.203967751928679,5.365133080102993,5.3534887364991395,5.158513432143057,5.150928948989789,5.718665949613578,5.30426166379328,123793.31141868512,1,7,1,8,0,0,1,1.0,0,-1,0,-1,0,-1,1
3400,5.9393512678146365,5.214950966835022,5.7836404180526735,4.730172139406204,5.5807408940792085,6.203386144638062,5.687508962154388,99272.79,8,E01003476,4,7,2,7,8,7,5.903441159771039,5.025413779112009,5.909699646326212,4.706293907303077,5.546286753737009,6.2438801916746,5.75677685210338,126757.20192307692,8,2,9,0,8,9,8,1.0,0,-2,2,-2,1,1,1
3401,5.976406931877136,5.030337209502856,5.916346025466919,4.591120905677477,5.624502518773079,6.355942602952322,5.74006926715374,101279.725,8,E01003477,1,8,0,8,9,8,5.900318921543658,4.9935567090287805,5.813896732404828,4.681627407670021,5.502558058127761,6.275045642629266,5.849322429858148,128720.8828125,8,1,8,0,7,9,9,1.0,0,0,0,0,-1,0,1
3402,5.636137994222863,5.153164406155431,5.736574403075284,4.906619809394659,5.462487667105918,6.11160033664038,5.50790369926497,96481.83139534884,5,E01003478,3,6,5,4,7,4,5.370746293972278,5.117650571225703,5.610710586624584,4.991654246702962,5.25066012349622,6.003062923749288,5.568752110004425,123552.47126436782,2,3,5,5,2,5,4,1.0,-3,0,-1,0,-2,-2,0
3403,5.712223521145908,5.402675225517966,5.402146462960677,4.828951842134649,5.39747692454945,5.930644746260209,5.3612572258169005,501281.4727272727,6,E01003479,7,1,3,3,3,2,5.761884685957207,5.273621481544566,5.45831336502759,4.89788750769957,5.4757110476493835,6.06375478348642,5.526180292075535,639788.6132075472,7,6,2,3,7,6,4,1.0,1,-1,1,0,4,3,2
3404,5.38570386838913,5.67598610496521,5.065585523605347,5.155591987133026,5.146471011161804,5.644187945365906,5.108791265964508,377480.616,2,E01003480,9,0,9,0,0,0,5.6186959665008045,5.565589410777935,5.20198835266961,5.105484985520319,5.220810862725655,5.818723508850537,5.339423853674052,492383.2263374486,5,9,0,7,1,2,1,1.0,3,0,0,-2,1,2,1
3405,5.395523760832992,5.78196185242896,5.0564022213804956,5.132495154119005,5.110018384690378,5.5691289700713815,5.132380397179547,493852.24705882353,2,E01003481,9,0,8,0,0,0,5.515981511112482,5.677228543395003,5.104135373267986,5.1072574078371975,5.173663157955865,5.696770631247737,5.308685203910317,629896.9219330855,4,9,0,7,0,0,1,1.0,2,0,0,-1,0,0,1
3406,5.062610867630196,5.853162269011193,4.794446532729136,5.39837861246248,4.978622687048097,5.3647102289872075,4.880887919999081,261245.04301075268,0,E01003482,9,0,9,0,0,0,5.312121465771967,5.6555018191647095,5.002836436819111,5.246172838109502,5.084634735666472,5.614321873952119,5.105109350192861,338608.66125760647,2,9,0,9,0,0,0,1.0,2,0,0,0,0,0,0
3407,5.384981107543892,5.556801646528109,5.215972295949157,5.113984007230947,5.156608121495851,5.667952116106598,5.1816587783920935,505608.71830985916,2,E01003483,9,0,8,0,0,0,5.46522116885995,5.438307067133346,5.291310313362746,5.124479442272547,5.225729845604807,5.895385869643973,5.484303625124805,646110.4528301887,4,8,0,8,1,3,3,1.0,2,-1,0,0,1,3,3
3408,5.620299190556238,5.229765054282792,5.493601532157408,4.896202264575783,5.418169447041433,5.980183478889115,5.549900208044489,497187.6422018349,5,E01003484,4,3,5,3,4,5,5.617290762521453,5.187007412061853,5.5418919213747575,4.953329536874415,5.4411096906257885,6.048002299615892,5.6684245204521435,635693.9491525424,5,4,3,4,6,6,6,1.0,0,0,0,-1,3,2,1
3409,5.755558971817612,5.308611034501529,5.480754434639681,4.789103421759098,5.533074089821349,6.032992484721731,5.510875925104669,507234.56028368796,6,E01003485,5,2,3,6,5,4,5.809404602886117,5.152853133904673,5.538734136706721,4.85131717337309,5.499053159769434,6.115632878602856,5.670544693939878,647588.6861313869,8,4,3,2,7,7,6,1.0,2,-1,1,-1,1,2,2
3410,5.465638024979327,5.540661609316447,5.244027119085013,5.03730792094426,5.217571094811681,5.705121561705348,5.154583541743727,488582.9457831325,3,E01003486,9,0,7,0,0,0,5.620310126453318,5.483141383176209,5.31126078354415,5.0249731418907,5.208482625023011,5.881529731135214,5.323647442684378,625834.1075268817,6,9,0,6,1,3,1,1.0,3,0,0,-1,1,3,1
3411,5.320201056674846,5.437460297519721,5.346714883174711,5.083436376840165,5.214922717474039,5.682969125729163,5.147112539670999,289483.1941747573,1,E01003487,7,1,8,0,0,0,5.515272881470475,5.343537179862752,5.418812366092906,5.0209689666243165,5.3118710529570485,5.846839984258016,5.339867536928139,338326.8137254902,4,7,1,6,3,2,1,1.0,3,0,0,-2,3,2,1
3412,5.334267424685614,5.352457571597326,5.504595112232935,5.106310161806288,5.319552814676648,5.810430594852993,5.300282857247761,504296.5833333333,1,E01003488,6,3,8,1,2,1,5.358509109866235,5.309331893920898,5.487841652285669,5.186757804245077,5.220700125540456,5.815752057618992,5.440972905005178,644259.9784946237,2,6,2,8,1,2,2,1.0,1,0,-1,0,0,0,1
3413,5.388694930350644,5.208502803725758,5.544173194074083,5.072350952817105,5.352332052143141,5.876442377594696,5.358876902481605,504296.6436781609,2,E01003489,4,3,8,2,2,2,5.354406540534075,5.12888813159045,5.628313120673685,5.11825549883001,5.236613145996542,5.7774999141693115,5.409924026096569,644285.2352941176,2,3,5,7,1,1,2,1.0,0,-1,2,-1,-1,-1,0
3414,5.522553721640972,5.103612613170705,5.63874988099362,4.854520982884346,5.437143029050624,5.945210860130635,5.380425871686732,504143.2021276596,3,E01003490,2,5,4,4,4,2,5.415431303539496,5.1639514092741345,5.683817879907016,5.076248464913204,5.214600934379402,5.885789282020482,5.518602067026599,644151.448275862,3,4,6,7,1,3,4,1.0,0,2,1,3,-3,-1,2
3415,5.380967181138318,5.181379722826408,5.583567155732049,5.1020257930562956,5.301687624719408,5.84274302347742,5.358072383235199,504527.8484848485,2,E01003491,3,4,8,1,2,2,5.301081069954881,5.165958351917095,5.554482236638799,5.146683228982462,5.135890153077272,5.7394796846149205,5.270355110769874,644481.4954954955,2,4,4,8,0,1,0,1.0,0,1,0,0,-1,-1,-2
3416,5.7102110265176504,4.93054154402093,6.00246295446082,4.724525809288025,5.440023820611495,6.227187159695203,5.658452067194106,505537.11392405065,6,E01003492,0,9,1,4,8,7,5.660403050006704,4.838076326441257,5.912018012493215,4.933478212102931,5.272748644047595,6.069086455284281,5.764148899849425,645672.1702127659,6,0,9,4,2,7,8,1.0,0,0,0,3,-2,-1,1
3417,5.388353219399085,5.134838849764604,5.77713711811946,4.926074806543497,5.360774207115173,6.003053538615887,5.408020933774801,505264.6461538462,2,E01003493,3,7,5,2,5,3,5.311431585825407,4.99300194978714,5.687104390217708,5.036402194316571,5.174486862696134,5.908196305311643,5.491556016298441,645384.9384615384,2,1,6,6,0,3,3,1.0,0,-2,-1,1,-2,-2,0
3418,5.806135297885963,4.940799631178379,6.000978156924248,4.656571261584759,5.4868127171482355,6.260674472366061,5.718441404402256,506132.1785714286,7,E01003494,0,9,1,5,8,7,5.684780451486695,4.907442621464999,6.004564127832089,4.790339143771045,5.357095432731341,6.12517005317616,5.761854180749857,646369.0849056604,6,1,9,1,4,7,8,1.0,-1,1,0,0,-1,-1,1
3419,5.969770758492606,4.8152804681233,6.0867283798399425,4.504460106577192,5.532811160314651,6.451438783463978,5.823114170346941,506197.06666666665,8,E01003495,0,9,0,6,9,9,6.04384167989095,4.791115133850663,6.066213214838946,4.663330574830373,5.527152838530363,6.442117267184788,5.933669130007426,646461.2685185185,9,0,9,0,8,9,9,1.0,1,0,0,0,2,0,0
3420,5.425208808694567,5.139406204223633,5.5717044489724294,4.968127976145063,5.405479005404881,5.914901648248945,5.453430094037738,517303.4142857143,2,E01003496,3,4,6,3,3,3,5.416015502568838,5.20186085314364,5.5673829252655445,5.020749937843632,5.302094678621034,5.8457682422689485,5.459920018105893,660238.3648648649,3,4,4,6,3,2,3,1.0,1,1,0,0,0,-1,0
3421,5.010825175947699,5.643229947212808,4.9960778970810376,5.350445254439326,5.056409483170586,5.41069121606097,4.926327431700237,513187.8199356913,0,E01003497,9,0,9,0,0,0,5.054827594066012,5.598048003514608,5.069254575950512,5.411731113903764,5.002991820418316,5.44020002130149,5.041349393388499,654820.2666666667,0,9,0,9,0,0,0,1.0,0,0,0,0,0,0,0
3422,5.369927416587698,5.355916038669389,5.436957203108689,5.024464724392726,5.43585963906913,5.784133315086365,5.286912807102861,507289.8189655172,2,E01003498,6,2,7,3,1,1,5.355303430557251,5.398005155563355,5.301025444030762,5.196063804626465,5.201258327484131,5.7049465112686155,5.2946492300033565,647787.728,2,8,0,9,1,0,0,1.0,0,2,-2,2,-2,-1,-1
3423,5.2214141944359085,5.394952969715513,5.499497714535943,5.115896477370427,5.253645159458292,5.629791263054157,5.187622956571908,506775.9379310345,0,E01003499,7,3,8,0,0,0,5.09725737098037,5.361142152192577,5.42264528779794,5.247083513941986,5.117513386619012,5.6133261358501105,5.225310350095989,647126.3112582781,0,7,1,9,0,0,0,1.0,0,0,-2,1,0,0,0
3424,5.295250049395155,5.534755271072536,5.250493014505667,5.16762495179509,5.20064642494039,5.69831770335057,5.1874964847121126,512744.7170542636,1,E01003500,9,0,9,0,0,0,5.263796322273485,5.5195876919861995,5.2403839600808695,5.214229206244151,5.13320902260867,5.686665910663026,5.204485456600334,654179.3863636364,1,9,0,9,0,0,0,1.0,0,0,0,0,0,0,0
3425,5.153294300510936,5.398075394386793,5.420239718291011,5.1164846933671155,5.200136084626191,5.689437177929565,5.290124653029616,507540.95620437956,0,E01003501,7,2,8,0,0,1,5.166983440004546,5.379840951130308,5.3917059026915455,5.246610519803803,5.155210318236516,5.694570917918765,5.287195167870357,648057.4344827586,0,8,1,9,0,0,0,1.0,0,1,-1,1,0,0,-1
3426,5.073457016944885,5.43216393334525,5.393282707759313,5.188487223216465,5.205804994446891,5.59075213432312,5.139255305698939,510097.5085714286,0,E01003502,7,1,9,0,0,0,5.124658785760403,5.2247617550194265,5.484383811056614,5.224965839833021,5.142665286362171,5.6499014616012575,5.201257425546646,650793.275,0,5,2,9,0,0,0,1.0,0,-2,1,0,0,0,0
3427,4.800175201813906,5.552515320430528,5.147457950162572,5.365560424248904,4.994051207769785,5.53840604838946,5.005929146381403,512548.5894039735,0,E01003503,9,0,9,0,0,0,4.974616351515748,5.400145606246105,5.289593743723493,5.422803489274757,5.007652264694835,5.579083334567935,5.277980283249256,653890.0813953489,0,8,0,9,0,0,0,1.0,0,-1,0,0,0,0,0
3428,5.224968978024404,5.413660269264781,5.423991810291185,5.087644119875146,5.250227340864479,5.733777663029662,5.254352221795179,502068.46788990824,0,E01003506,7,2,8,0,1,1,5.351433671250636,5.357786536216736,5.4083593110648955,5.238117565914076,5.198462770909679,5.781315312093618,5.249606167783543,641933.5306122449,2,7,1,9,1,1,0,1.0,2,0,-1,1,1,0,-1
3429,5.2843057126193855,5.209083031524312,5.552183059128848,5.045550642849563,5.251432813607253,5.7993395947790765,5.286728406881357,507498.94155844155,1,E01003507,4,4,7,0,1,1,5.218835498551902,5.254379919489974,5.506010361437528,5.165060441449003,5.181437376160292,5.769285037082696,5.3770932408998595,647880.9748427673,1,5,3,8,1,1,1,1.0,0,1,-1,1,1,0,0
3430,5.111679146600806,5.406909010721289,5.294862383344899,5.1708930772283805,5.160115237857984,5.638663581143255,5.165522415741631,507991.0956521739,0,E01003508,7,0,9,0,0,0,5.14543483951899,5.3690270842529655,5.47892691957669,5.159539279036634,5.235804316565746,5.737391725299865,5.263287722595095,648630.3779527559,0,7,2,8,1,1,0,1.0,0,0,2,-1,1,1,0
3431,5.450484441207336,5.203508217055519,5.652543748821224,5.065174894289927,5.26572745125573,5.983883151062974,5.2872500108169005,507673.5945945946,3,E01003509,4,5,8,1,4,1,5.4649288929425754,5.164662371333848,5.586546832679684,5.033534139649481,5.238340685510228,5.962194692375314,5.4552021322087345,648153.735042735,4,4,4,6,1,4,2,1.0,1,0,-1,-2,0,0,1
3432,5.26866274517636,5.466699932896813,5.394313637600389,5.148956897646882,5.201579750970352,5.767797858216042,5.203450322151184,508840.66279069765,1,E01003511,8,1,9,0,1,0,5.357397308054659,5.2239442965419025,5.598387657981558,5.102764412299874,5.395850851363742,5.886610798000061,5.3135889977523965,649565.3195876288,2,5,4,7,5,3,1,1.0,1,-3,3,-2,5,2,1
3433,5.10701220523654,5.319624790056484,5.476509989715937,5.174414849656773,5.2652775696882115,5.793497624359731,5.092861585729704,508956.7086614173,0,E01003512,5,2,9,1,1,0,5.0403849500876206,5.355035298604232,5.429781666168799,5.2321493790699884,5.146306035151849,5.7149066686630245,5.1735659461755015,649748.4,0,7,2,9,0,0,0,1.0,0,2,0,0,-1,-1,0
3434,5.6378224495294935,5.5030842349335956,5.250822116877582,5.004516284530228,5.3845938869424765,5.8049373923121275,5.384392081080256,504219.2972972973,5,E01003513,8,0,7,2,1,2,5.674680215890327,5.396844424129103,5.323252124079106,5.03402353074562,5.343537613535612,5.840187902655898,5.390673925431721,643357.4354066986,6,8,0,6,4,2,2,1.0,1,0,0,-1,2,1,0
3435,5.334155630039913,5.5127485926433275,5.322468888375067,4.987763542000965,5.275322373195361,5.78030744162939,5.2885120555918705,509111.5376344086,1,E01003514,8,1,6,1,1,1,5.369039645734823,5.342610849524444,5.476553527814038,5.113400657221956,5.281660604027082,5.793098593657872,5.326367271396349,649867.0849056604,2,7,2,7,2,1,1,1.0,1,-1,1,1,1,0,0
3436,4.987142841939981,5.601364183632625,5.067235627959918,5.4002044121654045,5.05428752182536,5.477109197936306,5.067738478238872,499600.78034682083,0,E01003515,9,0,9,0,0,0,5.012058283922808,5.571055449779679,5.115533026134443,5.362264146969753,4.996184552240671,5.532043143638275,5.101579004113779,637797.9339622641,0,9,0,9,0,0,0,1.0,0,0,0,0,0,0,0
3437,5.245007257761918,5.394526120245926,5.351241556678231,5.150768413318424,5.125995737361157,5.802227844403484,5.319978359177357,508254.88976377953,1,E01003516,7,1,9,0,1,1,5.228092669564135,5.362578901297906,5.335555087994127,5.259274536195924,5.092747561195317,5.815134749693029,5.364498814239221,648865.7058823529,1,7,1,9,0,2,1,1.0,0,0,0,0,0,1,0
3438,5.10135323183548,5.605305925083621,5.185053403250837,5.259717476540717,5.107093887628564,5.59886698446412,5.120052436123723,508819.6956521739,0,E01003517,9,0,9,0,0,0,5.2991134851902455,5.542985033881557,5.216971762545474,5.236417039557621,5.0984501027846125,5.684218168258667,5.236303775697141,649458.2252252252,1,9,0,9,0,0,0,1.0,1,0,0,0,0,0,0
3439,5.468751632115421,5.429996515898144,5.355960179777706,4.97079420615645,5.292016855057548,5.7850740990217995,5.2182983510634475,508547.1176470588,3,E01003518,7,1,6,1,1,0,5.532545432752492,5.443958661994156,5.373082932971773,5.0487338815416605,5.327359275752995,5.880421507115266,5.400244866098676,649191.537414966,4,8,1,6,3,3,2,1.0,1,1,0,0,2,2,2
3440,4.9584431744390915,5.34669957814678,5.577454247782307,5.229267931753589,5.3200604396481666,5.7571654742763885,5.042208119746177,508721.82258064515,0,E01003519,6,4,9,1,1,0,4.94547380455609,5.464868208457684,5.551931183913658,5.4255979451639895,5.317703123750357,5.71708201128861,5.077651463705918,649396.0,0,9,4,9,3,0,0,1.0,0,3,0,0,2,-1,0
3441,5.6041981766098425,4.974154540321283,5.863442943807234,4.802431877244983,5.378059547198446,6.143939043346204,5.477281956296218,500508.1052631579,4,E01003520,1,8,3,2,7,4,5.553148945895108,4.968146997148341,5.812135217406533,4.923928380012512,5.320995808731426,5.972976110198281,5.515268680182371,638960.7090909091,5,1,8,4,3,5,3,1.0,1,0,0,1,1,-2,-1
3442,5.5005436767407545,4.9083538791997645,5.79387909610097,4.82749931986739,5.381020414150827,5.905059362814678,5.341986693987033,497300.23577235773,3,E01003521,0,7,3,2,3,2,5.421503270793165,4.952071277504293,5.807783662763416,4.997008644617521,5.2466398222833615,5.899621321604802,5.324605033947871,636168.1452991453,3,1,8,5,2,3,1,1.0,0,1,1,2,0,0,-1
3443,5.554809787056663,4.912835383053982,5.924243302056284,4.70229935465437,5.406085176901384,6.140509291128679,5.441286890795737,504079.80303030304,4,E01003522,0,8,1,3,7,3,5.5059523721536,4.969748395681381,5.822081081072489,4.7750147422154745,5.1996252000331875,5.99552458524704,5.6223642230033875,643639.9833333333,4,1,8,1,1,5,5,1.0,0,1,0,0,-2,-2,2
3444,5.681685461030973,5.030892387136713,5.802904560015752,4.709182169053938,5.486105857195554,6.098974578030459,5.467193434288451,496265.65034965036,5,E01003523,1,7,1,5,6,4,5.52314236893016,5.020172245942863,5.790438160015519,4.946521216896689,5.280536957607148,5.95532109782954,5.573542885719591,634666.2101910828,4,2,8,4,2,4,5,1.0,-1,1,1,3,-3,-2,1
3445,5.644506563742955,5.078154793807438,5.9137409301031205,4.793079594771068,5.4345369310606095,6.13183130252929,5.63922428942862,504618.4404761905,5,E01003524,2,8,3,3,7,6,5.568533975969661,4.980129363861951,5.799228204922243,4.910724240270528,5.207575307650999,6.031526771458712,5.680763160640543,644678.5227272727,5,1,8,3,1,6,7,1.0,0,-1,0,0,-2,-1,1
3446,5.5200651512146,5.050127673149109,5.795070333480835,4.9403433980941776,5.353003580093384,5.998633406639099,5.457435429573059,501648.384,3,E01003525,1,7,6,2,5,3,5.4951196717851944,5.0554165922048435,5.767491802914452,4.992430462182023,5.245909297739276,5.995323514210359,5.4870888895660865,640893.5572519084,4,2,7,5,2,5,3,1.0,1,1,0,-1,0,0,0
3447,5.947585654258728,4.893382285535336,5.784681951999664,4.71496235281229,5.487424513697624,6.221314704418182,5.660444621741772,498579.5625,8,E01003526,0,7,1,5,8,7,5.784451299555162,4.886051896039177,5.945634973750395,4.739860081672669,5.325304205277387,6.168526402641745,5.7213501397301165,637458.5764705882,7,0,9,1,3,8,7,1.0,-1,0,2,0,-2,0,0
3448,5.891010612249374,4.944771573775345,5.903440147638321,4.655077396167649,5.509973828991254,6.26903913087315,5.699924935897191,500008.3611111111,7,E01003527,1,8,1,5,8,7,5.889131186664969,4.913888437160547,5.9188812072726265,4.726488155731256,5.3759481975997705,6.276781818141108,5.787184265212736,638852.2463768116,8,1,9,0,4,9,8,1.0,1,0,1,-1,-1,1,1
3449,5.326344157164952,5.475817279995613,5.4627835188271865,5.10094389825497,5.259848018862167,5.8453870044564304,5.2973744396893485,501913.1886792453,1,E01003528,8,2,8,0,2,1,5.19411426782608,5.32956856078115,5.425299151190396,5.204188840142612,5.148397075718846,5.705851665858565,5.32743593331041,641490.5689655172,1,7,2,9,0,0,1,1.0,0,-1,0,1,0,-2,0
3450,5.835730173371055,4.9067448309876704,6.039383939721367,4.655765855854208,5.387217643586072,6.390116802670739,5.662444890900091,500455.8068181818,7,E01003529,0,9,1,3,9,7,5.770323959263888,4.871938999403607,6.076010752807964,4.757364564321258,5.296282215551897,6.192659169435501,5.700472279028459,639763.8636363636,7,0,9,1,2,8,7,1.0,0,0,0,0,-1,-1,0
3451,5.789144814014435,5.080321068272871,5.890909499981824,4.789959132671356,5.4306044105221245,6.16617467473535,5.537787020206451,498603.3676470588,6,E01003530,2,8,3,3,7,5,5.77630375453404,4.95705919436046,5.921779084205627,4.8233425957815985,5.302114983967372,6.158705612591334,5.719012592520032,637808.6428571428,7,1,9,2,3,8,7,1.0,1,-1,1,-1,0,1,2
3452,5.800214022636413,4.935001868247986,5.886831413269043,4.7245513563156125,5.555749183654785,6.137332500457764,5.633309350013733,502069.184,7,E01003531,0,8,1,6,7,6,5.7388907443074615,4.8145621191052825,5.876218431136188,4.8735556400874085,5.469219838871675,6.060059175771825,5.583141828284544,641490.4779411765,7,0,8,3,7,6,5,1.0,0,0,0,2,1,-1,-1
3453,5.888027138710022,4.97941115061442,6.026202697753906,4.7739648548762,5.470414530436198,6.34071117401123,5.560374485651652,497441.4533333333,7,E01003532,1,9,2,4,9,5,5.915163384705055,4.842109869166118,6.1276282537274245,4.745423971152887,5.295784698753822,6.325522925795578,5.7607578722442065,636029.6951219512,8,0,9,1,2,9,8,1.0,1,-1,0,-1,-2,0,3
3454,5.699732878436781,4.955452687119784,5.976048126612624,4.764922899742649,5.5924522092897595,6.206444665177227,5.6860833168029785,503407.4657534247,5,E01003533,1,9,2,7,8,7,5.607628612807303,4.994208390062505,5.775660532893556,4.856633238720171,5.362852239247524,6.114522532983259,5.592440531109318,643272.0909090909,5,1,7,2,4,7,5,1.0,0,0,-2,0,-3,-1,-2
3455,5.620224075070743,5.0900332156954144,5.711935123492932,4.894283726297576,5.413050164436472,6.016979061324021,5.469763822596649,501447.2844827586,5,E01003534,2,6,5,3,5,4,5.591035554643537,5.060350571499496,5.678615505578088,4.964150739497826,5.229013605195968,5.94276828257764,5.409719708513041,641054.4508196721,5,2,6,5,1,4,2,1.0,0,0,0,0,-2,-1,-2
3456,5.176032447256148,5.710398489609361,4.977399478200823,5.246483937371522,5.0644902610220015,5.5405256119556725,4.936676171608269,248190.11328125,0,E01003535,9,0,9,0,0,0,5.298019867547801,5.581261461469489,5.090515925430916,5.211580374710996,5.0686479437519125,5.6146117037450765,5.230607214947821,297316.6338028169,1,9,0,9,0,0,0,1.0,1,0,0,0,0,0,0
3457,5.500318319566788,5.118452105791338,5.604293142595599,4.838390764690215,5.4330228249872885,5.994328639199657,5.372578046014232,429437.5967741936,3,E01003536,2,4,4,3,4,2,5.636409158507983,5.14315554300944,5.642483107248942,4.997686634461085,5.318665898839632,6.062651644150416,5.507988628745079,556096.9666666667,6,3,5,5,3,6,3,1.0,3,1,1,1,0,2,1
3458,5.773844941666252,5.085353032538765,5.9549210573497575,4.659773365447395,5.494567624309607,6.234560956034744,5.638081822478981,499324.49122807017,6,E01003537,2,9,1,5,8,6,5.781215665595872,4.981104789035661,5.8975719681807925,4.771005296281406,5.428869221891675,6.218352894697871,5.785434855946472,638398.1964285715,7,1,8,1,6,9,8,1.0,1,-1,-1,0,1,1,2
3459,5.438214016432809,5.18833342047021,5.647758665651378,4.908875484277706,5.310139925173013,6.108793225618872,5.478119108936574,496884.50495049503,2,E01003538,3,5,5,1,6,4,5.445872609431927,5.067061911408718,5.679855218300452,5.000959050196868,5.340608754983315,6.121185100995577,5.510060627873127,635756.3846153846,3,2,6,5,3,7,3,1.0,1,-1,1,0,2,1,-1
3460,5.609389100631658,5.138333482463865,5.632028652803741,4.871702967769038,5.356408001732652,6.051986922312827,5.555412096698789,506349.18248175184,4,E01003539,3,5,4,2,5,5,5.638749633146369,5.152216968329056,5.617589917735777,4.957008637379909,5.253670508446901,6.019323317037112,5.60434356375017,646649.9710144928,6,4,5,4,2,6,5,1.0,2,1,0,0,0,1,0
3461,5.479841657306837,5.301288475161013,5.532287379969722,4.9084120772886966,5.343552983325461,6.005040450372558,5.442040293113045,480803.59420289856,3,E01003540,5,3,5,2,5,3,5.430504088742392,5.323941931554249,5.546177613735199,5.021362220389502,5.239089620113373,6.002042766979763,5.490186271497182,615086.9642857143,3,7,3,6,1,5,3,1.0,0,2,0,1,-1,0,0
3462,5.171680524349212,5.404907568693161,5.431991713047028,5.048501459360122,5.282287349700928,5.777630439996719,5.155575339794159,506902.09,0,E01003541,7,2,7,1,1,0,5.181716397001937,5.334295058035636,5.51977970149066,5.058165118500993,5.101216096061844,5.832556622522372,5.23864902139784,646973.1441441441,0,7,3,6,0,2,0,1.0,0,0,1,-1,-1,1,0
3463,5.345139221791868,5.22217549306375,5.607034135747839,4.955606017289338,5.26483863901209,5.967366227397212,5.399903742472331,496189.6740740741,1,E01003542,4,4,6,1,4,2,5.363989356337794,5.160647254905953,5.615762544783536,5.1088847561387825,5.250064476436337,5.923564400893963,5.392986551815311,631903.4105960265,2,4,5,7,2,4,2,1.0,1,0,1,1,1,0,0
3464,5.647217277270644,5.020785881512201,5.778874911479096,4.726131773706692,5.424263770010934,6.084399141482453,5.633055000162837,500107.0746268657,5,E01003543,1,7,2,3,6,6,5.565437164417533,5.142586967741797,5.6538943920948705,4.903007450029832,5.273224625476571,5.999123039171677,5.5905816056007565,639383.3875968992,5,3,5,3,2,5,5,1.0,0,2,-2,1,-1,-1,-1
3465,5.330743067577237,5.383614511763463,5.314148443644164,5.073293688844462,5.234440970616262,5.714799239010107,5.16340322963527,503031.7786885246,1,E01003544,7,1,8,0,1,0,5.164801956192265,5.316996946567443,5.451520076612147,5.09804815974662,5.1781845218767,5.693006152059974,5.239227587614602,643272.325203252,0,6,2,7,1,0,0,1.0,-1,-1,1,-1,1,-1,0
3466,5.398378446811938,5.424166291724634,5.3372895854120035,4.996054731252539,5.347215388567393,5.800219102670218,5.209105925705597,508087.6259541985,2,E01003545,7,1,6,2,1,0,5.279443639901377,5.333865822322907,5.339046816672048,5.21830147600943,5.170049782722227,5.782141437453609,5.356331696433406,649068.9758064516,1,7,1,9,0,1,1,1.0,-1,0,0,3,-2,0,1
3467,5.1406315850714845,5.419650066643953,5.465497898558776,5.127624227354924,5.214913098762433,5.6686758659780025,5.2619279983143015,499881.2916666667,0,E01003546,7,2,8,0,0,1,5.064823420542591,5.315748285572484,5.418282261434591,5.219731202665365,5.09224789659932,5.647064187616672,5.2805059900823625,639249.5188679246,0,6,1,9,0,0,0,1.0,0,-1,-1,1,0,0,-1
3468,5.858150901272893,5.106207639910281,5.806452749297023,4.726829850114882,5.5865995194762945,6.227114103734493,5.670738589949906,500289.5,7,E01003547,2,7,2,7,8,7,5.667549149680684,4.937948904874671,5.739196134887579,4.8242748347857525,5.362358527329132,6.095064561785632,5.686995737425244,639735.6488549619,6,1,7,2,4,7,7,1.0,-1,-1,0,0,-3,-1,0
3469,5.199296909751314,5.377345003864982,5.436561169046344,5.184469149871306,5.197453056321,5.762261087244207,5.219696948925654,510628.2803030303,0,E01003548,6,2,9,0,1,0,5.176839393513803,5.247359122938782,5.439436962586323,5.230632554483778,5.134133558236916,5.787048307083945,5.4103681249472935,651643.465648855,0,5,2,9,0,1,2,1.0,0,-1,0,0,0,0,2
3470,5.008807793512183,5.479506087505211,5.273322081161758,5.284797254255262,5.221747056912568,5.563486473035004,5.045028740066593,510875.4745762712,0,E01003549,8,0,9,0,0,0,4.949267523960002,5.502665711838064,5.248037421587601,5.3900608437732584,5.18973622507262,5.618883306540332,5.16612088448793,652077.708737864,0,9,0,9,1,0,0,1.0,0,1,0,0,1,0,0
3471,5.437166481687312,5.287803188750618,5.510127444016306,4.981895568078024,5.352599047777946,5.8424570309488395,5.360575187624547,499335.01754385966,2,E01003550,5,3,6,2,2,2,5.292487857597215,5.204947002232075,5.570131721241133,5.054085676159177,5.229587657111032,5.775492337133203,5.420313113502094,638492.4107142857,1,4,4,6,1,1,2,1.0,-1,-1,1,0,-1,-1,0
3472,5.679338696391084,5.090623130632001,5.819690396619397,4.764996857144112,5.391355030758437,6.111060574997303,5.582169658915941,502218.88372093026,5,E01003551,2,7,2,3,7,5,5.658627852149632,5.041037295175635,5.7539929540260975,5.015969755856887,5.232247186743694,6.088172435760498,5.6260650689187255,641927.5326086957,6,2,7,6,1,7,6,1.0,1,0,0,4,-2,0,1
3473,5.721009513226951,5.141835791308705,5.722547818974751,4.914059166501208,5.45179681370898,6.050522152970477,5.677300982358979,502591.8780487805,6,E01003552,3,6,5,4,5,7,5.604986039367882,5.0752313636444715,5.769358541514422,4.95790442260536,5.284638775361551,6.091801308296822,5.660352349281311,642450.9864864865,5,2,7,4,2,7,6,1.0,-1,-1,1,-1,-2,2,-1
3474,5.315027344092894,5.304216729121261,5.593689449717489,5.057697028256534,5.292660911431473,5.738354157865717,5.280115556181147,508200.9550561798,1,E01003553,5,4,8,1,1,1,5.142095024055905,5.278978787528144,5.449842739105224,5.206283252769047,5.134542840056949,5.719417319032881,5.368787607881758,649943.2444444444,0,6,2,9,0,1,1,1.0,-1,1,-2,1,-1,0,0
3475,5.805861098425729,5.123101476260594,5.830284895215716,4.727800528208415,5.490898533094497,6.232436872663952,5.665428663435437,508131.6,7,E01003554,2,8,2,5,8,7,5.701169321031282,5.053233244202354,5.805827398492832,4.894359780080391,5.297944239895753,6.105788987092297,5.708895808518535,648847.9191919192,7,2,8,3,3,7,7,1.0,0,0,0,1,-2,-1,0
3476,5.9544447301660925,5.09347821323617,5.97405642676122,4.671193261748379,5.513734613807456,6.349241240510663,5.818352092816991,500886.23300970875,8,E01003555,2,9,1,5,9,9,5.879304816789716,5.069132067332758,5.786723161412176,4.874681742391854,5.331628342655217,6.204124548724878,5.901295179518584,640444.8691588785,8,2,8,3,3,8,9,1.0,0,0,-1,2,-2,-1,0
3477,5.547286324067549,5.0790276809172195,5.854799101569435,4.9167967872186145,5.437065695632588,5.997964614087885,5.520881754701787,501096.84545454546,4,E01003556,2,8,5,4,5,4,5.3742170151399105,5.123764778886523,5.664190589165201,5.169627665256967,5.204455161581234,5.832622014746374,5.570394361505703,640646.6632653062,2,3,6,8,1,2,4,1.0,-2,1,-2,3,-3,-3,0
3478,5.767579203454133,5.051266838456983,5.894513041059548,4.816250195013028,5.49911601632555,6.14232006474076,5.706759869495285,502679.0560747664,6,E01003557,1,8,3,5,7,7,5.592578467696604,5.0590030472688,5.785694001901029,5.002384827594565,5.418058529044643,5.991839943510113,5.614022224840491,642821.2020202021,5,2,7,5,6,5,5,1.0,-1,1,-1,2,1,-2,-2
3479,5.469153257608414,5.013217874765396,5.817238236665726,5.014429430961609,5.297627190351486,5.789225628376007,5.45963717341423,502341.03,3,E01003558,1,7,7,1,1,3,5.293555010767544,4.940285855648565,5.743484852360744,5.071842419166191,5.150282987192566,5.7332494153695945,5.477933731733584,642053.0,1,1,7,7,0,1,3,1.0,-2,0,0,0,-1,0,0
3480,5.384636443236778,5.227697621131766,5.618271441295229,4.971307564398338,5.343396854811702,5.921949637347255,5.374649847375935,515311.9482758621,2,E01003559,4,5,6,2,3,2,5.357697627408718,5.175835391370262,5.613798821844706,5.0605980283845735,5.16818757464246,5.829626839335372,5.4547726536184795,657676.674796748,2,4,5,7,0,2,2,1.0,0,0,0,1,-2,-1,0
3481,5.764964736424959,5.053917752779447,5.863615824626042,4.760368846012995,5.451806625953087,6.271630573272705,5.488755383858314,501821.3384615385,6,E01003560,1,8,2,4,8,4,5.5529970449786035,5.117495204171827,5.8321305590291175,4.893432917133454,5.333393781415878,6.060993440689579,5.615025331897121,641491.5161290322,5,3,8,3,3,6,5,1.0,-1,2,0,1,-1,-2,1
3482,5.617937316497167,5.088258559505145,5.856667922602759,4.76131291853057,5.496157934268315,6.0482335653569965,5.524317647020022,501780.3333333333,5,E01003561,2,8,2,5,5,4,5.463477926467782,5.011546789710201,5.7944252455412455,4.909080813180155,5.240438856295685,5.980021494538037,5.530433081868869,641451.5223880596,4,2,8,3,1,5,4,1.0,-1,0,0,1,-4,0,0
3483,5.475764495134354,4.934194813668728,5.900844013690948,4.841866007447242,5.476520437002182,6.003692761063576,5.328749822080136,502676.2625,3,E01003562,0,8,4,4,5,1,5.423589071595525,5.0532642516745145,5.754660635109407,5.069035586104335,5.257447710956436,5.8634217589734545,5.522584023245846,642478.6144578314,3,2,7,7,2,2,4,1.0,0,2,-1,3,-2,-3,3
3484,5.670476864124167,4.99034015269115,5.874802986095691,4.877791016266264,5.438091121870896,6.198129144208185,5.474512519507573,502555.775862069,5,E01003563,1,8,4,4,8,4,5.546247381152528,5.105406840642293,5.782837762977138,4.782633423805237,5.326564835779594,6.0877855943911,5.58681789672736,642285.5909090909,5,3,7,1,3,7,5,1.0,0,2,-1,-3,-1,-1,1
3485,5.448231155673663,5.080579324314992,5.792095137139161,4.940954405814409,5.404339286188285,6.004473569492499,5.43441928550601,503084.90625,3,E01003564,2,7,6,3,5,3,5.472997375538474,5.072987390819349,5.728170579358151,4.950588678058825,5.269421909984789,5.93147003023248,5.517105187867817,642912.4421052631,4,2,7,4,2,4,4,1.0,1,0,0,-2,-1,-1,1
3486,5.578485261310231,5.0262776752571,5.745834780977918,4.891330923352923,5.474400260231712,6.005787081532664,5.380117761624324,503368.0909090909,4,E01003565,1,7,5,4,5,2,5.473192559706198,5.062547525844058,5.76593512135583,4.937375125047323,5.1970953635267305,5.885558318447423,5.51942421938922,643246.9324324324,4,2,7,4,1,3,4,1.0,0,1,0,-1,-3,-2,2
3487,5.211160574640546,5.082003850203294,5.70088070827526,5.1576224735804965,5.2642321442509745,5.666261538044437,5.190517236898233,503513.5934065934,0,E01003566,2,6,9,1,0,0,5.070208739752721,5.150265233685272,5.642272746924198,5.159884631031692,5.1424382009891545,5.584009905054112,5.218343815418205,643371.1414141414,0,4,5,8,0,0,0,1.0,0,2,-1,-1,-1,0,0
3488,5.593878548319747,5.0701291212221475,5.848261301110431,4.819999178735221,5.398897854293265,6.067051942755536,5.598100516854263,501675.56097560975,4,E01003567,2,8,3,3,6,6,5.423433065414429,4.992599307195,5.743678945562114,4.88466410274091,5.230992527111717,5.958980638047923,5.543249555256056,641336.5217391305,3,1,7,3,1,4,4,1.0,-1,-1,-1,0,-2,-2,-2
3489,6.006586083659419,4.932552855691792,6.055443754902592,4.751053758609442,5.625862230489283,6.333585176938846,5.603059932037636,503999.97530864197,8,E01003568,0,9,2,8,9,6,6.017856240272522,4.879294517712715,5.905505684705881,4.855739289369339,5.451583535243303,6.2295068349593725,5.657087121254358,643966.717948718,9,0,9,2,6,9,6,1.0,1,0,0,0,-2,0,0
3490,5.391103012921059,4.981958015324318,5.847881921350139,5.076644146279113,5.367203232360213,6.006677023352009,5.371061411622453,503712.3561643836,2,E01003569,1,8,8,2,5,2,5.311407471812049,4.983907461166382,5.681096714596416,5.002301594545675,5.229241678881091,5.813976254574088,5.304482575072798,643607.5116279069,2,1,6,5,1,2,1,1.0,0,0,-2,-3,-1,-3,-1
3491,5.277596308943931,5.22057787889845,5.58669248323762,5.0865001129300405,5.2861542862452815,5.902553574422772,5.3160062519352085,502272.57303370786,1,E01003570,4,4,8,1,3,1,5.338606300808134,5.160323678028016,5.667505715574537,5.067893939358847,5.115261165868668,5.830457051595052,5.428843068225043,641991.0238095238,2,4,6,7,0,2,2,1.0,1,0,2,-1,-1,-1,1
3492,5.622096083696606,5.079622590426102,5.869178112270762,4.915737700693816,5.410942475772599,6.131941839329247,5.449723631432913,502443.786407767,5,E01003571,2,8,5,3,7,3,5.519679201852291,4.9538519623082715,5.949464666734048,4.807601229860149,5.231642071260225,6.161946642289468,5.581787786352525,642149.7155963302,4,1,9,1,1,8,5,1.0,-1,-1,1,-4,-2,1,2
3493,5.595478066802025,5.095933073759079,5.7333463579416275,4.927498434484005,5.398730859160423,6.031480231881142,5.615912291407585,502727.25,4,E01003572,2,6,5,3,5,6,5.631372847923866,4.871286098773663,5.834695232831515,4.938435626029968,5.210685898707463,6.093538508048424,5.597043525255644,642445.5384615385,6,0,8,4,1,7,5,1.0,2,-2,2,-1,-2,2,-1
3494,5.353138266777505,5.063460621298576,5.725584334256697,4.952922456118525,5.369434196121839,5.985004872691874,5.367804453081014,502933.89795918367,2,E01003573,2,6,6,2,4,2,5.415336049055751,4.941710361951514,5.659848699086829,5.046034782747679,5.266655611086495,5.844185632995412,5.367629245866703,642731.0253164558,3,1,6,6,2,2,1,1.0,1,-1,0,0,0,-2,-1
3495,5.740771465260407,5.104764917801166,5.777491285883147,4.880231433901294,5.50196753699204,6.0578247925330855,5.5754658466783065,503294.6206896552,6,E01003574,2,7,4,5,6,5,5.50229764636606,5.070032206363976,5.659189721569419,5.003472118638456,5.236827993765473,5.950419684872031,5.559284365735948,643129.78125,4,2,6,5,1,4,4,1.0,-2,0,-1,1,-4,-2,-1
3496,5.580698390007019,5.137228376865387,5.741735277175903,4.848723084926605,5.38883221745491,6.064177765846252,5.435786166191101,501312.13,4,E01003575,3,7,4,3,6,3,5.575717379267399,5.085017784283711,5.705175255353634,4.9573759665856,5.2791815514747915,6.018007791959322,5.463408294778604,640937.3461538461,5,3,6,4,2,6,3,1.0,1,0,-1,0,-1,0,0
3497,5.340932738890341,5.304854800941747,5.542924601003664,5.116704191636602,5.26683535925839,5.762999762088881,5.320131079866252,499428.81651376147,1,E01003576,5,3,8,1,1,1,5.195923201739788,5.18620819066252,5.5884964402232855,5.199874629931791,5.1226335891655514,5.725675380655697,5.528566654239382,638682.5089285715,1,4,4,9,0,1,4,1.0,0,-1,1,1,-1,0,3
3498,5.187356873503271,5.4778448399507775,5.3102118642825005,5.187543975857069,5.073726574205002,5.653306212065355,5.133783308964856,445300.0094339623,0,E01003577,8,1,9,0,0,0,5.158121869677589,5.428596360342843,5.1980500323431835,5.346920170102801,5.027376506442115,5.647497699374244,5.366997266951062,564516.4,0,8,0,9,0,0,1,1.0,0,0,-1,0,0,0,1
3499,5.697247909985,5.038238602576496,5.723551094103202,4.844385559610326,5.423383559254433,6.000597171646228,5.48066247624459,499362.24460431654,5,E01003578,1,6,4,3,5,4,5.562124019046482,5.097313612485103,5.687175448849905,4.960689736784791,5.276162704975485,5.954357390781101,5.526719312873675,638533.4676258992,5,3,6,4,2,4,4,1.0,0,2,0,0,-1,-1,0
3500,5.69830949647086,4.98062824181148,5.819812543051583,4.816153126103537,5.5159271683011735,6.161389684677124,5.354979259627206,500280.1142857143,5,E01003579,1,7,3,5,7,2,5.650810426787326,4.912431001663208,5.800337259706698,4.907478021947961,5.290427336567326,6.034794923506285,5.544990181922913,639771.4605263158,6,1,8,3,2,6,4,1.0,1,0,1,0,-3,-1,2
3501,5.338990991691063,5.4378350463406795,5.374537297775006,5.007635917334721,5.201157313379748,5.805215728693995,5.253704303708569,402289.724137931,1,E01003580,7,1,7,0,2,1,5.3268285980661405,5.381467421546237,5.315232154067236,5.1404989229813784,5.053819939380384,5.784644012232773,5.296103333698884,499854.48854961834,2,8,0,8,0,1,0,1.0,1,1,-1,1,0,-1,-1
3502,5.632078891369834,4.9502322157817105,5.902814662278588,4.796580033515816,5.538373164276578,6.2451859232205065,5.483928799629211,500220.41791044775,5,E01003581,1,8,3,6,8,4,5.680965903401375,4.937278452515602,5.844696214795112,4.913952641189098,5.298301810026169,6.006689897179603,5.582968156039715,639755.4125,6,1,8,3,3,5,5,1.0,1,0,0,0,-3,-3,1
3503,5.272049570694948,5.299670801712916,5.600117610051082,5.006543173239781,5.337529529363681,5.92707604322678,5.346848619289887,500682.0256410256,1,E01003582,5,4,7,2,3,2,5.288301476212435,5.2614362489345465,5.535101358280626,5.174865961074829,5.1238610425660776,5.873374900152517,5.402011426382287,640184.6976744186,1,6,3,8,0,3,2,1.0,0,1,-1,1,-2,0,0
3504,5.594865119320223,5.0993803712143295,5.824248560543718,4.803302675828166,5.412428513340567,6.137343746492232,5.522258853090221,501038.6781609195,4,E01003583,2,8,3,3,7,4,5.477309268712998,5.009684735536576,5.766176390647888,4.986267182230949,5.273022562265396,5.952068814635277,5.466534097492695,640625.7625,4,2,7,5,2,4,3,1.0,0,0,-1,2,-1,-3,-1
3505,5.872248373443274,5.210638953627442,5.579122569063585,4.741593762267407,5.648332257922605,6.1287393055373816,5.678849048751721,500222.12230215827,7,E01003584,4,4,2,8,7,7,5.774092308836045,5.191044595506456,5.492799112999362,5.074669037769043,5.291747929224002,6.008523778198591,5.581150001949734,639650.4379084967,7,4,3,7,2,5,5,1.0,0,0,-1,5,-6,-2,-2
3506,5.948438379072374,5.049167083155725,5.911560273939563,4.851324354448626,5.493001672529405,6.368428926314077,5.7398115819500335,500229.1612903226,8,E01003585,1,8,4,5,9,8,5.937284996432643,4.96148415150181,5.834665709926236,4.818478044002287,5.403678653701659,6.2842064096081645,5.875896126993241,639660.7096774194,9,1,8,2,5,9,9,1.0,1,0,0,-2,0,0,1
3507,5.784121596411373,5.091940800795395,5.877298460917526,4.723963643727678,5.502209592401312,6.155434230740151,5.662404647034205,501054.03370786516,6,E01003586,2,8,1,5,7,7,5.6084060202474175,4.981945953939272,5.801144739855891,4.88390781050143,5.342145997544994,6.104164805101312,5.815244314463242,640635.054347826,5,1,8,3,4,7,8,1.0,-1,-1,0,2,-1,0,1
3508,5.526815974615453,5.244950782961961,5.565157357270156,4.956037408937283,5.405381308338506,5.904772942628318,5.384091746516344,500794.56910569104,3,E01003587,4,4,6,3,3,2,5.397763658696272,5.265896897616349,5.467823466916722,5.0512488826992,5.216990198676042,5.90030110727145,5.463420722428269,640349.8818897638,3,6,2,6,1,3,3,1.0,0,2,-2,0,-2,0,1
3509,5.731823141376178,4.950518004596233,5.89215982457002,4.755054389437039,5.54431123038133,6.212356477975845,5.690695491929849,501529.7708333333,6,E01003588,1,8,2,6,8,7,5.63020785487428,4.987718404555808,5.813872658476537,4.786546349525452,5.26594971150768,6.111360564523814,5.6906397488652445,641154.4897959183,6,1,8,1,2,7,7,1.0,0,0,0,-1,-4,-1,0
3510,5.922544628758974,4.812213236772561,6.018345132658753,4.7154712345026715,5.4847314327578,6.244313550900809,5.6419672211514245,502074.15189873416,8,E01003589,0,9,1,5,8,6,5.797156573813639,4.865958163767685,6.0009279162795455,4.777982664696964,5.381663772794935,6.17827096691838,5.63792414429747,641756.5679012346,7,0,9,1,5,8,6,1.0,-1,0,0,0,0,0,0
3511,5.797279950038928,5.4386460036738935,5.225908313558695,4.870050416306151,5.49355157496224,5.73521912937433,5.295030592752735,499514.8591549296,7,E01003590,7,0,4,5,1,1,5.8801444836702395,5.431236417372645,5.229093438076182,4.94876157615987,5.362312724804991,5.8760720304968235,5.387464570208183,638619.5165876778,8,8,0,4,4,3,1,1.0,1,1,0,0,-1,2,0
3512,5.158866105908933,5.141474155757738,5.677423278145168,5.034962252948596,5.290843790510427,5.7892321887223614,5.250457783367323,500178.1217391304,0,E01003591,3,6,7,1,1,1,5.15077294421797,5.165325819945135,5.626694717327086,5.151668083767931,5.123955712598913,5.7110064811065415,5.303035260248585,639591.1596638656,0,4,5,8,0,0,1,1.0,0,1,-1,1,-1,-1,0
3513,5.4058327462413525,5.277127484283825,5.5227011394972845,5.041335458802704,5.342435315103814,5.916893010092254,5.38860559109414,504695.31683168316,2,E01003592,5,3,7,2,3,2,5.378412083083508,5.202548132223241,5.503806961517708,5.107633441102271,5.270384968495836,5.861527225550483,5.373959856874802,644686.9215686275,2,4,3,7,2,2,1,1.0,0,-1,0,0,0,-1,-1
3514,5.245561264753341,5.363380336761475,5.380094993114471,5.043378176689148,5.24799075961113,5.678930823802948,5.228266794681549,505621.94,1,E01003593,6,1,7,0,0,0,5.194891293843587,5.3896472823052175,5.3448222071405445,5.138739765636505,5.087694081049117,5.685553102266221,5.266347906892261,645824.7142857143,1,8,1,8,0,0,0,1.0,0,2,0,1,0,0,0
3515,5.418371358461547,5.335181600169132,5.397319017795095,5.091027628957179,5.27640113914222,5.787339371547365,5.2151038573499315,506036.1052631579,2,E01003594,6,1,8,1,1,0,5.276979853253846,5.347157441147971,5.429393572544833,5.0749043346545015,5.221347619634156,5.807756630652541,5.33537342351511,646284.4495412844,1,7,2,7,1,2,1,1.0,-1,1,1,-1,0,1,1
3516,5.333897709846497,5.341128022968769,5.380714812874794,4.984219047427177,5.305461117625237,5.704380655288697,5.251480269432068,505553.275,1,E01003595,6,1,6,1,0,1,5.167348486004454,5.36398306759921,5.475529305862658,5.151618260325807,5.266885869430773,5.7515869682485405,5.210762545917973,645783.5303030303,0,7,2,8,2,1,0,1.0,-1,1,1,2,1,1,-1
3517,5.778274192466392,5.054720429686813,5.750196325886357,4.762539293314959,5.582881788949709,6.157921492516458,5.6619398475767255,503839.58558558556,6,E01003596,2,7,2,7,7,7,5.6914729953992484,5.0949684145426986,5.6663956476910275,5.04312545592242,5.432339056883708,6.004191155480866,5.60037912000524,643722.2772277228,6,3,6,6,6,5,5,1.0,0,1,-1,4,-1,-2,-2
3518,5.826077390889653,5.046624050765741,5.906967288157979,4.854356030948827,5.536228813108851,6.255119714580599,5.608870342129567,504080.60655737703,7,E01003597,1,8,4,6,8,6,5.74497386666595,5.042714245983811,5.759581069477269,5.035738092954041,5.445431935982626,6.0711225994297715,5.586444170748601,644025.262295082,7,2,7,6,6,7,5,1.0,0,1,-1,2,0,-1,-1
3519,5.15049769786688,5.322390475334266,5.559604115975209,5.136806928194487,5.189970447466924,5.7366707019316845,5.117645674791092,504604.78205128206,0,E01003598,6,4,9,0,1,0,5.229631417019423,5.219977730928465,5.586731580800788,5.134619956792787,5.3207335582999296,5.7829686347828355,5.248797955901124,644626.2674418605,1,5,4,8,3,1,0,1.0,1,-1,0,-1,3,0,0
3520,5.475551362497261,5.266930585884186,5.674677007169609,4.975139245929488,5.328425686043429,5.916716406144292,5.4122633934021,504633.9277108434,3,E01003599,5,6,6,1,3,3,5.445932579629215,5.22629835576187,5.493134005570117,5.09400647510717,5.2741782017696055,5.840780331764692,5.287835702484037,644682.8888888889,3,5,3,7,2,2,0,1.0,0,0,-3,1,1,-1,-3
3521,5.09997185866038,5.349645921919081,5.471217179298401,5.105403980943891,5.217812878555722,5.634523651334974,5.174213284916348,505015.8333333333,0,E01003600,6,2,8,0,0,0,5.021665832008979,5.234789267934934,5.476979797536677,5.293192191557451,5.111429572105408,5.6251307810195765,5.441876322332055,645151.3434343435,0,5,2,9,0,0,2,1.0,0,-1,0,1,0,0,2
3522,5.372954871072325,5.239309563193211,5.55209526558255,4.95516278923944,5.355790582507155,5.916944358237954,5.378674003273942,507066.23255813954,2,E01003601,4,4,6,2,3,2,5.3258550184360445,5.174538937167845,5.508923323834,5.100991670060273,5.133933534944691,5.850124796807478,5.447778459332415,647497.3913043478,2,4,3,7,0,2,2,1.0,0,0,-1,1,-2,-1,0
3523,5.581347647401476,5.098996882586135,5.764819307425587,4.75644331125869,5.412681912638478,6.064470087130045,5.471892705897695,506489.73195876286,4,E01003602,2,7,2,3,6,4,5.632451408721031,5.062663718740991,5.76625162236234,4.870177291809244,5.223982562410071,6.02644400647346,5.584666829159919,646795.4893617021,6,2,7,3,1,6,5,1.0,2,0,0,1,-2,0,1
3524,5.418029427528381,5.258246732385535,5.652561351656914,4.932629506838949,5.283997190626044,5.895110720082333,5.369954458192775,506584.8092105263,2,E01003603,4,5,5,1,3,2,5.436997746652173,5.160373491625632,5.530047612036428,5.031313295518198,5.225591387287263,5.866013534607426,5.365054381278253,646967.9677419355,3,4,3,6,1,3,1,1.0,1,0,-2,1,0,0,-1
3525,5.237552702136156,5.486743440860655,5.343758127747512,5.121145668843897,5.082243367520774,5.8304573256795,5.237491563471353,507925.9512195122,0,E01003604,8,1,8,0,2,1,5.217087265746347,5.433202804676418,5.2707907023101015,5.1636931110045,4.97793262837262,5.808374745064769,5.317547768354416,648463.7672413794,1,8,0,8,0,2,1,1.0,1,0,-1,0,0,0,0
3526,5.583314791179839,5.079932718049912,5.846425095058623,4.882360713822501,5.37090000198001,6.040800196783883,5.496499636059716,505697.13333333336,4,E01003605,2,8,4,2,5,4,5.4507783493905695,5.1267793054850594,5.7658183799599705,4.934820671126528,5.211571811505084,5.937030029746722,5.468132827641829,645840.3867924528,3,3,7,4,1,4,3,1.0,-1,1,-1,0,-1,-1,-1
3527,5.5073593698698895,5.138555326132939,5.653914607804397,4.845757102966308,5.404791141378468,5.907242247153973,5.325389427974306,505386.8206896552,3,E01003606,3,5,4,3,3,1,5.394622089847034,5.069773100069817,5.63660702484333,5.0206633111499,5.176701477031834,5.887804307684993,5.386939722970621,645492.4238410596,3,2,5,6,1,3,1,1.0,0,-1,0,2,-2,0,0
3528,5.2944362950556485,5.23606366787142,5.5533424511696525,5.0202274299362335,5.28692294324486,5.852528811658471,5.341930203067446,505888.9708737864,1,E01003607,4,4,7,1,2,2,5.2737903087446005,5.221618875418559,5.639154049429563,5.059094452621913,5.129855580849223,5.861104684300942,5.46222702111348,646099.5346534654,1,5,5,6,0,2,3,1.0,0,1,1,-1,-1,0,1
3529,5.559547352790832,5.081200402312809,5.77062127855089,4.846544765101539,5.448097382651435,6.101260966724819,5.416183941894108,506359.4888888889,4,E01003608,2,7,4,4,6,3,5.5774671161876,4.961930014105404,5.761665756562177,4.970430707931518,5.257800006866455,5.988569503671982,5.56981523177203,646650.1529411764,5,1,7,5,2,5,4,1.0,1,-1,0,1,-2,-1,1
3530,5.000630683020542,5.648461626287093,5.145512958716231,5.357525827591879,5.096777031644743,5.485470827908544,5.035645931784869,492676.51754385966,0,E01003609,9,0,9,0,0,0,5.109859386298814,5.4803438081202405,5.190686925037487,5.332574199400018,5.148237665982445,5.494718484855108,5.061408565436886,629888.3857493857,0,9,0,9,0,0,0,1.0,0,0,0,0,0,0,0
3531,5.1255123529348285,5.516547250318098,5.282536087809382,5.146472298347198,5.215952458682361,5.511275635109292,5.105883095715497,492129.1891891892,0,E01003611,8,0,9,0,0,0,5.19210207880589,5.382355763201128,5.240836946587813,5.2971295651636625,5.1767103891623645,5.53599680934036,5.178613643897207,629157.0701754387,1,8,0,9,1,0,0,1.0,1,0,0,0,1,0,0
3532,5.2177959373681855,5.195613846920504,5.569310924794414,5.0480379409129075,5.260452475878272,5.787506611040323,5.3177219050945626,511208.7623762376,0,E01003615,3,4,7,0,1,1,5.121613365152608,5.256954790457435,5.484254220257634,5.240183576293614,5.148750888264698,5.699748816697494,5.301327614680581,652156.4347826086,0,5,2,9,0,0,1,1.0,0,2,-2,2,0,-1,0
3533,5.092379222071267,5.383082125245071,5.376947338988141,5.204917241887348,5.175407707206602,5.658147689772815,5.203508189054039,512716.0406504065,0,E01003616,7,1,9,0,0,0,4.975652673190698,5.343295644996758,5.389740954664417,5.278518553066971,5.015691349380894,5.572590856623829,5.1672099712199735,654206.9548872181,0,7,1,9,0,0,0,1.0,0,0,0,0,0,0,0
3534,5.040684285132508,5.3307962982278125,5.4029168431696135,5.265918145838537,5.150505846268253,5.5789743724622225,5.104781517072728,514986.9210526316,0,E01003617,6,1,9,0,0,0,4.98933739084186,5.358497814698652,5.400294006232059,5.331127782301469,5.105476885853392,5.627614197586522,5.290489558017615,657215.8787878788,0,7,1,9,0,0,0,1.0,0,1,0,0,0,0,0
3535,5.552665606721655,5.09525184894537,5.803546218128948,4.899676031106479,5.401208572573476,6.021604791864172,5.431787769515793,515599.97402597405,4,E01003618,2,7,5,3,5,3,5.461700679343424,5.16863864807435,5.685658079606515,4.974486035329324,5.158091197779149,5.994660278897227,5.53491955038942,658042.9691358025,4,4,6,5,0,5,4,1.0,0,2,-1,0,-3,0,1
3536,5.264977132968413,5.218228581624153,5.55201498911931,5.103965356411078,5.34025245874356,5.748581004754091,5.380377169755789,515869.0051282051,1,E01003619,4,4,8,2,1,2,5.250689815176596,5.120668876879286,5.553306478084904,5.094873190516292,5.248229845915691,5.7480486300912235,5.441950385523315,658430.8712871287,1,3,4,7,2,1,2,1.0,0,-1,0,-1,0,0,0
3537,5.624218965333606,4.89334355649494,5.91165344298832,4.66502911325485,5.441415385594444,6.177990599284096,5.478591319114443,495904.126984127,5,E01003621,0,8,1,4,7,4,5.5885810383030625,5.085363716375633,6.047786786908009,4.730678509493343,5.336130196930932,6.184043376172175,5.595872333792389,634254.9836065574,5,3,9,0,3,8,5,1.0,0,3,1,-1,-1,1,1
3538,5.279438932510939,5.492990123954686,5.310377253050154,5.0625195652246475,5.1845526972954925,5.702525281093338,5.174029633402824,335439.51136363635,1,E01003622,8,1,8,0,0,0,5.377693978222934,5.454251961951906,5.2222141013904055,5.214874392206019,5.070443911308592,5.704303605989977,5.280206176367673,402403.7443181818,2,8,0,9,0,0,0,1.0,1,0,-1,1,0,0,0
3539,5.227033679150352,5.500132204087312,5.344648601595035,5.201071493881793,5.191405845082496,5.770531202150771,5.14750756902143,346279.4958677686,0,E01003623,8,1,9,0,1,0,5.1539039745259645,5.408040575127103,5.407224937161403,5.176213271582305,5.126237859476858,5.731789782865723,5.216046804812417,442261.58208955225,0,8,1,8,0,1,0,1.0,0,0,0,-1,0,0,0
3540,5.3506887739087325,5.264887562504521,5.543250390041021,5.023467299378948,5.253368931052125,5.903711457311371,5.300472948286268,495721.83950617287,1,E01003624,5,3,7,0,3,1,5.233899857546832,5.2679194131413025,5.496969248797442,5.144288931344007,5.180294204402614,5.687822293590855,5.234600819445945,634036.1891891892,1,6,3,8,1,0,0,1.0,0,1,0,1,1,-3,-1
3541,5.199046099185944,5.555554971694947,5.233164232571919,5.165321519374848,5.153170031706492,5.725805426438649,5.175579518477122,392364.99333333335,0,E01003625,9,0,9,0,1,0,5.343614381186816,5.384671818642389,5.282016389223994,5.25020124879824,5.080402721353129,5.684911912801314,5.289293466782083,492753.49659863947,2,8,0,9,0,0,0,1.0,2,-1,0,0,0,-1,0
3542,5.8076951910809775,4.981876443072063,5.627515201161548,4.720487290766181,5.449573057453807,6.143949781976095,5.48032420146756,497002.2926829268,7,E01003626,1,5,1,4,7,4,5.686644112622297,5.005443742245804,5.699297715116431,4.896669849937345,5.2758331990536345,6.064381422819914,5.526570268619207,635528.3209876543,6,1,6,3,2,6,4,1.0,-1,0,1,2,-2,-1,0
3543,6.051280059133258,4.96114730664662,6.023853315625872,4.634127506187984,5.492378738948277,6.395538129125323,5.651557033402579,497173.4285714286,9,E01003627,1,9,0,5,9,7,5.894635266727871,4.881652752558391,5.960602392752965,4.718750067883068,5.445010897186068,6.309822317626741,5.626898548669285,635759.1111111111,8,0,9,0,6,9,6,1.0,-1,-1,0,0,1,0,-1
3544,5.49415826946497,5.140468123555183,5.713828235864639,4.820394305884838,5.369888156652451,6.042613738775254,5.310422532260418,496451.9875,3,E01003628,3,6,3,2,5,1,5.468580298209458,5.16021326016844,5.683251747924291,4.876733015092571,5.282947500100296,5.972682068856915,5.359429580442021,634799.2359550562,4,4,6,3,2,5,1,1.0,1,1,0,0,0,0,0
3545,6.106208686828613,4.804093713760376,6.145914878845215,4.548617413043976,5.608828830718994,6.589291138648987,5.742961218357086,497403.18,9,E01003629,0,9,0,7,9,8,6.072545184029473,4.675844139522976,6.163034613927206,4.67885508802202,5.512569432788425,6.392218452029758,5.686715184317695,635955.8,9,0,9,0,8,9,7,1.0,0,0,0,0,1,0,-1
3546,5.373240861562219,5.232948456660355,5.6123388639771115,4.939341013974483,5.3016922816191565,5.834926083536431,5.298747926655382,508688.9702970297,2,E01003630,4,5,6,1,2,1,5.286467280525428,5.140678645326541,5.562723556390176,5.1207104829641485,5.33383049414708,5.797556161880493,5.385293499781535,650254.7692307692,1,3,4,8,3,1,1,1.0,-1,-1,-1,2,2,-1,0
3547,5.192990225904128,5.495989271823098,5.30428010225296,5.152442641117993,5.207564508213716,5.701738764257992,5.166355819386594,517291.7794117647,0,E01003631,8,0,9,0,0,0,5.301945206097194,5.371756666047233,5.3404373824596405,5.217281383275986,5.1544170098645345,5.77095092194421,5.331003680399486,660407.3142857143,2,7,1,9,0,1,1,1.0,2,-1,1,0,0,1,1
3548,5.634340524673462,5.047179910482145,5.807368624444101,4.710033935659072,5.45125425563139,6.175228520935657,5.4839905547160726,513712.9705882353,5,E01003632,1,7,1,4,7,4,5.564269970964502,5.055050204197566,5.825154454619796,4.835107041729821,5.375825391875373,6.153106038217191,5.643352820917412,655889.2685185185,5,2,8,2,4,8,6,1.0,0,1,1,1,0,1,2
3549,4.994664586879112,5.587094503480035,5.241743021720165,5.370909726297533,5.112604593908465,5.623169560690184,5.133203282549575,516623.47297297296,0,E01003633,9,0,9,0,0,0,5.072095260426805,5.551076173782349,5.285145401954651,5.432858631417558,5.086455050352457,5.570037933620247,5.170306457055582,659581.5810810811,0,9,0,9,0,0,0,1.0,0,0,0,0,0,0,0
3550,5.34524385201729,5.43587514505548,5.374950853444762,5.195915078712722,5.2259489762581,5.740829405138048,5.214825394800154,516258.7966101695,1,E01003634,7,1,9,0,1,0,5.208460413176438,5.3917321624427,5.281740451681203,5.3119368851184845,5.176959791060152,5.743815443639098,5.282104617562787,659081.8275862068,1,8,0,9,1,1,0,1.0,0,1,-1,0,1,0,0
3551,5.508246154066116,5.273127159428975,5.584657213044545,4.928923253029112,5.407557808217549,5.976301401380509,5.359974803432586,509963.8968253968,3,E01003635,5,4,5,3,4,2,5.4541144371032715,5.344589985907078,5.478730798698962,5.0729916505515575,5.216102994047105,5.880948049947619,5.470512329600751,651373.0234375,3,7,2,7,1,3,3,1.0,0,2,-2,2,-2,-1,1
3552,5.429201043916471,5.24748220949462,5.502709480849179,5.04605333461906,5.356906496214144,5.852016667524974,5.376785137436607,516117.50757575757,2,E01003636,4,3,7,2,2,2,5.295420175213968,5.227668056949493,5.420340144249701,5.2311113634417135,5.244925781219236,5.763113251040059,5.3531220005404565,658856.3225806452,1,5,1,9,2,1,1,1.0,-1,1,-2,2,0,-1,-1
3553,5.690015010143581,5.02840665610213,5.843311206290596,4.777786013327147,5.566575985205801,6.188064697541688,5.5343078876796525,505956.3552631579,5,E01003637,1,8,2,7,8,5,5.604460010583374,5.128981998597069,5.69696499287397,4.96304028335659,5.367037863566957,6.074947014622305,5.585600465193562,646085.4827586206,5,3,6,5,4,7,5,1.0,0,2,-2,3,-3,-1,0
3554,5.55743610782501,5.288581484403366,5.507288408585084,5.007946987182666,5.429479282635909,6.020456596826896,5.383239400692475,161958.37179487178,4,E01003638,5,3,7,3,5,2,5.480107315125004,5.276858041363377,5.45100892128483,5.026514381747092,5.2676564447341425,6.008874794744676,5.636567110400046,204750.6064516129,4,6,2,6,2,5,6,1.0,0,1,-1,-1,-1,0,4
3555,5.468283779857573,5.565851552427308,5.279206817307748,5.018460563884294,5.332084741966783,5.7792093684850645,5.322561466496838,169951.20661157026,3,E01003639,9,0,7,1,1,1,5.262151394644354,5.407698513605656,5.29631428178559,5.144940025786049,5.16473669017482,5.792318848972647,5.394710593753391,187235.46153846153,1,8,0,8,0,1,2,1.0,-2,-1,0,1,-1,0,1
3556,5.719150059122749,5.638998863477603,4.928889666816188,5.050649922463154,5.289502767058505,5.665812075417053,4.987708677367747,318574.92043681745,6,E01003640,9,0,7,1,0,0,5.661472447350208,5.6795071974080695,4.864404897121971,5.164543604772982,5.191677070364088,5.582113002680643,5.084039333010575,406920.84502446983,6,9,0,8,1,0,0,1.0,0,0,0,1,0,0,0
3557,5.287300850175749,5.433274090669717,5.4209144738069766,5.005425409146935,5.330930538238234,5.904671324286491,5.397963298354179,147529.62420382164,1,E01003641,7,2,7,1,3,2,5.173688698496138,5.367103932244437,5.390154476846967,5.180315219334194,5.16211051259722,5.8401196084703715,5.37516901084355,186488.5657142857,0,7,1,8,0,2,1,1.0,-1,0,-1,1,-1,-1,-1
3558,5.41714100215746,5.488705434876939,5.330251805808233,5.004122861701509,5.294520765542984,5.8017377237910805,5.303346983764483,147778.04347826086,2,E01003642,8,1,7,1,1,1,5.3195205347314065,5.38270703402672,5.373418490531036,5.081894624957722,5.243194323876945,5.8710111893343,5.423614222700425,186774.18784530388,2,8,1,7,1,3,2,1.0,0,0,0,0,0,2,1
3559,5.489076834458571,5.223162920811237,5.647918427601839,4.847598526722345,5.439004496122018,6.113687691016075,5.5516303059382315,151211.12820512822,3,E01003643,4,5,4,4,7,5,5.399359544118245,5.196901369553346,5.565396203444554,4.961358704628089,5.348753995620287,6.1294970497106895,5.731793801753949,190918.19871794872,3,4,4,4,4,7,7,1.0,0,0,-1,0,0,0,2
3560,5.467502740789051,5.239900995877163,5.618025194514882,5.035597019944309,5.497126658100727,6.055525653618426,5.418529759753834,171175.173553719,3,E01003644,4,5,7,5,6,3,5.219413154655033,5.167345878150728,5.474673174045704,5.190443699006681,5.230750854368563,5.976747945502952,5.55258466468917,220877.4537037037,1,4,2,8,1,5,4,1.0,-2,0,-3,1,-4,-1,1
3561,5.240297191672855,5.394915796356437,5.432670855963671,5.083828632478361,5.268830395039217,5.8135981368429865,5.310300864555217,151387.65432098764,1,E01003645,7,2,8,1,2,1,5.20816841704308,5.277956113649931,5.493918592530179,5.08709406714908,5.202204703595597,5.8371634214599695,5.387567500847613,191130.82658959538,1,6,3,7,1,2,1,1.0,0,-1,1,-1,0,0,0
3562,5.454235602787563,5.21751197883061,5.5530963775089806,4.895159154619489,5.406137948036194,6.008363594327654,5.490147951671055,677663.56,3,E01003646,4,4,5,3,5,4,5.492625525835398,5.126604948817072,5.7182007982924175,4.963637690286379,5.361727795085391,6.119853883176236,5.595427589158754,858400.8594594594,4,3,7,5,4,7,5,1.0,1,-1,3,0,1,2,1
3563,5.269788461296182,5.172309113960517,5.639192690974788,5.054327139728947,5.478751338626209,6.046459406614304,5.538341404576051,189737.76315789475,1,E01003647,3,5,7,5,5,5,5.285482040025238,5.217979833595734,5.600623514419212,5.235992990938344,5.367418819800355,6.033548425014754,5.53141376667453,242104.25563909774,1,5,4,9,4,6,4,1.0,0,2,-1,2,-1,1,-1
3564,5.721852594461197,5.157490292420754,5.630048482081829,4.817810397881728,5.5356920055854015,6.210247519688728,5.555300969343919,180031.85256410256,6,E01003648,3,5,3,6,8,5,5.713671418546721,5.120240808443259,5.664748450271956,4.876099134219512,5.470331621534042,6.160059901594206,5.594470950483366,228025.4351145038,7,3,6,3,7,8,5,1.0,1,0,1,0,1,0,0
3565,5.772266801326506,5.142222606366681,5.711637452725442,4.708654550775405,5.683300376899781,6.281386700368697,5.730971765133642,388765.81451612903,6,E01003649,3,6,1,9,9,8,5.693222974253967,4.895500583986266,5.841326989958771,4.8025319112085665,5.53673397334276,6.293637412839232,5.772691836399314,507013.22123893804,6,0,8,1,8,9,8,1.0,0,-3,2,0,-1,0,0
3566,5.615850014402377,5.292148646929406,5.581856296551938,4.878049614413684,5.465967600708765,6.073948904378525,5.457797424682719,174449.96688741722,4,E01003650,5,4,4,4,6,3,5.474804152647654,5.15456870953242,5.5967130247751875,4.944885238011678,5.353339777787526,6.07533549785614,5.53326006491979,220056.26,4,4,4,4,4,7,4,1.0,0,-1,0,0,0,1,1
3567,5.622139986171279,5.204596777294958,5.65952131914538,4.822565388309863,5.519244596939679,6.1196681713873105,5.606900119966315,677414.0387596899,5,E01003651,4,5,3,6,7,6,5.555688044604133,5.095615596163507,5.70773066258898,4.975602906124265,5.513481016252555,6.129667607008242,5.692823528074751,858139.4509803922,5,3,6,5,8,7,7,1.0,0,-1,1,2,2,0,1
3568,5.5989239970222116,5.140346048399806,5.745997147634625,4.822054371237755,5.598262220621109,6.1497279070317745,5.612447826191783,355042.25,4,E01003652,3,7,3,7,7,6,5.507850912438721,4.989253254497752,5.7442030185410955,4.923907250917258,5.504608373682038,6.148460067620798,5.4537941457844585,434711.53781512607,4,1,7,4,8,8,2,1.0,0,-2,0,1,1,1,-4
3569,5.154860726830099,5.328096341113655,5.520046555266088,5.169075858836272,5.277538967781326,5.752633281305534,5.3237317013902725,315400.2789115646,0,E01003653,6,3,9,1,1,1,5.147654830998388,5.248169992709982,5.526838991559785,5.153345846307689,5.225095956901024,5.813274455892628,5.352097970863868,388793.2344827586,0,5,3,8,1,2,1,1.0,0,-1,0,-1,0,1,0
3570,5.650581929632413,5.368435628952518,5.536731714843421,4.824694628356605,5.456660208522632,6.137131532033284,5.570245550524804,685438.0752688173,5,E01003654,6,3,3,4,7,5,5.464747633133735,5.368090121896117,5.484675067288059,4.964927364896227,5.268489275778924,6.039664668636722,5.67636686938626,867893.993006993,4,7,2,5,2,6,6,1.0,-1,1,-1,2,-2,-1,1
3571,5.629985866167687,5.228370979132242,5.533768941235069,4.861257936780816,5.3913749274828575,6.016386043157009,5.532985532520622,685733.8410596027,5,E01003655,4,3,4,3,5,5,5.4897105518976845,5.193117062250773,5.5458643094698585,4.9051597555478414,5.325786186854045,5.930169177850088,5.501137493451436,868185.26,4,4,3,3,3,4,3,1.0,-1,0,0,-1,0,-1,-2
3572,5.577623099489597,5.530433939711395,5.299389846121784,4.966260423040176,5.36219097627118,5.885732628304862,5.421335929177801,685214.6143497758,4,E01003656,9,0,6,2,3,3,5.484855074103516,5.543960846296631,5.231506133433616,5.075726084779985,5.219852161289442,5.8738519803132165,5.4265914895746965,867399.0990099009,4,9,0,7,1,3,2,1.0,0,0,0,1,-1,0,-1
3573,5.63928516520013,5.376225903308649,5.474277955165013,4.867915289007502,5.457868768156861,5.951608128684888,5.444501408570105,683672.6690647482,5,E01003657,6,2,4,4,4,3,5.550461603438153,5.394726010368151,5.401665929047501,5.002540301312418,5.343598320641938,5.968967237016734,5.571638492100379,865972.3161764706,5,8,1,5,4,5,5,1.0,0,2,-1,1,0,1,2
3574,5.562574863433838,5.320330838737248,5.592093745117667,4.8759185930468005,5.528639620954886,6.013149529882947,5.478862446059221,684436.1194968553,4,E01003658,6,4,4,6,5,4,5.467774747365929,5.251965605350862,5.496485421456486,4.965087451848639,5.3511681520795245,5.968345917851092,5.533541704516813,866453.2530120482,4,5,3,5,4,4,4,1.0,0,-1,-1,1,-2,-1,0
3575,5.59808807069087,5.498630221621449,5.332002561880773,5.056799805021856,5.318072526103472,5.888587671447085,5.448859547713838,682397.2111553785,4,E01003659,8,1,7,1,3,3,5.3450809747231105,5.474771264220486,5.239453431938877,5.256197112948954,5.214689290323177,5.812227336298518,5.425091599716859,864221.2521008403,2,9,0,9,1,2,2,1.0,-2,1,-1,2,0,-1,-1
3576,5.532762301848239,5.289232739666164,5.442110801703178,4.943285004404567,5.352940314568129,6.143404029359753,5.601719988272494,685558.6845637584,3,E01003660,5,2,6,2,7,6,5.36448215923721,5.214969243077065,5.467449997826446,4.987979440380343,5.293447480784903,6.0308063064547754,5.561615862434716,867935.7410071943,2,5,2,5,2,6,4,1.0,-1,0,0,-1,0,-1,-2
3577,5.487589007293856,5.3021067550053465,5.604123352347194,4.894934458507074,5.357056075656736,6.081583327538258,5.576422648655401,152050.69594594595,3,E01003661,5,4,5,2,6,5,5.164559282575335,5.25842947619302,5.555314556189946,5.218019184895924,5.203564515284129,5.918160263129643,5.570896602528435,191831.09285714285,0,5,4,9,1,3,5,1.0,-3,0,0,4,-1,-3,0
3578,5.267708725577233,5.206153960836014,5.652244532668351,4.925783911007363,5.358193230308943,6.034486946643599,5.425066235881523,154104.8389261745,1,E01003662,4,5,5,2,5,3,5.300956849618392,5.19366696025386,5.504693737897006,5.136967333880338,5.173158635515155,5.905000012571161,5.407338854038354,194496.54545454544,2,4,3,8,0,3,2,1.0,1,0,-2,3,-2,-2,-1
3579,5.366124595558294,5.5661145403794166,5.355357927258543,5.043415295030282,5.333449727820552,5.866171865782478,5.312379952753937,150819.3891213389,2,E01003663,9,1,7,2,2,1,5.397225273105334,5.517103980734663,5.269229980009906,5.087839935748082,5.309229959856789,5.874187255805394,5.47630219414549,190362.69811320756,3,9,0,7,3,3,3,1.0,1,0,-1,0,1,1,2
3580,5.469963942527771,5.2415625228881835,5.445642122268676,5.03260857963562,5.369703717231751,5.947041372299195,5.5278847198486325,151461.008,3,E01003664,4,2,7,2,4,5,5.343483077396046,5.110297317938371,5.631850225275213,5.058270722085779,5.257298202948137,6.023642165010625,5.749811947345734,191268.75454545455,2,3,5,6,2,6,8,1.0,-1,-1,3,-1,0,2,3
3581,5.2608540443273695,5.423131763935089,5.491919920994685,5.1473231086364155,5.25702488055596,5.9425410545789275,5.3905945117657,151815.03076923077,1,E01003665,7,3,9,0,4,2,5.017828304076863,5.404852666587473,5.357901499650189,5.3456705396420485,5.1340391479920005,5.759163979057954,5.375387260847003,191663.15887850468,0,8,1,9,0,1,1,1.0,-1,1,-2,0,0,-3,-1
3582,5.3023265107178394,5.40266685647729,5.449543443726904,5.009678226194264,5.3558682593298546,5.860454780084115,5.381285846233368,152535.9012345679,1,E01003666,7,2,7,2,2,2,5.277271997237551,5.374732166096784,5.401760037394538,5.172275993271151,5.137454128783682,5.827834647634755,5.49421856627948,192607.72463768115,1,7,1,8,0,2,3,1.0,0,0,-1,1,-2,0,1
3583,5.729068216313137,5.1615873066227085,5.740708809220389,4.818983991494339,5.530749883544579,6.0860812543483265,5.712139903159624,645968.488764045,6,E01003668,3,7,3,6,6,7,5.539934846276012,5.174137477102226,5.624284477207247,4.966147489387896,5.452618503703752,5.981996783997094,5.556304967603204,827508.5251396648,5,4,5,5,6,5,4,1.0,-1,1,-2,2,0,-1,-3
3584,5.932870387167171,5.076742788155873,5.786332308382228,4.782386518906856,5.602239930111429,6.307402958040652,5.790317149265952,601071.0072463768,8,E01003669,2,7,2,7,9,8,5.661518273353576,5.131723020076752,5.704328478177389,4.859909794330597,5.428583606084188,6.066228044827779,5.64755117893219,763406.2666666667,6,3,6,2,6,6,6,1.0,-2,1,-1,0,-1,-3,-2
3585,6.0863771713141235,5.319344842072689,5.511897378256827,4.691314984812881,5.676599303158847,6.110960431532426,5.612431381687974,599803.5151515151,9,E01003670,5,3,1,9,7,6,5.910588190879351,5.3016044740323665,5.444291320847876,4.856959975795982,5.473910085948897,5.963106991332254,5.509935149440059,762267.8518518518,8,6,2,2,7,4,3,1.0,-1,1,-1,1,-2,-3,-3
3586,5.99216689215116,5.0946607933453985,5.782492909694742,4.684147167059542,5.684914035299804,6.282634824331553,5.807382527304573,671643.3435582822,8,E01003671,2,7,1,9,9,8,5.691275134394246,5.175816238311029,5.594021384946761,4.938672051891204,5.442538116824243,6.110571682837701,5.7241022240731025,851600.3483870968,6,4,4,4,6,7,7,1.0,-2,2,-3,3,-3,-2,-1
3587,5.670498447418213,5.266272407770157,5.547358042001724,4.89486939072609,5.497701517343521,5.9387337327003475,5.526297482252121,600954.23,5,E01003672,5,4,5,5,4,5,5.491178222706443,5.327944907389189,5.3968138355957835,5.018943929672242,5.2470383418233775,5.855768688101517,5.465841229338395,765747.8526315789,4,7,1,6,2,2,3,1.0,-1,2,-3,1,-3,-2,-2
3588,5.564767767874042,5.52504331744119,5.289635716529375,5.050485528586956,5.2579898264970675,5.850245972697654,5.433419936158684,601578.5056179776,4,E01003673,8,0,7,0,2,3,5.417963075083356,5.472611574239509,5.272846060436826,5.160694553408512,5.19533667384192,5.7832076632699305,5.365325412777967,763881.5116279069,3,9,0,8,1,1,1,1.0,-1,1,0,1,1,-1,-2
3589,5.528188513559208,5.329050085523672,5.4964312398642825,4.991391246256075,5.317480787373426,5.8492730463805955,5.444850511718214,650579.1885964912,3,E01003674,6,3,6,1,2,3,5.338029776748858,5.343845277501826,5.425612248349608,5.151435879238865,5.2056336544061965,5.783224303994262,5.401210072793458,823921.5131578947,2,7,2,8,1,1,2,1.0,-1,1,-1,2,0,-1,-1
3590,5.436904026173997,5.407887224493356,5.44221807211295,4.996443175721443,5.324953885599115,5.938839351308757,5.409422605202116,679352.5574712644,2,E01003675,7,2,7,1,4,3,5.332092971271939,5.331591431962119,5.386471082104577,5.112870889902115,5.23362679945098,5.877057536443075,5.414384166399638,860542.5333333333,2,7,1,7,1,3,2,1.0,0,0,-1,0,0,-1,-1
3591,5.5360422123462785,5.227515215173773,5.736202791196491,4.888908899158513,5.484118814862103,6.153142185386168,5.74050028061648,678678.8715596331,4,E01003676,4,6,5,5,7,8,5.384366011427295,5.0854323458287025,5.619368304168025,5.046093133188063,5.356143061191805,6.032723484500762,5.630949911571318,859635.3790322581,3,3,5,6,4,6,6,1.0,-1,-1,-1,1,-1,-1,-2
3592,5.584310666657984,5.48707263963297,5.257915548514575,4.915230161510408,5.366866240743548,5.8723436472937465,5.375920418649912,680353.68359375,4,E01003677,8,0,5,2,2,2,5.460967200930857,5.410760602917112,5.2500051476353,5.072819539660661,5.224757877533122,5.817265281049382,5.380628129765657,861751.6192170818,4,8,0,7,1,2,1,1.0,0,0,0,2,-1,0,-1
3593,5.512572260560661,5.218398734618877,5.594311921349887,4.92759320900358,5.437925119235598,6.0362153151939655,5.549323230776293,679509.2827586207,3,E01003678,4,4,5,4,5,5,5.346202940880498,5.284621944155874,5.552290492419955,5.023302128043356,5.372667846800406,5.8925529220436195,5.6899331710006615,861048.4810126582,2,6,4,6,4,3,7,1.0,-1,2,0,1,0,-2,2
3594,5.338045667101453,5.303994070399892,5.5221261894786275,5.014542859751028,5.41185934393556,5.933822570147214,5.502001526472452,680479.972027972,1,E01003679,5,3,7,3,3,4,5.196949236027829,5.246270998104198,5.591583273432276,5.089096552616841,5.288101591505446,5.937346310228915,5.8048192541878505,860931.3963963964,1,5,4,7,2,4,8,1.0,0,0,1,0,-1,1,4
3595,5.432075211778283,5.230015101842582,5.650655774399638,5.14670120831579,5.418247848749161,6.019098864868283,5.525076227262616,663081.9140625,2,E01003680,4,5,9,3,5,4,5.353630324356429,5.182437157812919,5.644618767818422,5.07573633976565,5.300553623956579,5.9794333272307885,5.5523904270798194,835614.3053435114,2,4,5,7,3,5,4,1.0,0,0,0,-2,0,0,0
3596,5.617937506321105,5.399932233004794,5.422981262207031,4.90037285076582,5.453690760832831,5.943362407305611,5.430687104321559,678629.2815884476,5,E01003681,7,2,5,4,4,3,5.6696452262108785,5.34634967268559,5.446168239493119,5.001083774315683,5.400149913419757,5.989322685777095,5.514670841317428,859709.2912280702,6,7,2,5,5,5,3,1.0,1,0,0,0,1,1,0
3597,5.644479908785978,5.18089697256193,5.674424239567348,4.768821590549344,5.573618887544988,6.142515917400737,5.671977522608998,679029.1263736264,5,E01003682,3,6,2,7,7,7,5.456863583958879,5.125074201700639,5.606783044581511,5.0427795788463285,5.44182984257231,6.067645327169068,5.570321176733289,860106.918367347,3,3,5,6,6,6,4,1.0,-2,0,-1,4,-1,-1,-3
3598,5.5409355954482,5.084276458391776,5.727095711689729,5.069339770537156,5.428906703224549,6.145253626199869,5.511077120900154,162616.48076923078,4,E01003683,2,6,8,3,7,4,5.455130261070323,5.089637908170808,5.658635350893128,5.061063068092994,5.268649460009809,6.079526206232467,5.693777087724434,204816.88679245283,3,3,6,7,2,7,7,1.0,-1,1,0,-1,-1,0,3
3599,5.396582099212997,5.234515819056281,5.696439433371884,5.060052712758382,5.364232189353856,6.080955050457483,5.4464776200809695,161868.7011494253,2,E01003684,4,6,8,2,6,3,5.170185627043248,5.069251307845116,5.665337243676186,5.185981437563896,5.195400816202164,6.01203220486641,5.549199560284615,203739.3375,0,2,6,8,1,5,4,1.0,-2,-2,0,0,-1,-1,1
3600,5.425840823957236,5.2770269259367835,5.723433211298272,5.124730995385954,5.284958385004856,5.985901948248986,5.547983779765592,163741.1287128713,2,E01003685,5,6,8,1,4,5,5.335171383619309,5.125710167884827,5.661057214736939,5.212133722305298,5.190793421268463,5.8660729885101315,5.497386192083359,205946.28,2,3,6,9,1,3,3,1.0,0,-2,0,1,0,-1,-2
3601,5.462964822538197,5.36763930413872,5.624911203980446,5.1722892159596086,5.30188521463424,5.93321130797267,5.475916549563408,162852.125,3,E01003686,6,5,9,1,3,4,5.363295418739319,5.252481514930725,5.555020156860351,5.261366635322571,5.237015724182129,5.904149263381958,5.559823212623596,204945.96,2,5,4,9,1,3,4,1.0,-1,-1,-1,0,0,0,0
3602,5.458339661643619,5.437728414081392,5.69487369855245,5.120174246742612,5.30494707879566,5.982113711039225,5.550512881506057,170198.8,3,E01003688,7,6,8,1,4,5,5.429700153042572,5.243314467295252,5.640237516827053,5.214093084287161,5.25728349372594,5.954011216308132,5.584185660487473,214229.75757575757,3,5,5,9,2,4,5,1.0,0,-2,-1,1,1,0,0
3603,5.043697088208031,5.342095898024401,5.487183733801147,5.190969477945836,5.191268518941486,5.662048887367823,5.209338440367924,180135.63316582915,0,E01003689,6,3,9,0,0,0,5.034483242390761,5.2101091531971795,5.45896644971857,5.280473406635114,5.1495858187699195,5.6216583216368265,5.323888147648294,228004.67164179104,0,5,2,9,0,0,1,1.0,0,-1,-1,0,0,0,1
3604,5.545031390833051,5.2506886941663335,5.67684811286712,4.8614145550835,5.479193988810764,6.014196709300695,5.612447085005514,617811.7078651686,4,E01003690,4,6,4,5,5,6,5.462752325968309,5.083154339983006,5.676042433941003,5.01763719801951,5.385095136334198,5.988491381057585,5.707863660773846,777306.6616161616,4,2,6,6,5,5,7,1.0,0,-2,0,2,0,0,1
3605,5.763897646798028,5.376726266189857,5.583147855158205,4.914924498840614,5.357622961644773,6.137062340312534,5.581071700873198,595583.9481481481,6,E01003691,6,4,5,2,7,5,5.626138091866487,5.388284579601163,5.490140122525832,5.046638200485629,5.298401316006978,6.009927822873483,5.4948130308413035,757465.248366013,6,8,2,6,3,5,3,1.0,0,2,-2,1,1,-2,-2
3606,5.8381246017808675,5.137899017133632,5.759106593973496,4.753930214072476,5.529363489952408,6.321627931434567,5.8816387042278,677758.3529411765,7,E01003692,3,7,2,6,9,9,5.610315580820215,5.159793197081007,5.669641853406511,4.987159940703162,5.4289272468665555,6.15983069148557,5.800969384867569,858442.4051724138,5,4,6,5,6,8,8,1.0,-2,1,-1,3,0,-1,-1
3607,5.758392222722372,5.378367435137431,5.4447161796357895,4.872637567520141,5.376455145412021,6.069535106023153,5.492089218563503,649132.12,6,E01003693,6,2,4,2,6,4,5.4983337314118375,5.390284726273121,5.387441405115673,5.035927314065101,5.241357064457191,5.939843536998732,5.464069748239895,822516.3039647577,4,8,1,6,1,4,3,1.0,-2,2,-1,2,-1,-2,-1
3608,5.884262513568383,5.1388502921766905,5.775758785145883,4.662613581155092,5.5810705414255155,6.31475226023725,5.797200060072746,678204.2595419848,7,E01003694,3,7,1,7,9,8,5.6638672113418576,4.961241479353471,5.704090504212813,4.896961555697701,5.498864713582125,6.21262243010781,5.809583153507926,859032.2545454545,6,1,6,3,7,8,8,1.0,-1,-2,-1,2,0,-1,0
3609,5.979283191824472,5.217200057480925,5.878462532515167,4.7029497597807195,5.564433692603983,6.4151794525884815,6.108611341445677,674079.9784946237,8,E01003695,4,8,1,7,9,9,5.673315731187661,4.990040867278974,5.834495993951957,5.105425811062257,5.537068349619706,6.247013536592324,5.75743455439806,854150.25,6,1,8,7,8,9,8,1.0,-2,-3,0,6,1,0,-1
3610,5.571707143819422,5.157720282561797,5.67845760969291,4.7919168301991055,5.451982933775823,6.1651884398066015,5.694911436030739,678274.6466165413,4,E01003696,3,6,3,4,7,7,5.424052685101827,5.078008563518524,5.643843372662862,4.979302825927735,5.328604867458344,6.055550193786621,5.728470590909322,859160.34,3,2,5,5,3,6,7,1.0,-1,-1,-1,2,-1,-1,0
3611,5.458066725606069,5.431251092106884,5.434705630022818,4.9796710151652395,5.312724655211284,5.898700945664451,5.470764221945358,679291.5811518325,3,E01003697,7,2,6,1,3,4,5.333307914654081,5.276928948059242,5.388154201427763,5.12543060889304,5.200749537934818,5.821436189208569,5.452323154425521,860451.2719665272,2,6,1,8,1,2,2,1.0,-1,-1,-1,2,0,-1,-2
3612,5.557632528884071,5.303842803410121,5.483992304120745,4.988574711765562,5.359914692810603,6.032610126904079,5.5400350851672036,677213.7071428571,4,E01003698,5,3,6,2,5,5,5.18518042179846,5.292171515764728,5.402026201448133,5.241525028021105,5.197428182248147,5.923907491468614,5.576283833672924,857688.5725806452,0,6,1,9,1,4,5,1.0,-4,1,-2,3,-1,-1,0
3613,5.526630806398916,5.471964529582432,5.30051033444457,5.0159321289796095,5.348654164717748,5.878725152094286,5.353471220194638,675660.9505494506,3,E01003699,8,0,7,2,2,2,5.132573059626988,5.514675770487104,4.953320750168392,5.358620456286839,5.0125386118888855,5.70673326083592,5.191745238644736,856041.0714285715,0,9,0,9,0,0,0,1.0,-3,1,0,2,-2,-2,-2
3614,5.422247895598412,5.421427315970262,5.463600578407447,5.043513743082682,5.2976805284619335,5.905699796477953,5.509852074086666,678287.625,2,E01003700,7,2,7,1,3,4,5.239651615803059,5.374157601136428,5.446028583477705,5.123090636424529,5.115609266207769,5.864159865257068,5.537073135375977,858711.3487179488,1,7,2,8,0,2,4,1.0,-1,0,0,1,-1,-1,0
3615,5.252607963863432,5.32712557340533,5.5029840846135825,5.055329927508695,5.301148921096881,5.8474924156702865,5.465250303090545,181076.29015544042,1,E01003701,6,3,7,1,2,4,5.1714122471551,5.294477361763639,5.50927200693215,5.116716376079127,5.169166449255544,5.811751551228791,5.476368314526939,230262.881773399,0,6,3,7,0,2,3,1.0,-1,0,0,0,-1,0,-1
3616,5.457919415599572,5.388534206116271,5.504357652036016,4.963476615751575,5.4060541419925805,5.985710396738109,5.437026339376758,676042.754491018,3,E01003702,7,3,6,3,4,3,5.3367846213951315,5.3840180818366,5.404346910103288,5.1443516653050825,5.1766575265813755,5.912430551317003,5.4681379706771285,856753.201058201,2,8,1,8,0,3,3,1.0,-1,1,-2,2,-3,-1,0
3617,5.457384439746729,5.479222122561989,5.3713396103188185,4.893422860277897,5.349005532606937,5.899825685902646,5.380493432711186,681396.8612440191,3,E01003703,8,1,5,2,3,2,5.2360686716043725,5.451932793518282,5.207042684532562,5.179173506093475,5.135731371506205,5.683657172715889,5.260890334844589,863437.0306603773,1,8,0,8,0,0,0,1.0,-2,0,-1,3,-2,-3,-2
3618,5.215319573489669,5.2720733857622335,5.459803419175491,5.100801174936731,5.289126043226204,5.93458292375203,5.526778387867547,676195.522875817,0,E01003704,5,2,8,1,3,5,5.0409354193020715,5.260050407553141,5.440335621875999,5.2188047782509726,5.186438548881395,5.851634890632292,5.462974572603682,856663.7079646018,0,5,2,9,1,2,3,1.0,0,0,0,1,0,-1,-2
3619,5.38200742129963,5.307921654455889,5.465807281094468,5.062608413676504,5.303631679151068,5.931342144230094,5.4097308706940455,528909.8962655602,2,E01003705,5,2,8,1,3,3,5.334076702594757,5.241295674615655,5.517624750610225,5.090462494487605,5.247073143966927,5.942666966560458,5.55731250431912,667537.0,2,5,3,7,2,4,4,1.0,0,0,1,-1,1,1,1
3620,5.319252208659523,5.410125018062448,5.448257500067689,5.114744382693355,5.269871733242407,5.868398696856391,5.286471642945942,683203.3533834587,1,E01003706,7,2,8,1,2,1,5.217466818844831,5.399554736525924,5.419691009874697,5.11292043350361,5.26068655649821,5.932003566953871,5.543834510555974,865143.7333333333,1,8,1,7,2,4,4,1.0,0,1,-1,-1,1,2,3
3621,5.432092227759185,5.380510551841171,5.488268984688653,5.029339022989626,5.370248639142072,5.957712378325286,5.506983138896801,682936.4,2,E01003707,7,3,7,2,4,4,5.254108433691871,5.302457594713628,5.45286179852012,5.096521502299025,5.228627241999898,5.864265513735891,5.564658240766715,864895.7086092716,1,6,2,7,1,2,4,1.0,-1,-1,-1,0,-1,-2,0
3622,5.329793250176214,5.5538729998373215,5.294108389269921,5.063804896416203,5.316874015715815,5.836092299799765,5.250574756437732,682952.729032258,1,E01003708,9,0,8,1,2,1,5.238933522622664,5.446938291355804,5.277836416448865,5.128425262786529,5.219874594237778,5.781114054250193,5.335638057399582,864888.7362637363,1,8,0,8,1,1,1,1.0,0,-1,0,0,0,-1,0
3623,5.257671321671585,5.402070018340801,5.45108346692447,5.152868683584805,5.339887577911903,5.967863872133452,5.38718730087938,648756.4275862069,1,E01003709,7,2,9,2,4,2,5.167641814677946,5.326614591383165,5.402476739498876,5.176374572900034,5.260198283580042,5.928434316189058,5.582340686551986,824292.8145161291,0,7,1,8,2,4,5,1.0,-1,0,-1,-1,0,0,3
3624,5.4979712235576965,5.46511388789205,5.527172000969157,4.949048899552402,5.3381573417607475,6.00727464872248,5.657710173550774,683620.5220588235,3,E01003710,8,3,6,2,5,7,5.371707668671241,5.316321461350768,5.585281151157993,5.016831920697139,5.289091953030833,6.028292385848252,5.799370862387277,865741.8321678322,2,6,4,6,2,6,8,1.0,-1,-2,1,0,0,1,1
3625,5.389800422576838,5.351617217584469,5.423111580344787,5.016186433067489,5.371811366497689,5.9141108042288035,5.378625394996076,240315.39737991267,2,E01003711,6,2,7,2,3,2,5.318745167274785,5.312568839972581,5.403687087500968,5.002407885663878,5.270508485111764,5.901798437765943,5.490285075776946,324486.10569105693,2,6,1,5,2,3,3,1.0,0,0,-1,-2,0,0,1
3626,5.303805993795395,5.422487274408341,5.367610379457473,5.0846260333061215,5.294078195095063,5.68282721042633,5.169928858280182,272007.94,1,E01003712,7,1,8,1,0,0,5.31983185594327,5.411462973211413,5.361667273200561,5.148608572015139,5.207681929953744,5.713796145448061,5.317713716319788,354704.2990654206,2,8,1,8,1,0,1,1.0,1,1,0,0,0,0,1
3627,5.7777932316828995,5.027302583058675,5.882581094900767,4.8066118986178665,5.5003743920570765,6.4280670545040035,5.763744152509249,157039.33333333334,6,E01003713,1,8,3,5,9,8,5.741039507918888,4.932126835540489,5.8011513793909995,4.90120330563298,5.450867798593309,6.306021189248121,5.743101772334841,197959.99074074073,7,1,8,3,6,9,7,1.0,1,0,0,0,1,0,-1
3628,5.3342989742426585,5.228765359241001,5.688142124460547,5.090193194579024,5.283413846189805,5.9715895856941605,5.486000585292584,160389.73480662983,1,E01003714,4,6,8,1,4,4,5.275074989417863,5.161917121032548,5.67698967391676,5.230565295844782,5.232480648436833,5.815049286097126,5.40186151650434,202189.77595628417,1,4,6,9,1,2,2,1.0,0,0,0,1,0,-2,-2
3629,5.751931017095393,5.112629748655088,5.811981564218348,4.783285896886479,5.468149170731053,6.310088713963826,5.866966782194195,159289.56818181818,6,E01003715,2,7,2,4,9,9,5.657339971264204,5.055302339792251,5.766962071259816,5.053966811299324,5.350601688027382,6.149364507198333,5.742731485764185,200679.25833333333,6,2,7,6,4,8,7,1.0,0,0,0,4,0,-1,-2
3630,5.717899643457853,5.298776534887461,5.768759588618855,4.8291988765800395,5.475768859569843,6.174547014655648,5.774231644777151,156798.5164835165,6,E01003716,5,7,3,4,7,8,5.568265039433715,5.198857912453272,5.689859504340797,5.029742657497365,5.291157768618676,6.158857994182135,5.755424566166376,197899.18279569893,5,4,6,6,2,8,8,1.0,-1,-1,-1,3,-2,1,0
3631,5.578782340884208,5.331058599054813,5.582969790697097,4.903334824740886,5.474498860538006,6.076602122187614,5.649735531210899,155777.5125,4,E01003718,6,4,5,4,6,7,5.5248383830575385,5.1298236398135915,5.617685177746941,5.07898399549372,5.31550633206087,6.052013200872085,5.703890674254474,196537.6,4,3,5,7,3,6,7,1.0,0,-3,1,2,-1,0,0
3632,5.767003990709782,5.164216392487288,5.735072547197342,4.774329787492752,5.554119725525379,6.21586262434721,5.862293057143688,156348.375,6,E01003719,3,6,2,6,8,9,5.517795196409976,5.131461446874597,5.755723468373331,5.0541411765505755,5.424211889840244,6.014076230231296,5.7018690162830135,197292.84831460673,4,3,7,6,6,5,7,1.0,-2,0,1,4,0,-3,-2
3633,5.317199560277389,5.548131455074657,5.240814724654863,5.103067223772858,5.22507911243222,5.73749462266763,5.225478410720825,675617.4242424242,1,E01003720,9,0,8,0,1,0,5.543485789623075,5.547450037835871,4.9905205559962,5.14602598403264,5.291814859630992,5.8015804522245835,5.2327200070168205,856721.2524271845,5,9,0,8,2,1,0,1.0,4,0,0,0,2,0,0
3634,5.413890965355253,5.645639188081315,5.302513325677334,5.0193729331192465,5.363011161679203,5.794628512512133,5.279559437511037,674572.1116504854,2,E01003722,9,0,7,2,1,1,5.210384419193007,5.5798975957583075,5.250386737797358,5.148872123352469,5.140062164933714,5.778319450273906,5.334278582873409,854721.498630137,1,9,0,8,0,1,1,1.0,-1,0,0,1,-2,0,0
3635,5.3905493259429935,5.517877895964516,5.419858880837759,5.037290109528436,5.345744819773568,5.87461411025789,5.362893456220627,674924.3833333333,2,E01003723,8,2,7,2,2,2,5.215381965731943,5.511415297621923,5.258407783824087,5.245047516380715,5.1325942104225915,5.796324202556484,5.356745861223992,854895.463576159,1,9,0,9,0,1,1,1.0,-1,1,-2,2,-2,-1,-1
3636,5.497402740667944,5.624482830909834,5.348625787316936,5.042002806108292,5.390511981428486,5.873719875943171,5.357661447296404,674369.2191780822,3,E01003724,9,1,7,3,2,2,5.295081575163479,5.574550322828622,5.211775277400839,5.233259930281804,5.2165738048224615,5.799976314347366,5.307055196268805,854413.6068965517,1,9,0,9,1,1,1,1.0,-2,0,-1,2,-2,-1,-1
3637,5.308355322751132,5.582081718878313,5.3365010955116965,5.162966525554657,5.207143610174006,5.8588604905388575,5.435263092951341,674719.8454545455,1,E01003725,9,1,9,0,2,3,4.998701351925843,5.546947353764584,5.360614848316164,5.439459766660418,4.990534689193382,5.762085975560927,5.463914727806149,854480.5789473684,0,9,1,9,0,1,3,1.0,-1,0,0,0,0,-1,0
3638,5.475551876401113,5.698368261668308,4.936775133136876,5.231854596906457,5.230147357568268,5.530680775396095,4.908734926014892,676850.5661157025,3,E01003726,9,0,9,0,0,0,5.376570223598946,5.67619973101267,4.922584158036767,5.22613348931801,5.14802106473504,5.657308697118991,5.1211842926537114,862942.9658536585,2,9,0,9,0,0,0,1.0,-1,0,0,0,0,0,0
3639,5.309506519060386,5.565812022278183,5.335945041556108,5.092488204962329,5.27475300666533,5.860257518918891,5.408522484333892,674733.4736842106,1,E01003727,9,1,8,1,2,3,5.143574484975347,5.509424924850464,5.230201221647716,5.2500965761177705,5.1393547643235316,5.855065268911285,5.406203994820843,854662.4761904762,0,9,0,9,0,2,2,1.0,-1,0,-1,1,-1,0,-1
3640,4.950662578919995,5.616007039302202,5.1223004761757505,5.4504545800132895,5.036072937707937,5.4731202261529495,5.097555329591149,271629.9581749049,0,E01003728,9,0,9,0,0,0,5.057476912402777,5.402465778238633,5.220309677833504,5.424934149200941,4.9795929271869595,5.547038903698377,5.23845850018894,346550.43252595153,0,8,0,9,0,0,0,1.0,0,-1,0,0,0,0,0
3641,5.308256284704486,5.2104917452173325,5.744972381776976,4.967747294787064,5.31711291109474,5.994898951169357,5.324530471875829,179709.87378640776,1,E01003729,4,7,6,1,4,1,5.277133031767242,5.113403980829278,5.679243126694037,5.191573644170956,5.215522996016911,5.875383902569206,5.438904613864665,227856.27551020408,1,3,6,8,1,3,2,1.0,0,-1,-1,2,0,-1,1
3642,5.795039219515664,5.0982644238642285,5.907608142920902,4.769139330301966,5.463786133698055,6.3846145910876135,5.91852188536099,162990.8392857143,7,E01003730,2,8,2,4,9,9,5.643040636490131,5.02684818259601,6.079872965812683,4.9891941814587035,5.3098086406444684,6.189296631977476,5.8577879317875565,205189.93103448275,6,2,9,5,3,8,9,1.0,-1,0,1,3,-1,-1,0
3643,5.519849922749903,5.129654686172287,5.742452082695899,4.978648492268154,5.454407263111759,6.16602213042123,5.531954667784951,162815.3116883117,3,E01003731,2,7,6,4,7,5,5.350348000119372,5.054037392139435,5.63421371797236,5.042708174484532,5.2881959356912756,6.1484800460861955,5.636357250736981,205589.0,2,2,5,6,2,8,6,1.0,-1,0,-2,0,-2,1,1
3644,5.292381106761464,5.598007478212056,5.318235556284587,5.185389163201315,5.390161326057033,5.895230159424899,5.259003664317884,180586.1403508772,1,E01003732,9,1,9,3,3,1,5.181205379111426,5.442348005516188,5.402243456670216,5.221099864159312,5.1316065575395315,5.913769521883556,5.559465429612568,229091.4107142857,0,8,1,9,0,3,4,1.0,-1,-1,0,0,-3,0,3
3645,5.5159624413303705,5.230209884436234,5.7435567560403245,4.908465254565944,5.410711415435957,6.101914265881414,5.474824854861135,181036.0652173913,3,E01003733,4,7,5,3,6,4,5.306555306210237,5.115473330722136,5.724933189504287,5.040266339919146,5.200698846929214,5.967035316018498,5.473198260980494,228606.90588235293,2,3,7,6,1,4,3,1.0,-1,-1,0,1,-2,-2,-1
3646,5.3951008674527,5.192974811743114,5.691995043399905,4.880656765512199,5.372545952639304,6.0790144766657805,5.484386296311686,166986.78512396695,2,E01003734,3,6,4,2,6,4,5.221430657290611,5.05806533629153,5.682808100676336,5.060282427723668,5.176214797156198,5.936673378744045,5.486003551162591,209586.6050420168,1,2,6,7,0,4,3,1.0,-1,-1,0,3,-2,-2,-1
3647,5.402811381551954,5.469060034663589,5.368083786081384,5.040145683067816,5.3711940381262036,5.8568160246919705,5.2288381545631974,162117.49074074073,2,E01003735,8,1,7,2,2,1,5.350565678933087,5.375531863932516,5.332802878875358,5.05861340083328,5.224567304639256,5.834038063591602,5.363407589641272,204200.04901960783,2,7,1,6,1,2,1,1.0,0,-1,0,-1,-1,0,0
3648,5.4697519721406875,5.303863384506919,5.657704093239524,4.8284899628523625,5.5075324918284565,6.090634136488943,5.543536112164006,165432.0,3,E01003736,5,5,3,5,6,5,5.315433373396424,5.162705774964957,5.574642523951914,5.136623540143857,5.112505993623843,5.954210223822758,5.663503056285025,210436.41379310345,2,4,4,8,0,4,6,1.0,-1,-1,-1,5,-5,-2,1
3649,5.639796709149612,5.39207658928293,5.527318865524054,4.809115716212772,5.374801800658666,6.14024051483431,5.673164749392574,158372.65284974093,5,E01003737,7,3,3,2,7,7,5.4377404672128185,5.187342174469479,5.558134432192202,4.888803830853215,5.303197233765213,6.173746339858524,5.6730741243513805,199760.67724867724,3,4,4,3,3,8,6,1.0,-2,-3,1,0,1,1,-1
3650,5.60741645683443,5.167345552086141,5.659548017330941,4.728667616155106,5.493712267434666,6.207116967680826,5.712502362411146,159213.89595375722,4,E01003738,3,5,2,5,8,7,5.400718280902276,5.125114873870388,5.544901276027764,5.08280740072439,5.299258503940079,5.979211012085716,5.41784649170362,200930.63186813187,3,3,3,7,3,5,2,1.0,-1,0,-2,5,-2,-3,-5
3651,5.414902163061866,5.233849617249188,5.532253312554589,4.970707983256661,5.37813639385815,6.002512286691105,5.4294361519941035,161189.00534759357,2,E01003739,4,3,6,2,5,3,5.366771314156617,5.119083668549023,5.5589086410262825,4.980334332476112,5.198543920566898,6.00368857383728,5.5380925994893015,203095.7277486911,2,3,4,5,1,5,4,1.0,0,-1,1,-1,-1,0,1
3652,5.700903205971443,5.191343466024748,5.648788992647101,4.782956650119801,5.507427409057218,6.217296552907734,5.666118427096861,160663.9214659686,5,E01003740,3,5,2,5,8,7,5.537471945561356,5.018556717652173,5.599931345513118,4.889392674867831,5.382329774262318,6.156772020474151,5.689687474888173,202452.09547738693,4,2,4,3,5,8,7,1.0,-1,-1,-1,1,0,0,0
3653,5.592834483127336,5.175830591369319,5.668588725296226,4.812104747102067,5.47523099747864,6.2820019432016325,5.508877200049323,159868.17567567568,4,E01003741,3,5,3,4,9,4,5.433313037386004,5.181661526098946,5.532432226155767,4.9856860574507555,5.294247835677191,6.053460371415347,5.388805219669216,201553.34437086093,3,4,3,5,2,6,1,1.0,-1,1,-2,2,-2,-3,-3
3654,5.628402320616836,5.186806534408429,5.828011740238295,4.903930570007464,5.398303577659327,6.133492307925443,5.717873996550884,160289.94495412844,5,E01003742,3,8,5,3,7,7,5.383065794421508,5.05116262689101,5.694600715046436,5.053650787446351,5.330819367307477,5.96057397074404,5.545128570193738,202076.97345132745,3,2,6,6,3,4,4,1.0,-2,-1,-2,1,0,-3,-3
3655,5.386404339860126,5.2560632761900985,5.657300982048841,5.013120849927266,5.355807465266406,6.068332640136161,5.517773286113894,161229.9756097561,2,E01003743,4,5,7,2,6,4,5.294087611784146,5.155743518213588,5.651370048522949,5.072797275903657,5.218520036832554,5.970934887570659,5.56748537378987,203145.7874015748,1,4,5,7,1,5,4,1.0,-1,0,0,0,-1,-1,0
3656,5.997811344378164,5.4575347496375874,5.35086201673771,4.664191665010971,5.575458408898389,5.958553374063021,5.522627742220667,622604.4016736401,8,E01003744,8,1,1,7,4,4,5.86749914163301,5.435265926252894,5.275461797453776,4.864232090340943,5.461342486513763,5.891181635255573,5.476456016051669,790425.037815126,8,8,0,2,7,3,3,1.0,0,0,-1,1,0,-1,-1
3657,6.184730315400708,5.2493323371295,5.557436424878336,4.654304314524897,5.736220104079092,6.206843043527296,5.739805994014586,685033.0483870967,9,E01003745,4,4,1,9,8,8,6.024295038543642,5.340741128195077,5.517733230255544,4.755761618260294,5.551468288060278,6.1762359868735075,5.783297681249678,867336.02734375,9,7,3,1,8,8,8,1.0,0,3,-1,0,-1,0,0
3658,6.007516215317441,5.358190863671964,5.431058110546892,4.738433278825161,5.603708952447794,5.972407214833002,5.636494695705219,619374.2846715328,8,E01003746,6,2,2,7,4,6,5.762194322239269,5.355749692049893,5.342342081069947,4.8933579973741015,5.395493883219633,5.925010491284457,5.497849175713279,787351.1236363637,7,7,1,3,5,4,3,1.0,-1,1,-1,1,-2,0,-3
3659,6.133361049164507,5.215104495672355,5.703279869897025,4.677716291040406,5.728959890236532,6.332081156565731,6.086417567461057,685369.3157894737,9,E01003747,4,6,1,9,9,9,5.9871567063683635,5.121735382400103,5.836911799923685,4.678682199260533,5.647668680088632,6.252805767443356,5.945273554565122,867725.2953020134,9,3,8,0,9,9,9,1.0,0,-1,2,-1,0,0,0
3660,6.098100093946065,5.265159286864816,5.599952818051865,4.669307598240299,5.666887459689623,6.123515985872103,5.768435185358404,679909.5114155251,9,E01003748,5,4,1,8,7,8,5.929748383435336,5.237065314704721,5.545226998220791,4.826927516135302,5.499986826289784,6.116644328290766,5.734504714879122,861026.0363636364,9,5,3,2,7,7,7,1.0,0,0,-1,1,-1,0,-1
3661,5.845127725751145,5.361160450011679,5.602669993286613,4.816640921358792,5.572405687668039,6.078526363432783,5.591817004125823,684767.8301886793,7,E01003749,6,4,3,7,6,6,5.693648972294548,5.255674110604571,5.544286826988319,4.973159925504164,5.428976860913363,6.047075033187866,5.651408170724844,866894.2012987013,6,5,3,5,6,6,6,1.0,-1,-1,-1,2,-1,0,0
3662,5.939308332833084,5.359979300080119,5.513771630219511,4.782001842920844,5.574340084920058,6.036284038343945,5.550525571848895,620705.5506756756,8,E01003750,6,3,2,7,5,5,5.830836609918244,5.370732597753304,5.463423073291779,4.877642719113097,5.423474790287667,5.990331064276144,5.579578307615656,788579.0714285715,8,7,2,3,6,5,5,1.0,0,1,-1,1,-1,0,0
3663,5.314644080128161,5.41317566881325,5.431117792419975,5.072778685443898,5.364764956653421,5.894606284078607,5.42027942541287,147592.67005076143,1,E01003751,7,2,8,2,3,3,5.33915886890541,5.22627066582152,5.469933637137552,5.0436546472669805,5.216860275824093,5.946558576185726,5.597893761778341,186510.39805825244,2,5,2,6,1,4,5,1.0,1,-2,0,-2,-1,1,2
3664,5.4348721311048225,5.35142731445807,5.6620247573764235,4.870701235201624,5.488834274587808,6.046133800789162,5.509036965944149,159508.80092592593,2,E01003752,6,5,4,5,5,4,5.303784960816646,5.244021816500302,5.51799763893259,5.1235516415587785,5.276654128370614,6.065565341505511,5.72356157621433,201027.7629310345,2,5,3,8,2,6,7,1.0,0,-1,-2,4,-3,1,3
3665,5.330782598064792,5.389423783748381,5.501121461391449,5.002815699385058,5.383287576898452,6.007582289557303,5.392521057398088,156552.5564516129,1,E01003753,7,3,7,2,5,2,5.297869222504752,5.175174008948463,5.566611109461103,4.954401775768825,5.240165265968868,6.082550728321076,5.642252486944199,197095.2785714286,1,4,4,4,1,7,6,1.0,0,-3,1,-3,-1,2,4
3666,5.4659662544727325,5.205524375361781,5.656054000700673,5.007715270403893,5.4118213990042285,6.0642569161230515,5.531496774765753,157522.48387096773,3,E01003754,4,5,7,3,6,5,5.422313718395379,5.112467903217286,5.610988090966494,5.067981533421815,5.295198848229329,6.0526609038578645,5.5846833554843,198631.02290076335,3,3,5,7,2,6,5,1.0,0,-1,0,0,-1,0,0
3667,4.991947239286759,5.4599651224472945,5.431590285721947,5.212290477051455,5.1910954447353586,5.751581896052641,5.187742609136245,154270.33529411766,0,E01003755,8,2,9,0,1,0,5.020070211692426,5.268768186089377,5.461166222140474,5.253305946506044,5.074176015344056,5.782499292361662,5.420383585324077,194874.87421383648,0,6,2,9,0,1,2,1.0,0,-2,0,0,0,0,2
3668,5.305938610509664,5.313982860380862,5.590869118185604,5.107414287679336,5.373649457923505,5.91476980377646,5.357330205059853,162036.41176470587,1,E01003756,5,4,8,2,3,2,5.287239969286144,5.218743689039833,5.723991775105143,5.204145768768767,5.29038300167801,5.949305261302198,5.55182041775467,204071.4700854701,1,5,7,9,2,4,4,1.0,0,0,3,1,0,1,2
3669,5.667886600114297,5.161753968052242,5.70617171301358,4.8309101108191665,5.504972722219384,6.149810892948206,5.636623254720716,161447.4492753623,5,E01003757,3,6,4,5,7,6,5.664272233110959,5.09528805584204,5.696065266601375,5.0177488893759055,5.327700640334458,6.039953446779095,5.716446595113785,203375.96721311475,6,3,6,6,3,6,7,1.0,1,0,0,2,-2,-1,1
3670,5.351134084738218,5.409014972356649,5.552467361780313,5.010413205623626,5.370774353467501,5.85234938951639,5.316500922349783,162014.22307692308,2,E01003758,7,4,7,2,2,1,5.287219686861391,5.260225876172384,5.478080726552893,5.167430616308142,5.226437023833946,5.838296927346123,5.455496502805639,204054.9111111111,1,5,2,8,1,2,2,1.0,-1,-2,-2,1,-1,0,1
3671,5.849678586423397,5.155739479511976,5.839676304161548,4.64772714972496,5.619082948565483,6.31893380433321,5.876200740039349,681247.0625,7,E01003759,3,8,0,8,9,9,5.584264516830444,5.109403109248681,5.759649100182932,4.907532519932035,5.408003962492641,6.139263913601259,5.7165673405309265,862859.3164556962,5,3,7,3,5,8,7,1.0,-2,0,-1,3,-3,-1,-2
3672,5.4970534534681414,5.349928668567112,5.504818672793252,5.067937009107499,5.391949688252948,5.92256905975796,5.4357248942057295,682368.4238095238,3,E01003760,6,3,8,3,3,3,5.34258600473404,5.360280278481935,5.445306101598238,5.144527260253304,5.215266965564928,5.8139187662225025,5.477723703886333,864223.4947368421,2,7,2,8,1,2,3,1.0,-1,1,-1,0,-2,-1,0
3673,5.576267183804121,5.43329659250916,5.33664692425337,5.047353594029536,5.329086479593496,5.938099583641428,5.32168442108592,682551.3770491803,4,E01003761,7,1,7,1,3,1,5.44413986288268,5.522008232001601,5.223989486694336,5.066112912934402,5.134196080010513,5.801572343398785,5.374646865088364,864351.551724138,3,9,0,7,0,1,1,1.0,-1,2,-1,0,-1,-2,0
3674,5.480375855483792,5.428784969855439,5.427088849246502,5.051322149282152,5.305699765004895,5.847392095760866,5.3173064630139955,682756.0795454546,3,E01003762,7,2,7,1,2,1,5.382306004789743,5.329695040529424,5.40543403273279,5.149314394728704,5.243090687827631,5.816273454238068,5.2955362200737,864637.5454545454,3,7,1,8,1,2,0,1.0,0,0,-1,1,0,0,-1
3675,5.5761692741939,5.554331258705684,5.183145982537951,4.9870694872311185,5.3398937664713175,5.841064966065543,5.336005234037127,683475.4685714286,4,E01003763,9,0,6,2,2,2,5.553294775937054,5.473504980512567,5.166560019029153,5.128962539337777,5.231149928634231,5.84152870017129,5.314883945439313,865499.3648648649,5,9,0,8,1,2,1,1.0,1,0,0,2,-1,0,-1
3676,5.417435409931036,5.515932850730725,5.216691392736557,5.092041287284631,5.253746706705827,5.771923153828352,5.280970938312701,683754.9871794871,2,E01003764,8,0,8,0,1,1,5.352924719314457,5.481704978381886,5.2456055894355655,5.144720138041966,5.14901228401314,5.777645318869836,5.271377095127992,865817.9442724459,2,9,0,8,0,1,0,1.0,0,1,0,0,0,0,-1
3677,5.286155420960042,5.5212270403117465,5.296430290268178,5.118364151109729,5.172337522109349,5.785935340220468,5.25468100528968,683333.25,1,E01003765,8,0,8,0,1,1,5.244495600975793,5.478020468662525,5.25080465653847,5.233052992101373,5.116080243012001,5.746405002372018,5.245231858615218,865274.0603448276,1,9,0,9,0,1,0,1.0,0,1,0,1,0,0,-1
3678,5.756639193884934,5.186726823637757,5.992124125927309,4.8098340864422955,5.539832362645789,6.348066133788869,6.022974103311949,159170.25316455695,6,E01003766,3,9,3,6,9,9,5.494508075973262,5.11901384462481,5.9244566559791565,5.111006664193195,5.289380348247031,6.120484315830728,5.842181244622106,200751.01086956522,4,3,9,7,2,7,9,1.0,-2,0,0,4,-4,-2,0
3679,5.258713413687313,5.279998269151239,5.62366609275341,5.056982873117223,5.264169905115576,5.861752725699368,5.385924207813599,158648.08088235295,1,E01003767,5,5,8,1,2,2,5.1899045327614095,5.2792517185211185,5.600769306873453,5.259535975291811,5.112312217416434,5.7181554366802345,5.334342351453057,200115.8,1,6,4,9,0,0,1,1.0,0,1,-1,1,-1,-2,-1
3680,5.621504932901134,5.291921832250512,5.908507021613743,4.880999115239019,5.447147792318593,6.146697832190472,5.820237695652506,160300.58260869567,5,E01003768,5,8,4,4,7,9,5.4587627107446846,5.140191849598215,5.797738203332444,5.18411931814241,5.286294213996446,6.053364066053028,5.708466936734097,202068.97520661156,3,3,8,8,2,6,7,1.0,-2,-2,0,4,-2,-1,-2
3681,5.369317128740508,5.313768237212608,5.558632648402247,5.042323951063485,5.38001328747848,5.861859811585525,5.402170184562946,156630.8827586207,2,E01003769,5,4,7,2,2,2,5.336059097475654,5.314248865882822,5.539887893119914,5.263151697664453,5.21034309207993,5.734976603680809,5.3909652041108815,197316.8120805369,2,6,3,9,1,1,2,1.0,0,1,-1,2,-1,-1,0
3682,5.579656760957506,5.340401887893677,5.481287326812744,4.853630278375413,5.406937328974406,6.020508468416002,5.548180706765916,147239.44444444444,4,E01003770,6,2,4,3,5,5,5.543157558469377,5.258109896846071,5.455147142946368,5.068819671692933,5.316576291823528,5.956455363324408,5.625221243976841,186461.60355029587,5,5,2,7,3,4,6,1.0,1,-1,0,3,0,-1,1
3683,5.559147755304973,5.368269434342017,5.649466730590559,4.961917204734607,5.489024490372747,6.126273850090484,5.621852950153188,155778.94017094016,4,E01003771,6,5,6,5,7,6,5.4372896903327534,5.20502807199955,5.6006168105772565,5.246232450008392,5.296087188380105,5.982832195503371,5.571710843060698,197759.23214285713,3,4,4,9,2,5,5,1.0,-1,-2,-1,3,-3,-2,-1
3684,5.7301390124756155,5.125470610498224,5.786050960855577,4.72969483287589,5.596178192536808,6.304571408669926,5.846805366497596,159370.6796116505,6,E01003772,2,7,2,7,9,9,5.586105543916876,5.068153927542946,5.743997673554854,5.044460053877397,5.263376779989763,6.229114020954479,5.7920224059711805,200937.63636363635,5,2,7,6,2,9,8,1.0,-1,0,0,4,-5,0,-1
3685,5.660447023533009,5.1947427517102085,5.65638624297248,4.881108545962675,5.51819399477523,6.078204303611944,5.611028658019172,154679.2037037037,5,E01003773,3,5,4,5,6,6,5.485293277962641,5.138472985137593,5.5622724653645,5.091980930079114,5.351240604438565,6.013886996290901,5.586840517818928,195057.27272727274,4,3,4,7,4,5,5,1.0,-1,0,-1,3,-1,-1,-1
3686,6.0309452681491775,5.215253513306379,5.688109380503495,4.631076965481043,5.64344148337841,6.211766850203276,5.819043967251976,648576.703125,8,E01003774,4,6,0,8,8,9,5.692266449988264,5.278256354841796,5.563506813169275,4.883805887504193,5.458100408877966,6.023461749718624,5.598243443471081,845351.9559748428,6,6,4,3,7,6,5,1.0,-2,2,-2,3,-1,-2,-4
3687,6.174668788909912,5.208712249267392,5.766397527078303,4.563967174873119,5.795273711041706,6.261096388828464,5.839227731634931,591702.6402439025,9,E01003775,4,7,0,9,8,9,5.8144238491853075,5.1812210356195765,5.621543428964085,4.808112571636836,5.502245614926021,6.0942853937546415,5.712449407411946,755261.0486111111,8,4,5,2,7,7,7,1.0,-1,0,-2,2,-2,-1,-2
3688,5.8635900293648575,5.3734371735397,5.552388520880118,4.725526599244699,5.6411479118816015,6.042275831020079,5.576615522693655,596975.0167597765,7,E01003776,6,4,2,8,5,5,5.693432961424736,5.460276505718492,5.426984040704492,4.929333329200745,5.452608487377428,6.003100311919434,5.49523076047636,761202.301369863,6,8,2,4,6,5,3,1.0,-1,2,-2,2,-2,0,-2
3689,5.856451224535704,5.164098842069507,5.790678805361192,4.747044075280428,5.543912636737029,6.196519158780575,5.784537040938933,679160.359375,7,E01003777,3,7,2,6,8,8,5.694970421718828,5.169894886137259,5.6381031792573255,4.9413035343391725,5.386948779375866,6.055628427953431,5.653991636001702,857367.7777777778,6,4,5,4,5,6,6,1.0,-1,1,-2,2,-1,-2,-2
3690,5.871060448534348,5.216131715714431,5.5979354211262295,4.749684602272611,5.507917741767499,6.029806388526404,5.5981429539808705,614689.8025210084,7,E01003778,4,4,2,5,5,6,5.667792378378309,5.287673708328531,5.490655836487605,4.935927706809084,5.392079267127455,5.924180778590116,5.578453319624436,785011.285123967,6,6,2,4,5,4,5,1.0,-1,2,-2,2,0,-1,-1
3691,5.744164308287063,5.210754373163547,5.731935621432538,4.844355862095671,5.554441458774063,6.14008078485165,5.667110193450496,586032.5943396227,6,E01003779,4,6,4,6,7,7,5.660212850570678,5.142956030887106,5.6451784900997,5.002047134482342,5.438155777558037,6.086102838101595,5.553549632818803,746125.947826087,6,3,5,5,6,7,4,1.0,0,-1,-1,1,0,0,-3
3692,5.897745478594745,5.192555583847893,5.844210709465875,4.741941672784311,5.70074419092249,6.2688407774324775,5.966111083383914,596739.3333333334,7,E01003780,3,8,2,9,8,9,5.54477027992704,5.124631600593453,5.686401329823394,4.893485891285227,5.424022229749765,6.213727321197737,5.931497112138947,759274.4776119404,5,3,6,3,6,8,9,1.0,-2,0,-2,1,-3,0,0
3693,5.653888754728364,5.110148022814495,5.860819944521276,4.8665793087424305,5.5956145069463465,6.138815806164005,5.727381108252983,193204.9024390244,5,E01003781,2,8,4,7,7,8,5.599340402086576,5.032810870806376,5.802092371384303,4.977693528930346,5.4672695149978,6.156078098217646,5.762497902909915,241988.825,5,2,8,5,7,8,8,1.0,0,0,0,1,0,1,0
3694,5.38375208307715,5.415011131295971,5.72226576127258,5.0147751569747925,5.3859577903560565,6.019656793743956,5.500502103683996,171209.42156862744,2,E01003782,7,6,7,2,5,4,5.28891391329246,5.287919489463957,5.499371818976827,5.175124737295774,5.1703787971251085,5.851890781138203,5.426580739493417,216605.63366336634,1,6,3,8,0,2,2,1.0,-1,-1,-3,1,-2,-3,-2
3695,5.286394567884637,5.23697375052074,5.665990475366807,5.121768593082766,5.326604405098413,5.80429583682111,5.29893132427035,214045.5029585799,1,E01003783,4,5,8,1,1,1,5.264011364615425,5.135984200799004,5.655930180575966,5.17909462017249,5.306113801608428,5.813646520698927,5.324913838291695,259752.96132596684,1,3,5,8,3,2,1,1.0,0,-1,0,0,2,1,0
3696,5.688877135207973,5.261596865260724,5.8030044639233465,4.904979401028033,5.4442577521825575,6.227536690603826,5.714261004605244,522256.76288659795,5,E01003784,5,7,5,4,8,7,5.41344426882149,5.269277408571527,5.705644468269726,5.215085906557517,5.286981367828822,6.017039872632168,5.583682733006997,663199.5544554455,3,6,6,9,2,5,5,1.0,-2,1,-1,4,-2,-3,-2
3697,5.4386077602957466,5.591826921815326,5.441419941604517,5.218110335860283,5.258418093821046,5.863494642221244,5.388076480786512,475948.2929936306,2,E01003785,9,2,9,0,2,2,5.340665546455824,5.505683178157476,5.387281708634657,5.294847959038839,5.136287654755432,5.828819620816005,5.399545976881347,601527.3179190751,2,9,1,9,0,2,2,1.0,0,0,-1,0,0,0,0
3698,5.841105284150114,5.148805492932034,5.818637523454489,4.839537808575581,5.557604234243176,6.266447537953091,5.8016580085164495,162583.46391752578,7,E01003786,3,7,4,6,8,8,5.756355469043438,4.938681495495332,5.9032525068674335,5.011340401111505,5.422365980270581,6.253234936640813,5.9282972904352045,204596.83333333334,7,1,9,6,6,9,9,1.0,0,-2,2,2,0,1,1
3699,5.681054660907159,5.174386493288553,5.840710339637903,4.910045551565977,5.592190454785641,6.204748188073818,5.788356418793018,172261.03846153847,5,E01003787,3,8,5,7,8,8,5.719750694049302,5.132182928823656,5.696034792930849,5.001966004730553,5.381004910315236,6.1423067174932005,5.9218518221250145,215372.1075268817,7,3,6,5,5,8,9,1.0,2,0,-2,0,-2,0,1
3700,5.636963147053615,5.308861281374376,5.734068637271579,4.955023143788893,5.451357201706592,6.097414677091639,5.686752590344106,571145.0,5,E01003788,5,6,6,4,6,7,5.508215270643159,5.214727050676121,5.713206542758491,5.207892478920344,5.313975342615383,5.984661793145608,5.623244058428787,736567.5669291338,4,5,6,9,3,5,6,1.0,-1,0,0,3,-1,-1,-1
3701,5.683661636782856,5.407407110299522,5.419020319857249,4.913686823069565,5.404608115432708,5.946313684064198,5.448178432821258,653480.593495935,5,E01003789,7,2,5,3,4,3,5.587965928205923,5.333296424701434,5.417844823929442,4.982322794048726,5.318046604885774,6.002463462973843,5.52895520314449,834517.962184874,5,7,1,5,3,5,4,1.0,0,0,-1,0,0,1,1
3702,5.9168893159574765,5.225845703653469,5.53542001687797,4.754774299396831,5.510287852044318,6.089593784065004,5.539764567545265,545863.4140127389,8,E01003790,4,3,2,5,6,5,5.772789457309171,5.238598044563389,5.5661241213480634,4.8850277999662,5.377807162842661,6.023091980496293,5.509412097481062,693773.251572327,7,5,4,3,4,6,3,1.0,-1,1,1,1,-1,0,-2
3703,6.147741151305865,5.175407623344997,5.522442279221877,4.626056986484888,5.70157858200793,6.165869413231904,5.658165457113734,570108.7698113207,9,E01003791,3,3,0,9,7,7,6.1669383374127476,5.190458115303155,5.59203964516972,4.7406260885975575,5.544587912884626,6.149033703587272,5.616297733603102,721925.9810606061,9,4,4,1,8,8,5,1.0,0,1,1,1,-1,1,-2
3704,6.30327578179248,5.0386019666473585,5.920960172430261,4.492868798119681,5.751187872577023,6.457325602506662,5.910979952130999,498679.13636363635,9,E01003792,1,8,0,9,9,9,6.295749576299783,4.855004477020878,5.94457831478759,4.560371410926717,5.715010798217466,6.456319906567567,5.8898300844550935,637733.5033557047,9,0,9,0,9,9,9,1.0,0,-1,1,0,0,0,0
3705,5.922892523821069,5.40166919319718,5.445692968116235,4.782801745429872,5.56925796705579,5.991446213747459,5.528585551907777,516966.4973544974,8,E01003793,7,2,2,7,4,5,5.835429779414473,5.318700238988905,5.449483775152949,4.875265294107898,5.40316703930277,6.02820938913693,5.49964005078001,658703.1822660099,8,6,2,3,5,6,3,1.0,0,-1,0,1,-2,2,-2
3706,5.507168751387369,5.505542466328258,5.38126983883835,4.924061162131173,5.289921331973303,5.989234233895938,5.560262356485639,681413.6785714285,3,E01003794,8,1,5,1,4,5,5.458379452201453,5.408898052166808,5.399344067004594,5.102742407132279,5.189665072343566,5.955601552670652,5.4167724983258685,863143.7329545454,3,8,1,7,1,4,2,1.0,0,0,0,2,0,0,-3
3707,5.789342821132942,5.40808311935331,5.435309911849068,4.862724540663547,5.505715545083656,6.054445268677884,5.554348195673989,680068.0,6,E01003795,7,2,4,5,5,5,5.673089565535789,5.334439762208143,5.406162365245433,4.937952033421289,5.385203410739358,6.03446574201468,5.48792750487926,861407.2267206478,6,7,1,4,5,6,3,1.0,0,0,-1,0,0,1,-2
3708,5.731954877575238,5.349312507680485,5.556892419145221,4.880524591321037,5.4654380189520975,6.045617422177678,5.622989050689197,680212.1011904762,6,E01003796,6,4,4,4,5,6,5.561593896704293,5.304361398102807,5.5182646812637,5.087176601743438,5.358363511132413,5.9710041408330365,5.578068043364853,861592.1584699453,5,6,3,7,4,5,5,1.0,-1,0,-1,3,0,0,-1
3709,5.971585714097681,5.179687840671375,5.6810891761862,4.685036942362785,5.592783925862148,6.190888493225493,5.77912489556033,84875.41379310345,8,E01003797,3,6,1,7,8,8,5.811207765315866,5.159643374726364,5.632230282827401,4.7874992896323425,5.472137063616988,6.163522675446386,5.801858675030983,108691.75313807532,8,4,5,1,7,8,8,1.0,0,1,-1,0,0,0,0
3710,5.91340877136714,5.033409069121723,5.777556548655872,4.695941972900444,5.529527003496465,6.200530183147377,5.799241040793943,84721.3309859155,8,E01003798,1,7,1,6,8,8,5.6989930725697455,5.09916682138383,5.687346384210406,4.845501701037089,5.429542019682111,6.140926272614197,5.746455029871479,108470.5534591195,6,3,6,2,6,8,8,1.0,-2,2,-1,1,0,0,0
3711,6.042345063841862,4.957620720500532,5.864732497412225,4.587373569607735,5.643337114349656,6.26407576514327,5.774815231561661,86680.82065217392,9,E01003799,1,8,0,8,8,8,6.053793995247947,4.937937942478392,5.816183272997538,4.558822443750169,5.60107732547654,6.243025845951504,5.845928829246097,110822.13888888889,9,1,8,0,9,9,9,1.0,0,0,0,0,1,1,1
3712,6.0102251784221545,5.2301340779742675,5.743755132765384,4.627528397618113,5.7046414066005395,6.277353470389907,5.848789028219275,84087.64864864865,8,E01003800,4,7,0,9,9,9,5.897757082252029,5.2178500157705745,5.735362406102767,4.705707227961617,5.538189423010216,6.220926050814042,5.806847736702203,107645.51552795031,8,5,7,0,8,9,8,1.0,0,1,0,0,-1,0,-1
3713,6.088587569718314,5.059422788053456,5.754809960280315,4.648954796318961,5.684327734578954,6.112711547624947,5.862118251252882,83236.54455445544,9,E01003801,2,7,0,9,7,9,5.747791231063104,5.158963709492837,5.634922653628934,4.825140664654393,5.4268011077757805,5.986326034607425,5.6537949538999985,112424.96129032258,7,4,5,2,6,5,6,1.0,-2,2,-2,2,-3,-2,-3
3714,5.950394456203167,5.30580306205994,5.583553277529203,4.8112682195810175,5.658620161887927,6.169131110876035,5.66320523696068,83622.96153846153,8,E01003802,5,4,3,8,7,7,5.962116959003302,5.231962481370339,5.694333369915302,4.664089997227375,5.584878919216303,6.210913259249467,5.808222471521451,107123.04807692308,9,5,6,0,9,8,8,1.0,1,0,2,-3,1,1,1
3715,5.803939509850282,5.422745698919663,5.538803490308615,4.798877236934809,5.564824588023699,6.129537648879564,5.582398280501366,83558.94230769231,7,E01003803,7,3,3,7,7,5,5.618734150602107,5.408480002169023,5.440406918525696,4.884502977655645,5.323889137360087,6.032878766980088,5.642415182632313,106989.85087719298,5,8,2,3,3,6,6,1.0,-2,1,-1,0,-4,-1,1
3716,5.819460393713532,5.063141328825368,5.833223099331204,4.777217397586905,5.538936843117364,6.153341125241287,5.747888681699904,193559.08633093524,7,E01003804,2,8,2,6,7,8,5.6733922028691515,5.077155371881881,5.749962557786666,4.7845202167079135,5.456410701169908,6.06676325258219,5.758344339124812,245535.43396226416,6,2,7,1,6,6,8,1.0,-1,0,-1,-1,0,-1,0
3717,6.04841716232754,5.338971010276249,5.473896330784237,4.701084058436137,5.629257992146507,6.094388688367511,5.535356252912491,196028.23015873015,9,E01003805,6,2,1,8,6,5,6.016282025973002,5.2110865251690734,5.54227071836883,4.66791894716375,5.575676024193857,6.190921523524266,5.743228769769855,248963.53725490195,9,5,3,0,9,8,7,1.0,0,-1,1,-1,1,2,2
3718,6.278441177166093,5.485780703004941,5.172899445206004,4.7081277567594855,5.727115133320022,6.005743824542339,5.337607987167299,128177.10852713179,9,E01003806,8,0,1,9,5,2,6.433401264332153,5.4335591321463115,5.340566981624771,4.632384104715599,5.817976969939012,6.274223180917593,5.736851059800976,171896.49725274724,9,8,1,0,9,9,7,1.0,0,0,1,-1,0,4,5
3719,5.620219676922529,4.929419935259045,5.964466484183939,4.833995547050085,5.458686549439389,6.200901081419398,5.557203654550079,192659.58974358975,5,E01003807,0,9,4,4,8,5,5.677015803654989,4.837209463119507,5.825143402417501,4.816348769664764,5.408519814014435,6.123000663121541,5.628732338746389,244572.34666666668,6,0,8,2,5,7,6,1.0,1,0,-1,-2,1,-1,1
3720,5.727309406749786,5.012235584713164,5.838071407779815,4.751021659563458,5.522368397031512,6.222880357787723,5.46429386309215,191595.4126984127,6,E01003808,1,8,2,6,8,3,5.6759974023570186,5.000396135924519,5.818804806557255,4.742890247400256,5.388215954752936,6.144618029179781,5.5521629547727285,244212.20289855072,6,1,8,1,5,8,4,1.0,0,0,0,-1,-1,0,1
3721,5.994232079078412,5.088786792285337,5.919363525700686,4.664863561174553,5.636407385905975,6.325871406517592,5.705987260259431,154680.08866995072,8,E01003809,2,8,1,8,9,7,5.872050553259223,5.053137212690681,5.820956667264302,4.656369866144778,5.537372410899461,6.300917497789017,5.846877621881889,200772.75757575757,8,2,8,0,8,9,9,1.0,0,0,0,-1,0,0,2
3722,5.967964802917681,5.126982005018937,5.826277543055384,4.644698383776765,5.668019432770579,6.289303992923937,5.863336111369886,221561.07236842104,8,E01003810,2,8,0,8,9,9,5.767080871850852,5.101665852853916,5.8011907715125375,4.7405821933042285,5.477164074878565,6.183647735006857,5.86913579262343,284029.1610738255,7,3,8,1,7,8,9,1.0,-1,1,0,1,-1,-1,0
3723,5.6300972757668335,5.292487225039252,5.601839211891438,4.850311671454331,5.417543390701557,6.056223890699189,5.488544085108001,228052.70344827586,5,E01003811,5,4,4,3,6,4,5.463964643932524,5.197893743612329,5.5547923311895255,4.9707864247211795,5.323509213064804,5.942540665062106,5.439423747614128,293197.90476190473,4,4,4,5,3,4,2,1.0,-1,-1,0,1,0,-2,-2
3724,5.717683641604205,5.1772640870270115,5.670936062349288,4.752391350335915,5.455497671106008,6.152869163278761,5.56716960968252,227764.8156424581,6,E01003812,3,6,2,4,7,5,5.547768118560955,5.117219574348901,5.726592643286592,4.852653132330987,5.354733445311106,6.0749977801435735,5.688106413810484,292854.5806451613,5,3,7,2,4,7,7,1.0,-1,0,1,0,0,0,2
3725,6.075466826558113,5.261783466316187,5.647265874995635,4.616281925485684,5.592005235644487,6.187779904558108,5.749316084270294,213449.45192307694,9,E01003813,5,5,0,7,8,8,5.886166664270254,5.319693081806868,5.615019371570685,4.839412450179076,5.4455620038203705,6.152373769955758,5.710731020340552,273138.6666666667,8,6,5,2,6,8,7,1.0,-1,1,0,2,-1,0,-1
3726,6.063047440594466,5.334711926324027,5.640395122861105,4.7313048801724875,5.72315025708032,6.088312482076978,5.623916435493994,205281.44444444444,9,E01003814,6,5,2,9,6,6,5.819585643192329,5.2484447956085205,5.608763996917422,4.795463538405919,5.562730805708631,6.118630092923004,5.678041243317104,263067.61386138614,8,5,5,1,8,7,6,1.0,-1,-1,0,-1,-1,1,0
3727,5.83519814066265,5.353462574274643,5.503901816969332,4.791642736870309,5.51882033970045,5.997669452169667,5.389229748560035,202663.92173913043,7,E01003815,6,3,3,6,5,2,5.494065686551536,5.268206302712604,5.520367713672359,5.006735569093285,5.3847853311678255,5.895186396342952,5.366344193132912,258147.53170731707,4,6,3,5,5,3,1,1.0,-3,0,0,2,-1,-2,-1
3728,6.150682873842193,5.504944786065963,5.2079478703378665,4.722968306967883,5.650805965671695,5.913206404302178,5.39606089538675,180711.2581300813,9,E01003816,8,0,1,8,3,2,6.0970143871955305,5.440730658812634,5.215219223575228,4.790360276106816,5.605271565686365,5.999425068023099,5.529150523704075,224954.35031847135,9,8,0,1,9,5,4,1.0,0,0,0,0,1,2,2
3729,6.234722389294949,5.543340772430803,5.073571887721523,4.699188755357605,5.709840860586801,5.817698368709156,5.362466049323736,17714.807327001356,9,E01003817,9,0,1,9,2,2,6.3810719662858535,5.4617502264274185,5.243896081312066,4.6295366184039946,5.729054172217692,6.054821922643548,5.51251982179415,24653.841085271317,9,9,0,0,9,6,3,1.0,0,0,0,-1,0,4,1
3730,5.964231947225011,5.3877441740321546,5.583976817702105,4.760272160261691,5.676418104571496,6.058973920559454,5.492806158379881,40557.54491017964,8,E01003818,7,4,2,9,6,4,5.893477642599912,5.31548240924264,5.614648287309045,4.788102095139855,5.575801454763361,6.194349499309764,5.655587450705748,53217.1550802139,8,6,5,1,9,8,6,1.0,0,-1,1,-1,0,2,2
3731,5.849294181994476,5.534465488908593,5.310871711984992,4.811508747167462,5.640802325119618,5.969904370703551,5.350314376656145,115416.98689956332,7,E01003819,9,1,3,8,4,2,5.85579417358365,5.425010181309884,5.354886153288055,4.861758328843535,5.514334609633998,6.0556797918520475,5.603803622095208,146172.73245614034,8,8,1,2,8,6,5,1.0,1,-1,0,-1,0,2,3
3732,5.831951469182968,5.397237609382029,5.488738638383371,4.84048872910164,5.529567485606229,5.984922726949056,5.507972277976848,4169.356481481482,7,E01003820,7,3,4,6,4,4,5.767634055060798,5.2945862183638654,5.555551378647863,4.820452204247786,5.547849502608674,6.163544477444689,5.736694227462697,5549.194312796209,7,6,4,2,8,8,7,1.0,0,-1,1,-2,2,4,3
3733,6.008260995149612,5.104002849757672,5.588360707461834,4.735084836930037,5.688164614140987,5.9381003975868225,5.612241335213184,197628.25,8,E01003821,2,4,2,9,4,6,5.9188710599212175,5.119598409403926,5.558630638981458,4.772150101128572,5.5452949837868255,5.895520347986162,5.538524775771621,251135.92546583852,8,3,4,1,8,3,4,1.0,0,1,0,-1,-1,-1,-2
3734,6.151857228156848,5.26513770482479,5.6687398409232115,4.606974445245204,5.694169170428545,6.196173488176786,5.819182493747809,296514.4717948718,9,E01003822,5,5,0,9,8,9,6.027553669445178,5.192827230348637,5.777557065973731,4.6587035674699315,5.649103373133075,6.240350350035423,5.888239932309895,378356.49214659684,9,4,7,0,9,9,9,1.0,0,-1,2,0,0,1,0
3735,5.964332047511231,5.492398789208947,5.236082421785051,4.861625297503038,5.621009851269649,5.918061575654781,5.4711907535339845,270471.95265151514,8,E01003823,8,0,4,8,3,4,5.926926837689211,5.371298406602574,5.292078786764015,4.92186811039237,5.52791994445178,5.97831857285532,5.541393241712025,332162.64285714284,9,7,0,4,8,5,4,1.0,1,-1,0,0,0,2,0
3736,5.939386068786705,5.162433447758795,5.733784005128218,4.602592353004118,5.577875232169641,6.1941876187508935,5.711628584571965,279828.05524861877,8,E01003824,3,6,0,7,8,7,5.75379238042189,5.178420097716732,5.647027231868685,4.7940573142600185,5.530009952851528,6.060562584684303,5.633157016699796,363790.7098445596,7,4,5,1,8,6,6,1.0,-1,1,-1,1,1,-2,-1
3737,5.7740487866772865,5.349399211877834,5.682579158308977,4.781838224319641,5.5019218457673125,6.259803051006294,5.773424162836132,276343.1676646707,6,E01003825,6,6,2,5,8,8,5.631604721912971,5.246126967362868,5.717580933601428,4.891175459592771,5.43456125488648,6.148841309241759,5.664636715864524,357224.75,6,5,7,3,6,8,6,1.0,0,-1,1,1,1,0,-2
3738,5.608593047275478,5.496665359763969,5.1701105849327895,4.973097008242949,5.422661995318156,5.79816854610378,5.24205800209436,359241.4129692833,4,E01003826,8,0,6,3,1,1,5.635610061419475,5.420522148345972,5.252433494313971,4.973404886660638,5.384775028987364,5.862699141750088,5.231691672043367,460056.9285714286,6,8,0,5,5,2,0,1.0,2,0,0,-1,2,1,-1
3739,5.737434458644951,5.2924282506984826,5.449091664570219,4.895103120190256,5.557264718062737,5.972375833812882,5.496410613989129,358868.3161764706,6,E01003827,5,2,5,6,4,4,5.669669248422601,5.226393502191227,5.4524922867999575,4.993407161999853,5.464357593805174,5.9677596561697,5.372404824352633,459576.4864864865,6,5,2,5,7,4,1,1.0,0,0,0,0,1,0,-3
3740,5.843168444674591,5.378263659518341,5.587389975786209,4.699258424598595,5.593359658430362,6.086424066074963,5.598077790490512,199993.6120689655,7,E01003828,6,4,1,7,6,6,5.737879644556249,5.300845871073134,5.540766889998253,4.868521758343311,5.41917796743677,6.093858423638851,5.609375715255737,254250.9021276596,7,6,3,3,6,7,5,1.0,0,0,-1,2,-1,1,-1
3741,5.721885373472501,5.434805598338889,5.484420895576477,4.887066044620961,5.487937267932146,5.975878796763927,5.499770679287404,226362.0055865922,6,E01003829,7,3,5,5,4,4,5.617110054339132,5.400392619512415,5.456972427906528,4.995935589395543,5.336741503848825,5.902738398121249,5.4478380551902195,289568.2311827957,5,8,2,5,3,3,2,1.0,-1,1,-1,0,-2,-1,-2
3742,5.898994049640617,5.345309501946574,5.552525888789784,4.762638672433718,5.568574280449838,6.020240715055754,5.600405104834624,199308.95454545456,7,E01003830,6,4,2,7,5,6,5.767759063551503,5.353806509125617,5.448495598890448,4.9473776637866935,5.412305756922691,5.929692154289574,5.540520851330091,253329.40322580645,7,7,2,4,5,4,4,1.0,0,1,-2,2,-2,-1,-2
3743,5.767351989801219,5.499356162341344,5.3867071515562905,4.871139273478117,5.48819576867054,6.002527800598585,5.426909659639259,218983.0231213873,6,E01003831,8,1,4,5,5,3,5.62099007235633,5.391496371560627,5.421562218666077,4.9526657528347435,5.352226301034292,5.927290447552999,5.434371422396766,281209.59444444446,6,8,1,4,4,4,2,1.0,0,0,0,0,-1,-1,-1
3744,5.656745794342785,5.497640379076081,5.226104337994645,4.987670066880017,5.3849475490368475,5.839020573995946,5.302734367246551,200393.20325203252,5,E01003832,8,0,6,2,2,1,5.555924276995465,5.461115874895236,5.311063297395783,5.073422875830798,5.4092361675045355,5.892458778086716,5.30630796517783,254761.34959349592,5,8,0,7,5,3,1,1.0,0,0,0,1,3,1,0
3745,5.814177420904052,5.422000292337166,5.403166660722697,4.91256777407988,5.5237092499463065,6.023990174509445,5.5288749202242435,200161.43396226416,7,E01003833,7,1,5,6,5,5,5.649401341836284,5.417576373092771,5.286022623692911,4.937391836812177,5.303003879044,5.9788424358593195,5.465123754786694,254467.79527559056,6,8,0,4,3,5,3,1.0,-1,1,-1,-1,-3,0,-2
3746,5.788762690907433,5.299327881563277,5.565711312634605,4.819112642038436,5.5230163716134575,5.981023383140564,5.530428013915107,21460.22857142857,6,E01003834,5,4,3,6,4,5,5.698057540582151,5.24120797429766,5.479900032160233,4.9047657192969805,5.493496526990618,5.934536743164062,5.577341089443284,28362.342857142856,6,5,2,3,7,4,5,1.0,0,0,-2,0,1,0,0
3747,6.190903348166768,5.111067345956477,5.864791210104779,4.5463012645884255,5.766952465220196,6.370703158582129,5.829736789552177,23007.29268292683,9,E01003835,2,8,0,9,9,9,6.0919851482688605,5.061181686141274,5.865004898665787,4.595964006789319,5.653117381907129,6.394490830309979,5.9360042531768995,30099.272727272728,9,2,8,0,9,9,9,1.0,0,0,0,0,0,0,0
3748,6.103158714090075,5.16480301788875,5.700552945477622,4.653980592318944,5.73440260887146,6.187888501371656,5.774812137229102,52904.29285714286,9,E01003836,3,6,1,9,8,8,5.987935081506387,5.066795803033388,5.766373680188106,4.747060649670088,5.617303342391283,6.241546673652453,5.738883539652213,64070.570512820515,9,2,7,1,9,9,7,1.0,0,-1,1,0,0,1,-1
3749,6.148335484302405,5.310523729613333,5.714078055006085,4.592089832190311,5.787156275546912,6.183834567214504,5.7335131768024326,21239.466666666667,9,E01003837,5,6,0,9,8,8,5.974097517289613,5.273275777540709,5.628201649063512,4.736000825856861,5.654825062500803,6.1453778655905476,5.742450606822968,27628.252631578947,9,6,5,0,9,8,7,1.0,0,1,-1,0,0,0,-1
3750,6.118596775726703,5.170993316848323,5.782494104133462,4.59546442451717,5.717173900244371,6.215456227836369,5.828523245247655,48740.85534591195,9,E01003838,3,7,0,9,8,9,6.024754313651673,5.091970683571821,5.819530614121946,4.65041305704745,5.64442274670401,6.242169274541432,5.84102733049564,57140.44910179641,9,3,8,0,9,9,9,1.0,0,0,1,0,0,1,0
3751,5.87854598753551,5.228123973812577,5.58360445076192,4.751645113589496,5.59997556830299,6.094639487520477,5.594671786184142,23044.739644970414,7,E01003839,4,4,2,7,6,6,5.731243685390172,5.144782934965712,5.548830816585027,4.875264386112771,5.44839221640919,5.970421543282069,5.536772521694055,30191.26966292135,7,4,4,3,6,5,4,1.0,0,0,0,1,-1,-1,-2
3752,5.543083624406294,5.464128351830817,5.321140296273417,4.932879449485184,5.480708730685246,5.859847472859667,5.457703593489412,220865.25324675324,4,E01003840,8,1,5,5,2,3,5.463835508502715,5.322202453139233,5.446221695308797,5.031764293274684,5.316368828042906,5.986647918210392,5.646782593420374,283943.62573099416,4,7,2,6,3,5,6,1.0,0,-1,1,1,-2,3,3
3753,5.564946596789512,5.421128888798368,5.32672423769714,4.938046264041001,5.457977026131503,5.904494393403363,5.387955781760489,222464.27388535033,4,E01003841,7,1,6,4,3,2,5.520927631614993,5.4127169391452865,5.352610053632083,5.007307171021532,5.319826076494768,5.7917618951541465,5.433499502655644,286050.932885906,4,8,1,5,3,1,2,1.0,0,1,0,-1,-1,-2,0
3754,5.52620609308544,5.424477540819269,5.401903360768368,4.909299081250241,5.374913960381558,5.963059922268516,5.411820036486575,223348.6052631579,3,E01003842,7,1,5,2,4,3,5.478862783393344,5.31395011281108,5.49763400705011,5.032703739028793,5.283747763247104,5.954949062149804,5.491651989855208,287197.13963963964,4,6,3,6,2,4,3,1.0,1,-1,2,1,0,0,0
3755,5.540920606324839,5.427006574564202,5.420870102283566,4.957345626520556,5.39210417769676,5.951860109595366,5.443541581131691,228116.23720930232,4,E01003843,7,2,6,3,4,3,5.409274967173313,5.391455669605985,5.409310181090173,5.088820440718468,5.331679011913056,5.935776715075716,5.409759645259126,293264.7319148936,3,8,1,7,3,4,2,1.0,-1,1,-1,1,0,0,-1
3756,5.75792195473876,5.204224102965025,5.598899051407788,4.752239667366598,5.5381964695787875,6.1238858348855345,5.718047889593605,223557.71495327103,6,E01003844,4,4,2,6,7,7,5.720155245813973,5.196881831466378,5.547665672900873,4.8689402104456185,5.368191913092807,6.100671517384517,5.810700312837378,287492.9567099567,7,4,3,3,4,7,8,1.0,1,0,-1,1,-2,0,1
3757,5.586263994640774,5.358904259999593,5.4848934311336945,4.7439265537261965,5.496928944057888,6.025456623501248,5.589293588002523,224248.66222222222,4,E01003845,6,3,2,5,5,6,5.458545018372865,5.318017905128413,5.522480977506473,5.019846874578246,5.3240402294644,5.996819353309171,5.557005325781888,288498.5818965517,3,6,3,6,3,5,4,1.0,-1,0,0,4,-2,0,-2
3758,6.341172715028127,4.970978216046379,5.978072384993236,4.501362682098434,5.770052237170083,6.45958841130847,5.973205446487381,188135.83333333334,9,E01003846,1,9,0,9,9,9,6.098502843444412,4.9124417640067435,5.983800205024513,4.605207637194041,5.673602041682681,6.459059657277288,5.966544499912778,238473.02702702704,9,1,9,0,9,9,9,1.0,0,0,0,0,0,0,0
3759,5.996386268156038,5.163541966633831,5.64893150586876,4.698179227842702,5.672089445505211,6.005504746231244,5.625471211165833,188099.48920863308,8,E01003847,3,5,1,8,5,6,5.97722877902644,5.153038477046149,5.648028608305114,4.7290767077888765,5.6109000653028485,6.027430725097656,5.687392385942595,238174.7142857143,9,4,5,0,9,6,7,1.0,1,1,0,-1,1,1,1
3760,5.793201784169452,5.20936846288835,5.704929028979,4.725545743237371,5.521323797125254,6.196126089333007,5.550412753353948,191699.93167701864,7,E01003848,4,6,2,6,8,5,5.757067064906275,5.145464236653129,5.716520337171333,4.766843124877575,5.442734514558038,6.13537842173909,5.720073878072029,243155.0,7,4,7,1,6,8,7,1.0,0,0,1,-1,0,0,2
3761,6.023067170923406,5.019711953220946,5.92685572125695,4.602404484243104,5.630179907336379,6.296764265407216,5.743863746975407,188525.9090909091,8,E01003849,1,9,0,8,9,8,6.137626603671483,5.008437595197132,5.932291751248496,4.5813507497310635,5.678144121170044,6.297416242531368,5.820747458934784,239116.32857142857,9,2,9,0,9,9,8,1.0,1,1,0,0,1,0,0
3762,6.240832603338993,5.039420918984846,5.918279418078336,4.597139350573221,5.643795111685089,6.31288362271858,5.827936202829535,187082.58181818182,9,E01003851,1,8,0,8,9,9,6.025226964950561,5.039346692221505,5.836051645278931,4.685268834659031,5.5836503791809085,6.249570395605905,5.83136335849762,237024.12,9,2,8,0,9,9,8,1.0,0,1,0,0,1,0,-1
3763,6.138189880794267,5.30710515293661,5.330106724113514,4.634749586175876,5.665791622695433,5.839302896303379,5.510619051203467,88863.2765273312,9,E01003852,5,1,0,8,2,4,6.114135581561086,5.38835285185327,5.357594055711683,4.7344797900076,5.561257874497474,5.886900366613152,5.509276739059978,113408.46525679759,9,8,1,0,8,3,3,1.0,0,3,0,0,0,1,-1
3764,6.058089400729994,5.131746421765237,5.734104173896957,4.666511179756944,5.644443647704855,6.2067670700323845,5.6465623752914205,87783.05109489051,9,E01003853,2,6,1,8,8,6,5.902738223905149,5.1230627522952314,5.699835060299307,4.688819644243821,5.551233138727105,6.131561673205832,5.736011077528414,112114.48550724638,8,3,6,0,8,8,7,1.0,-1,1,0,-1,0,0,1
3765,5.724688230362614,5.136814073123763,5.694361447233014,4.780850733275962,5.479024169719325,6.041985737538971,5.572779441301802,86232.6017699115,6,E01003854,3,6,2,5,5,5,5.63592997992911,5.115081588427226,5.716237380252621,4.725370452656009,5.38590334779848,6.044798451710522,5.5857358444027785,110234.67479674796,6,3,7,0,5,6,5,1.0,0,0,1,-2,0,1,0
3766,5.570590250506372,5.355678030830657,5.420104375142537,4.922770231069919,5.442363977432251,5.88844697846624,5.379658690469707,191593.67065868265,4,E01003855,6,2,5,4,3,2,5.50605120930647,5.390143088108517,5.4408065389475055,5.009122392674184,5.408932964418836,5.889193072837869,5.412920341590525,243084.27461139896,4,8,2,6,5,3,2,1.0,0,2,0,1,1,0,0
3767,5.862055320258534,5.036530297830565,5.773556443529391,4.735389418558243,5.501202635808823,6.228038907051086,5.714651304647463,153763.6605504587,7,E01003856,1,7,2,5,8,7,5.787425636208575,4.976432053939156,5.753475674338962,4.820851249280183,5.4329791504403815,6.110427814981212,5.709763028310693,195549.53043478262,7,1,7,2,6,7,7,1.0,0,0,0,0,1,-1,0
3768,5.70906295559623,5.126590705730698,5.773907535455444,4.745672515847466,5.459224719892848,6.172688356854699,5.543027661063454,88943.31818181818,6,E01003857,2,7,2,4,7,5,5.6935878343952515,5.056969651898134,5.761988887509096,4.708056873488195,5.455664252771915,6.192161661907307,5.686347692915537,113530.19417475729,6,2,7,0,6,8,7,1.0,0,0,0,-2,2,1,2
3769,5.795752845069234,5.089617740276248,5.78807980792467,4.704359658928805,5.565204494683317,6.3440913294636925,5.618492735448734,88588.11627906977,7,E01003858,2,7,1,7,9,6,5.740612179785967,5.009321564435959,5.6926585108041765,4.757156984508038,5.4353728540241715,6.24333036839962,5.628720987588167,114745.20625,7,2,6,1,6,9,6,1.0,0,0,-1,0,-1,0,0
3770,5.944323931644165,5.139943063648698,5.792687216615366,4.662409896164938,5.618013065624861,6.308294907114864,5.765544065462998,192819.5816993464,8,E01003859,3,7,1,8,9,8,5.788153493339247,5.060684280968755,5.699154608888053,4.777523021880395,5.5235030038760655,6.261203859673172,5.858104880390272,244666.7486338798,7,2,6,1,8,9,9,1.0,-1,-1,-1,0,0,0,1
3771,5.77595761062902,5.3044061507653755,5.549027131238115,4.8219830891407955,5.476382922141924,6.021172386790634,5.480623851128675,192855.21100917432,6,E01003860,5,4,3,4,5,4,5.782471369682474,5.187476434606187,5.5852636134370846,4.825201073605964,5.44911601746336,6.054557389401375,5.632317787535647,244617.16170212766,7,4,4,2,6,6,6,1.0,1,-1,0,-1,2,1,2
3772,5.437118428724784,5.416091424447519,5.527325941898205,4.989105470092208,5.39564241833157,5.86265361044142,5.322541650136312,192559.2888888889,2,E01003861,7,3,6,3,2,1,5.450282115809965,5.229666069643387,5.532288953168503,5.030221661984526,5.2653748925947985,5.929316287798597,5.481517655170516,244225.34437086093,3,5,3,6,2,4,3,1.0,1,-2,0,0,-1,2,2
3773,5.631694037135285,5.220747853269671,5.6297361850738525,4.814124806092517,5.426019636711271,6.059749445112625,5.5051459664165385,192676.52475247523,5,E01003862,4,5,3,3,6,4,5.662841296907681,5.028834397223458,5.733277996974205,4.804280825515292,5.357862451183262,6.207794314000144,5.759077571221252,244519.6194029851,6,2,7,1,4,8,8,1.0,1,-2,2,-2,1,2,4
3774,5.894823045857184,5.224126284101368,5.700681718049851,4.7876495966869115,5.569917787492803,6.139820476548862,5.627237498232748,193389.81415929203,7,E01003863,4,6,3,7,7,6,5.666277975595298,5.316700593764041,5.538467677701421,5.018326797405211,5.348013228728991,6.052424514994902,5.7062897942647215,245341.16806722688,6,6,3,6,4,6,7,1.0,-1,2,-3,3,-3,-1,1
3775,5.984464999334312,5.135830335411025,5.7223978565063005,4.652263343334198,5.6622718337141436,6.1744704290672585,5.571796773392477,191564.85185185185,8,E01003864,3,6,0,8,7,5,5.909952394949283,5.084320807717537,5.715813062230095,4.744037782559629,5.574920032845169,6.20839198690946,5.786144982270204,243016.4699453552,8,3,7,1,9,8,8,1.0,0,0,1,1,1,1,3
3776,5.786659805862992,5.176009902247676,5.670511036743353,4.713999677587439,5.460780944353268,6.179499564347444,5.629355467396018,192698.76543209876,6,E01003865,3,6,1,4,7,6,5.574575194606075,5.08886092680472,5.673124077879352,4.807857672373454,5.391256974067217,6.12582086339409,5.656939993669957,244457.25925925927,5,3,6,1,5,7,6,1.0,-1,0,0,0,1,0,0
3777,6.1124629398872115,5.106798611838242,5.813025433441688,4.53619947515685,5.617101928283429,6.374535108434743,5.7339995770618835,195084.4051724138,9,E01003866,2,7,0,8,9,8,5.986766978314049,4.969664609223082,5.850260797299836,4.684355722184767,5.535065159463046,6.283002234341805,5.79060517486773,247651.4649122807,9,1,8,0,8,9,8,1.0,0,-1,1,0,0,0,0
3778,5.629030475368747,5.385226130485535,5.489173284340731,4.919871127450621,5.451178293207507,5.9792902934086785,5.4915063938537205,220698.40692640693,5,E01003867,7,3,5,4,4,4,5.576284007722163,5.2794200970357155,5.5317370487874244,4.973137562493404,5.305524896815479,5.99457387335272,5.6186319171669945,283767.796812749,5,6,3,5,3,5,5,1.0,0,-1,0,0,-1,1,1
3779,5.7998957318707935,5.0482432369358285,5.794311771708086,4.773427492330883,5.555129349724321,6.1712287891009625,5.623565257088212,194581.67768595042,7,E01003868,1,7,2,6,7,6,5.758214368964687,4.995984559709376,5.8497104662837405,4.726529635263212,5.4294818712003305,6.19498085975647,5.748942787900115,247047.60606060605,7,1,8,0,6,8,8,1.0,0,0,1,-2,0,1,2
3780,5.992586051931187,5.277344499315534,5.565716455177385,4.726073726707575,5.5899408739440295,6.148399396818512,5.686353861069192,203072.00510204083,8,E01003869,5,4,2,7,7,7,5.8674410004421595,5.2322066504491405,5.588101862782267,4.809247234288384,5.46261911208813,6.161233024899237,5.772369637748235,259539.83257918552,8,5,4,2,7,8,8,1.0,0,0,0,0,0,1,1
3781,5.870532612851325,5.231146922136875,5.721081644930738,4.700536696834767,5.5962124530305255,6.146809350936971,5.667396506096455,221521.585106383,7,E01003870,4,6,1,7,7,7,5.641877772907416,5.232160791754723,5.595621721943219,4.951212350527445,5.375267213582992,6.084381660322348,5.648436797161897,284915.8,6,5,4,4,4,7,6,1.0,-1,1,-2,3,-3,0,-1
3782,5.79044234752655,5.221809648099493,5.613353182057866,4.787010083433057,5.476657981755303,5.9958056719576724,5.5382687703507845,194975.69672131148,6,E01003871,4,5,3,4,4,5,5.794298536144197,5.1272923201322556,5.722911551594734,4.81149070058018,5.407234840095043,6.055706107988954,5.682868706993759,247516.25,7,3,7,2,5,6,7,1.0,1,-1,2,-1,1,2,2
3783,5.895355795148158,5.303379834479119,5.590695661228296,4.777199134555967,5.531397196923802,5.946058281644463,5.563129546340376,194530.17903930132,7,E01003872,5,4,2,6,4,5,5.827597582096956,5.223880490964773,5.51769305151336,4.867781011912287,5.507237799800172,6.012274899774668,5.609738170857332,246943.73469387754,8,5,3,3,8,5,5,1.0,1,0,-1,1,2,1,0
3784,5.851118706970763,5.061520827759941,5.765987063483369,4.756688279213665,5.5626833816226435,6.065783598440157,5.61117692388219,195979.20143884892,7,E01003873,2,7,2,7,6,6,5.733180143537313,5.147360982686064,5.7338022263380735,4.794456461920356,5.488179333888701,6.032218830428854,5.721260936590877,248757.07299270073,7,4,7,1,7,6,7,1.0,0,2,0,-1,0,0,1
3785,5.659161045172504,5.181860312123165,5.76905039760554,4.777250619692223,5.5740167114222166,6.0581507237158085,5.443126218341221,196975.21495327103,5,E01003874,3,7,2,7,6,3,5.578979104757309,5.1383903076251345,5.664571166038513,4.882895293831825,5.471101158857346,5.879341795047124,5.479317769408226,250250.66666666666,5,3,6,3,7,3,3,1.0,0,0,-1,1,0,-3,0
3786,6.107013502120972,5.256181975205739,5.66627259572347,4.680760474999746,5.680352571805318,6.151318687597911,5.687569062709809,194755.33333333334,9,E01003875,4,5,1,9,7,7,5.903834347149835,5.218870848866564,5.684675426339385,4.739583239483474,5.5146899726522625,6.172138620261571,5.743949389337894,247685.0703517588,8,5,6,1,8,8,7,1.0,-1,1,1,0,-1,1,0
3787,5.6653171092568835,4.99210263447112,5.800662532597285,4.833038148293859,5.625941004467961,5.9012636053205725,5.486148722544065,195546.4784053156,5,E01003876,1,7,4,8,3,4,5.70673667583145,4.948021876043966,5.750905080335815,4.801253775588605,5.593483544531322,5.936610846292405,5.595110283846281,248314.06722689077,7,1,7,1,9,4,5,1.0,2,0,0,-3,1,1,1
3788,5.928276114047519,5.102060679405454,5.815627461387997,4.694071794313098,5.64561803189535,6.155221668500749,5.640188031726414,197442.0634920635,8,E01003877,2,7,1,8,7,6,5.788768232378185,5.073346952087859,5.797975391404242,4.690599377338703,5.53489216372498,6.09241567310105,5.834750349705036,250872.90598290597,7,2,8,0,8,7,8,1.0,-1,0,1,-1,0,0,2
3789,6.096045017242432,5.146645991425765,5.803802744786542,4.588685731242474,5.659321446167795,6.1354365599782845,5.7652668684048765,197070.72180451127,9,E01003878,3,7,0,8,7,8,5.925951438239126,5.267758250958992,5.583025300864017,4.749153186335708,5.438956612529177,6.017544895229918,5.696996248129643,250342.53333333333,9,6,4,1,6,5,7,1.0,0,3,-3,1,-2,-2,-1
3790,6.257731412705921,5.07614125637781,5.860807216735113,4.524206802958534,5.70876646723066,6.239025327137538,5.882726131166731,197391.9714285714,9,E01003879,2,8,0,9,8,9,6.213254073344239,5.15265494858453,5.767908363167299,4.694264391146668,5.617697155803715,6.118642190180787,5.842172646741255,250779.35779816515,9,4,7,0,9,7,9,1.0,0,2,-1,0,0,-1,0
3791,6.09510148097487,5.151746720952146,5.754382596296423,4.6246740537531235,5.717004698865554,6.3315335775122925,5.82925359203535,225621.17647058822,9,E01003880,3,7,0,9,9,9,5.857367856722129,5.180890297419147,5.64745983873543,4.791131305851434,5.529770029218573,6.187067132247122,5.799191959594426,289929.5394736842,8,4,5,1,8,8,8,1.0,-1,1,-2,1,-1,-1,-1
3792,6.070578123899114,5.220998141589581,5.710024452849522,4.604408406571254,5.683162116364345,6.140814541170261,5.7732669707112665,217932.8389261745,9,E01003881,4,6,0,9,7,8,5.840752104694924,5.2425410372487615,5.646676232305805,4.759264665373256,5.484040871764837,6.086288658420691,5.753908010011308,280327.17415730335,8,5,5,1,7,7,8,1.0,-1,1,-1,1,-2,0,0
3793,5.764592205345964,5.0371620655059814,5.720548294110005,4.777865968602995,5.532817781970488,6.164609671970985,5.57036811479643,215706.8659217877,6,E01003882,1,6,2,6,7,5,5.5962428918448825,5.043062889447776,5.68654977890753,4.822396355290567,5.392283178785796,6.075962092286797,5.602376381556193,276494.0483870968,5,2,6,2,5,7,5,1.0,-1,1,0,0,-1,0,0
3794,5.38541795385295,5.311728138759219,5.512514000103391,4.9656383399305675,5.344220779682028,5.811476030843012,5.160840152049887,221405.9448275862,2,E01003883,5,3,6,2,2,0,5.215972646688804,5.305223275453616,5.488589521401968,4.997625425075873,5.160663935618523,5.718922378161015,5.303484867780637,284542.891025641,1,6,2,5,0,0,1,1.0,-1,1,-1,-1,-2,-2,1
3795,5.98003091670499,5.240156623986688,5.6979356189765555,4.716263326677946,5.64535123050803,6.155014373288296,5.625552055269185,225899.24752475249,8,E01003884,4,6,1,8,7,6,5.661471335933759,5.244675764097617,5.536361084534572,4.90235238808852,5.36040679537333,6.05035976607066,5.645721442424334,290492.02403846156,6,5,3,3,4,6,6,1.0,-2,1,-3,2,-4,-1,0
3796,5.935311459832722,5.238440081477165,5.636868109305699,4.675709428886573,5.565738812088966,6.064934326542748,5.6292357254359455,226617.76388888888,8,E01003885,4,5,1,7,6,6,5.8452184120814,5.266526117324829,5.658007032076518,4.879333327611287,5.54802259683609,6.057650005022685,5.626604580879212,291375.05333333334,8,6,6,3,8,6,6,1.0,0,2,1,2,1,0,0
3797,5.8295761856340595,5.107714095423298,5.810794255425853,4.682158388437763,5.486377210386338,6.212198094014199,5.67817035509694,217456.0483870968,7,E01003886,2,7,1,5,8,7,5.6702295002872,5.028755915491549,5.772220560949143,4.826802216164054,5.442903797103934,6.0807531255565275,5.546124248471979,277080.19863013696,6,2,7,2,6,7,4,1.0,-1,0,0,1,1,-1,-3
3798,5.734232411498115,5.091563651249523,5.805437654256821,4.745177261176563,5.547394837651934,6.080750506548655,5.574994398014886,196785.50595238095,6,E01003887,2,7,2,6,6,5,5.629833716919968,5.089974343443716,5.672225735041017,4.9126980377975125,5.410653608471321,5.989399779442302,5.5412474804084395,251565.19553072625,6,3,6,3,5,5,4,1.0,0,1,-1,1,-1,-1,-1
3799,5.967912566318787,5.347576101906865,5.4606388459960336,4.757471804138568,5.591834479098697,5.97743713426933,5.430516989968663,217518.845323741,8,E01003888,6,2,2,7,4,3,5.570953641845062,5.180345152331665,5.606996082099138,4.935623013867741,5.3783241789952845,5.962989665765678,5.5367055841251815,259919.46902654867,5,4,5,4,4,4,4,1.0,-3,-2,3,2,-3,0,1
3800,6.438700665952638,5.473202382912859,5.294834454543889,4.634926363127306,5.769481805618852,6.078011079225689,5.575117509812117,163506.13671875,9,E01003889,8,0,0,9,6,5,6.092870527052191,5.390873063893456,5.3856802043013685,4.801528898436879,5.698978985075563,6.157718736042813,5.658799935513594,211752.22309711287,9,8,1,1,9,8,6,1.0,0,0,1,1,0,2,1
3801,6.018553128763407,5.112433900352285,5.833108855896637,4.691037104911163,5.648246394485986,6.28732285980417,5.768931924795904,221991.90756302522,8,E01003890,2,8,1,8,9,8,5.820037700818933,4.999134328054345,5.819091019423111,4.654551226159801,5.4614769562431,6.189887415844461,5.839976390548374,284528.6956521739,8,1,8,0,7,8,9,1.0,0,-1,0,-1,-1,-1,1
3802,5.938702354888003,5.3021433439083445,5.642433584807161,4.695973646141098,5.614470313409131,6.126464432585025,5.690283075064242,102277.99401197604,8,E01003891,5,5,1,8,7,7,5.816083504655267,5.170479324577892,5.714088131478951,4.807746291834082,5.487182354522964,6.122227605453319,5.772702465623112,124706.22598870056,8,4,7,1,7,7,8,1.0,0,-1,2,0,-1,0,1
3803,6.155901572643182,5.258386181969928,5.5976223099944935,4.5760203620307465,5.6812106931311455,6.154769595871624,5.6732795432082606,196131.15384615384,9,E01003892,4,4,0,9,7,7,6.135908919411737,5.0926378401550085,5.76020015735884,4.69305177475955,5.577123535645975,6.252509424815306,5.7222858957342195,249086.5,9,3,7,0,9,9,7,1.0,0,-1,3,0,0,2,0
3804,5.905284789356872,5.183987748883936,5.6350932243096565,4.682802498775677,5.67235110449965,6.110689995062613,5.696702329781804,195673.79562043794,8,E01003893,3,5,1,8,7,7,5.820407196656982,5.085539209308909,5.743280174127266,4.736952873308267,5.501941214746504,6.149719156436066,5.727281656727862,248462.5,8,3,7,0,7,8,7,1.0,0,0,2,-1,-1,1,0
3805,6.149320335741396,5.055822910202874,5.842107628009938,4.585183029704623,5.684470838970608,6.28324463279159,5.8491813553704155,194278.3777777778,9,E01003894,2,8,0,9,9,9,6.109786726426387,4.889611924040144,5.88644103900246,4.60922912929369,5.596766547016475,6.299655216327612,5.877384926097981,246682.74637681158,9,0,8,0,9,9,9,1.0,0,-2,0,0,0,0,0
3806,6.001233436122085,5.189080333709716,5.753108011592518,4.722542700623021,5.651949310302735,6.190749470392863,5.679456016511628,194633.27878787878,8,E01003895,3,7,1,8,8,7,5.806613735405795,5.094560852251857,5.6216946660754195,4.806739206773689,5.5426761457719,6.06793639746057,5.652964993413672,247085.6746987952,8,3,5,1,8,6,6,1.0,0,0,-2,0,0,-2,-1
3807,5.688241645495097,5.100760528776381,5.688661714129978,4.800099585851034,5.54106561448839,5.918628181881375,5.4722258461846245,196339.9111111111,5,E01003896,2,6,3,6,3,4,5.602727936725227,5.077163130896432,5.658634285050995,4.879332852850155,5.4415817966266555,5.916381416515428,5.472226642102611,249585.2530612245,5,2,6,3,6,3,3,1.0,0,0,0,0,0,0,-1
3808,5.623172681733786,5.152832732861301,5.628849790038832,4.945266344461096,5.466661576047001,6.003421295120056,5.50900611460927,202431.8313253012,5,E01003897,3,5,6,4,5,4,5.49041027080513,5.045148383357568,5.652244171696509,4.906202948735859,5.379602168848415,5.9080329976395936,5.566121858750988,256314.2634730539,4,2,5,3,4,3,4,1.0,-1,-1,0,-3,0,-2,0
3809,5.708089485548545,5.218957440576691,5.61022316718447,4.827085567557293,5.404980537684067,5.971077415390291,5.413428579551586,225914.78260869565,6,E01003898,4,5,3,3,4,3,5.5532721223102675,5.203919582896763,5.48182546099027,4.9832577291462155,5.366435527801514,5.860039346747929,5.451137921048535,290529.38194444444,5,4,2,5,4,2,2,1.0,-1,0,-3,2,1,-2,-1
3810,5.738079278557389,5.354810958659208,5.611289872063531,4.811158101867746,5.519118233963296,6.0191655512209294,5.469250592920515,226154.00925925927,6,E01003899,6,5,3,6,5,4,5.475708950864206,5.290754929627522,5.493787531805511,5.110702665725557,5.33016018112107,5.930689899048002,5.585243821144104,290883.8613861386,4,6,3,7,3,4,5,1.0,-2,0,-2,4,-3,-1,1
3811,5.778769023650516,5.345027141866431,5.54868918446313,4.780706155089151,5.509043188221686,6.0113213800751,5.551631287663384,227313.8628318584,6,E01003900,6,4,2,5,5,5,5.599910963762988,5.311062395035684,5.502293645798623,4.9866623357609585,5.3539163298435035,5.920317816304731,5.5564779161332964,292283.36936936935,5,6,3,5,4,4,4,1.0,-1,0,-1,3,-1,-1,-1
3812,5.674032715459664,5.256406942382455,5.667603652924299,4.906034692501028,5.55397177922229,6.125798846284549,5.588237073272467,225234.91145833334,5,E01003901,4,5,5,6,7,6,5.603822309331796,5.186633563533272,5.675555808642476,4.972368290743877,5.44852164418427,6.115210278747008,5.714535764197714,289652.706185567,5,4,6,5,6,7,7,1.0,0,0,1,0,0,0,1
3813,5.627745246345347,5.244502872228622,5.64680983803489,4.79817798462781,5.456787472421473,6.148147727503921,5.634043676383568,226246.07575757575,5,E01003902,4,5,3,4,7,6,5.417571768164635,5.298263737931848,5.474614035338163,5.095485186204314,5.2453123442828655,5.975307013839483,5.665493613108993,291003.984375,3,6,2,7,2,5,6,1.0,-2,2,-3,4,-2,-2,0
3814,5.634906912007348,5.433047748634918,5.441278245582833,4.930506894690763,5.4474120557111485,5.939311914318072,5.496809925576641,226940.36633663366,5,E01003903,7,2,5,4,4,4,5.7606362590422995,5.344634135869833,5.490120664009681,4.878266933331123,5.431641039940027,5.98913186788559,5.649437595789249,291907.16538461536,7,7,2,3,6,5,6,1.0,2,0,0,-2,2,1,2
3815,5.693605721899957,5.283015015450391,5.665706316630046,4.847456438974901,5.4622687534852465,6.1032001665144255,5.513500920750878,224649.50757575757,5,E01003904,5,5,4,4,6,4,5.4820447256488185,5.3160043262666274,5.505066897599928,5.007970423467698,5.242901957804157,5.9891618067218415,5.5514357311110345,289068.03225806454,4,6,3,5,1,5,4,1.0,-1,1,-2,1,-3,-1,0
3816,5.68493053206691,5.3272247829555,5.519518973650755,4.92928221932164,5.484781404336293,6.055489721857471,5.4864344184781295,220782.57407407407,5,E01003905,6,3,5,5,6,4,5.61732632915179,5.342689409142449,5.52497169091588,4.965197799461229,5.3927432390905565,5.942776434478306,5.639545392422449,283878.34523809527,5,7,3,5,5,4,6,1.0,0,1,0,0,0,-2,2
3817,5.813868467487506,5.352040096005397,5.630939876855309,4.839091588312121,5.496155387430049,6.178274905503685,5.6397185236660405,220515.40298507462,7,E01003906,6,5,4,5,7,6,5.608350958513177,5.256824328415636,5.601476807525192,4.945408896259639,5.359475831190745,6.163595866465914,5.703320593073748,283541.14492753625,5,5,4,4,4,8,7,1.0,-2,-1,-1,0,-1,1,1
3818,5.566682423314741,5.491724901301886,5.365111359985926,4.9882513964048,5.436879410538622,5.918577053213633,5.372543349060961,221193.50537634408,4,E01003907,8,1,6,3,3,2,5.457792276630596,5.428552445708489,5.353665582987727,5.142116095338549,5.2534932117072906,5.847689357339119,5.46562756385122,284413.9081632653,3,8,1,8,2,2,3,1.0,-1,0,0,2,-1,-1,1
3819,5.739104870467158,5.186591163016202,5.683882752357171,4.821710571908114,5.522207216212624,6.20217514177512,5.645851467785082,220937.55555555556,6,E01003908,3,6,3,6,8,6,5.480795378684998,5.121018655640738,5.625470556531634,4.89576383795057,5.336457204818726,6.108954906463623,5.7705213757923675,284094.41142857145,4,3,5,3,3,7,8,1.0,-2,0,-1,0,-3,-1,2
3820,5.678091211606993,5.157589068348776,5.790295952918545,4.87901173582013,5.56954019741724,6.190398907501425,5.712256784407084,221671.93959731545,5,E01003909,3,7,4,7,8,7,5.535073069163731,5.096322546005249,5.660830339704241,4.924353529385158,5.328611022404262,6.0681418589183265,5.719083028520856,285002.2,4,3,6,4,3,6,7,1.0,-1,0,-1,0,-4,-2,0
3821,5.647635884130532,5.427516607137827,5.480514688530431,4.954228996747901,5.386735809959381,6.014787477037685,5.475377136879121,221686.07287449393,5,E01003910,7,2,6,3,5,4,5.611442337559246,5.429394936762781,5.529719468410508,4.9327771100313855,5.32044290087897,6.013138708686024,5.592340501048897,285035.7215189873,5,8,3,4,3,5,5,1.0,0,1,1,-2,0,0,1
3822,5.853374344237308,5.048193742620184,5.668412845185462,4.711257484365017,5.597362675565354,5.971801707085143,5.678123036597637,624208.9574468085,7,E01003911,1,5,1,7,4,7,5.798575232329878,4.959506685293994,5.7512335777282715,4.788087464073329,5.515070250890787,5.961768036907159,5.708212040003064,791950.5145631068,8,1,7,1,8,4,7,1.0,1,0,2,0,1,0,0
3823,5.345147501539301,5.135716802544064,5.540798178425542,5.120813444808677,5.3929339470686735,5.764058086607191,5.503547522756788,615288.3888888889,1,E01003912,3,3,8,3,1,4,5.459992823053579,5.140840065283854,5.534649309564809,5.054341916178093,5.409484497836379,5.786987484478559,5.4161973820358025,780595.524590164,4,3,3,6,5,1,2,1.0,3,0,0,-2,2,0,-2
3824,5.739549963589174,5.049660765981099,5.727210719183267,4.775918411921306,5.59804526869073,5.949685850057257,5.5811801545591235,624676.4939759036,6,E01003913,1,6,2,7,4,5,5.591616351902485,5.032850959897042,5.731742740422487,4.896440060436726,5.411217583715915,5.9709698259830475,5.6341282948851585,792162.7875,5,2,7,3,5,5,6,1.0,-1,1,1,1,-2,1,1
3825,5.9065465880375285,4.913116081088197,5.97589312581455,4.699124925276813,5.5648832905526255,6.202798712487314,5.827845077888639,615543.1470588235,8,E01003914,0,9,1,7,8,9,5.85969285068349,4.858431099826454,6.00042972401676,4.755995778955965,5.522215591536628,6.23822042473361,5.935717162922916,780902.4957264957,8,0,9,1,8,9,9,1.0,0,0,0,0,1,1,0
3826,5.543916672167152,5.069500620919045,5.669471751559865,4.900980212471702,5.502671870318326,5.857306266071821,5.456736544165948,620288.9393939395,4,E01003915,2,6,5,5,2,3,5.597314855456352,5.14613888412714,5.728500121831894,4.948510026931762,5.384557972848415,5.882644097507,5.698371006548404,786787.05,5,4,7,4,5,3,7,1.0,1,2,1,-1,0,1,4
3827,5.370572075247765,5.222501275129616,5.553203534334898,5.033130379393697,5.346866928040981,5.80893462151289,5.40825420152396,615153.0546875,2,E01003916,4,4,7,2,2,3,5.339021006927771,5.154547618592487,5.540337283821667,5.008018035222502,5.381153951672947,5.795570953803904,5.391904370749698,780366.1029411765,2,4,3,5,5,1,2,1.0,0,0,-1,-2,3,-1,-1
3828,5.751323820596718,5.072101100381598,5.702671858201544,4.813810311168073,5.528293316622815,5.995762203113142,5.585059677261904,620916.8795180722,6,E01003917,2,6,3,6,4,6,5.59336359086244,5.104872220236322,5.707238091074902,4.9250955801943075,5.463521099608878,5.899880054204361,5.659813772077146,787525.5869565217,5,3,6,4,7,3,6,1.0,-1,1,0,1,1,-1,0
3829,5.293316666083999,5.524245449259311,5.396134809602665,5.2135627843156644,5.320534152320668,5.692477844938447,5.18763202202471,622718.9746835442,1,E01003918,8,1,9,1,0,0,5.089803560156572,5.373371739136545,5.370062954802262,5.217847535484715,5.340430540787546,5.608534727598491,5.131432498128791,790496.8421052631,0,7,1,9,3,0,0,1.0,-1,-1,0,0,2,0,0
3830,5.617895662784576,5.12476509809494,5.671054323514302,4.915114994634662,5.414904811926055,5.924883453469527,5.384456496489675,626299.8771929825,5,E01003919,2,6,5,3,3,2,5.463880877534883,5.05842427345885,5.722103283184917,4.960434426780508,5.321362342153277,5.869277679619669,5.509056046229451,794467.1512605041,4,2,7,4,3,3,3,1.0,-1,0,1,-1,0,0,1
3831,5.425393764074746,5.22522982219597,5.574825642944931,5.051814265065379,5.372701971561877,5.712213305683879,5.381065816074223,625865.1818181818,2,E01003920,4,4,7,2,0,2,5.3547417348431,5.203331507662291,5.524622878720684,5.051667303167363,5.267228841781616,5.745098957451441,5.358276318478328,793843.8709677419,2,4,3,6,2,1,1,1.0,0,0,-1,-1,0,1,-1
3832,5.352198079689262,5.085284739425502,5.7033654119550565,4.949228189655186,5.475364146773348,5.771020631200259,5.448379355607574,625810.6804123712,2,E01003921,2,6,6,4,1,3,5.2671400183723085,4.978415858177912,5.731452869233631,4.964019669805254,5.360665262313116,5.80315203666687,5.488607801709857,793815.7523809524,1,1,7,5,4,1,3,1.0,-1,-1,1,-1,0,0,0
3833,5.473820015517148,5.228996464339169,5.622523817149076,4.932164882529865,5.458485365997661,5.800420935587449,5.387493679740212,626034.990909091,3,E01003922,4,5,5,4,1,2,5.345334141641049,5.166639497956714,5.588613423141274,5.030014335303693,5.306426666878365,5.782728481937099,5.385467235300992,794129.25,2,4,4,6,3,1,1,1.0,-1,0,-1,1,-1,0,-1
3834,5.553958653017532,5.068161938079568,5.767295295415923,4.877556699653004,5.576859820720761,5.917841814285101,5.569958115732947,626528.1162790698,4,E01003923,2,7,4,7,3,5,5.66829762401351,4.972975742386048,5.792060208607869,4.881259435630707,5.415767747235585,5.887951853763626,5.59321965366961,794662.8554216868,6,1,8,3,5,3,5,1.0,2,-1,1,-1,-2,0,0
3835,5.306599605541963,5.192777395248413,5.599170891138224,5.005942644981237,5.474988886943231,5.774581152659196,5.336659009640034,626337.1153846154,1,E01003924,3,4,7,4,1,2,5.350294197306914,5.088680940515855,5.710445165634155,4.941643539597006,5.353691236645568,5.731792454626046,5.384022771143446,794467.5294117647,2,3,6,4,4,1,1,1.0,1,0,2,-3,0,0,-1
3836,5.1796330457383934,5.387004613876343,5.351465655998751,5.20050203258341,5.242386225949634,5.694665958935564,5.15889712897214,624773.375,0,E01003925,7,1,9,0,0,0,5.2690411293229396,5.315956778304521,5.591383703919345,5.091625585112461,5.289219692695973,5.8155470532040265,5.353213982526646,792509.3139534884,1,6,4,7,2,2,1,1.0,1,-1,3,-2,2,2,1
3837,5.3498659012269,5.310701257112075,5.505440541676113,5.104089575154441,5.301274575749222,5.770643928829505,5.373953827789852,627192.306122449,1,E01003926,5,3,8,1,1,2,5.477563658513521,5.237256060148541,5.551983820764642,4.969780358515288,5.376975087115639,5.733240284417805,5.36789777780834,795553.0736842105,4,5,4,5,4,1,1,1.0,3,0,1,-3,3,0,-1
3838,5.0531433661353775,5.151533991257774,5.540972265542722,5.120727568386711,5.347475720811867,5.608112515825214,5.298453200097177,623033.4171122995,0,E01003927,3,3,8,2,0,1,5.166841083957303,5.081663908112434,5.597152771872858,5.109533683715328,5.293298384835643,5.612006184747142,5.358750281795379,790444.135483871,0,2,4,7,2,0,1,1.0,0,-1,1,-1,0,0,0
3839,5.261371555758137,4.876459030122716,5.776705319277719,5.028190417351129,5.5104640092972526,5.71106685947451,5.408800524191795,590713.4978540773,1,E01003929,0,7,7,5,0,3,5.298236164018567,4.8071157214366815,5.783050888533043,5.0104170080454375,5.412149001674581,5.719924980379835,5.573748045251272,751958.4237918216,1,0,7,6,5,1,5,1.0,0,0,0,-1,0,1,2
3840,5.420120004380103,5.025498219055705,5.730658221952986,4.978420590410138,5.427705937092847,5.834030699021746,5.534418944084998,625175.6633663366,2,E01003930,1,6,6,3,2,5,5.4115985461643765,5.002899666059585,5.580996226129078,4.9721019075030375,5.394740615572248,5.801038564954485,5.484873416310265,792605.9238095238,3,1,4,5,5,1,3,1.0,1,0,-2,-1,2,-1,-2
3841,5.484566407688593,5.010191121343839,5.7669809834431796,4.9155664322739945,5.605139403019921,5.82884828519013,5.495436637078301,623847.3813559322,3,E01003932,1,7,5,7,2,4,5.39189350605011,5.029374338612698,5.714397451665142,4.997644291065707,5.401671204236474,5.818660806901384,5.5758029836239205,791369.0,3,2,7,5,5,2,5,1.0,0,1,0,0,-2,0,1
3842,5.543403177034287,5.052335176439512,5.779500624963215,4.8474544655709035,5.470509517760504,5.916759394464039,5.5028384036961056,627490.8095238095,4,E01003933,1,7,4,4,3,4,5.785604764544774,4.975143414956552,5.861720372760106,4.805956193378994,5.494217254497387,5.990576226875265,5.722881664044012,799169.7566137566,7,1,8,1,7,5,7,1.0,3,0,1,-3,3,2,3
3843,5.104401481778998,5.199288007111577,5.56650535893022,5.132032571480289,5.307333298593933,5.592426325145521,5.4258115932955375,366071.3333333333,0,E01003934,3,4,8,1,0,3,5.233339667896142,4.979978565432599,5.612523042061478,5.199207494224328,5.296815035423795,5.722666554980808,5.534465018101937,479508.9130434783,1,1,5,9,2,1,4,1.0,1,-2,1,1,1,1,1
3844,5.17846713747297,5.044736364909581,5.655627468654088,5.042737387475514,5.40599110580626,5.728279864220392,5.452426648139953,385641.49523809523,0,E01003935,1,5,7,3,1,3,5.416688431481846,4.928715632587183,5.621874658787837,5.012311184992556,5.419510987938428,5.677589582615211,5.514836100281262,518199.4016393443,3,1,5,6,6,0,3,1.0,3,0,0,-1,3,-1,0
3845,5.645342531957124,4.8969233224266455,5.70394425141184,4.809209418296814,5.487040480814482,5.902684455168875,5.806390965612311,623591.5578947369,5,E01003936,0,6,3,5,3,8,5.753757481722488,4.944041100973935,5.722167071607924,4.832562660433583,5.503229738510761,5.898097864131338,5.86361450755719,791138.6701030928,7,1,7,2,7,3,9,1.0,2,1,1,-1,2,0,1
3846,5.5528932351332445,5.098834333053002,5.648168534498948,4.924083751898546,5.507380384665269,5.802507580243624,5.5506656573368955,623600.5538461539,4,E01003937,2,5,5,5,1,5,5.5355269877941575,5.162190894027809,5.6480508082872865,5.003685623020321,5.4515837322581895,5.85511690610415,5.555415958553166,791169.5974025974,4,4,5,5,6,2,4,1.0,0,2,0,0,1,1,-1
3847,5.680341665337726,5.082975121532998,5.695195558594494,4.870385380779824,5.511292085414979,5.892555292059735,5.568986981380276,623508.5731707317,5,E01003938,2,6,4,5,3,5,5.667946980549739,5.087272654741239,5.654631617741707,4.926864640835004,5.532041372397007,5.826672523449629,5.557142671866295,791023.4102564103,6,3,5,4,8,2,4,1.0,1,1,-1,0,3,-1,-1
3848,5.287406032149856,5.029523171820082,5.71254360997999,5.027882495441952,5.461879541208078,5.757461162300797,5.402632383612899,623196.8288288289,1,E01003939,1,6,7,4,1,2,5.382422688706168,4.960428214278714,5.669387698173523,5.047153341359105,5.393465376105802,5.797561184085649,5.5350750273671645,790674.8534482758,3,1,6,6,5,1,4,1.0,2,0,0,-1,1,0,2
3849,5.598531301021576,5.296444675922394,5.623042707443237,4.877778272628785,5.471493153572083,5.927664351463318,5.487742369174957,622556.02,4,E01003940,5,5,4,4,3,4,5.695003051024217,5.104657471179962,5.728384467271658,4.915489254089502,5.452899213020618,5.889260292053223,5.593950317456172,789720.1538461539,6,3,7,4,6,3,5,1.0,2,-2,2,0,2,0,1
3850,5.323156424243041,5.126326967971494,5.61719194084707,5.05577340631774,5.294349076771977,5.735242234336005,5.381019646471197,618375.6262626263,1,E01003941,2,5,7,1,1,2,5.338012174804612,5.113577616096723,5.668619221980029,5.024592465693408,5.337365910558417,5.782248081547199,5.420529988732668,783494.5742574257,2,3,6,6,3,1,2,1.0,1,1,1,-1,2,0,0
3851,5.366195006697786,5.2845901881947235,5.468845884005229,5.133879737526763,5.379884889312819,5.725780818976608,5.451720127872393,623780.8235294118,2,E01003942,5,2,8,2,1,3,5.327787335713705,5.130037217670017,5.598019483354356,5.058940193388197,5.395091072718302,5.848768414391412,5.597011497285631,790772.4,2,3,4,6,5,2,5,1.0,0,-2,2,-2,3,1,2
3852,5.735769625810477,5.127899965873131,5.711891056941106,4.735306369341337,5.611899220026457,5.9555598919208235,5.459370378347543,623906.0923076923,6,E01003943,2,6,2,8,4,3,5.5533489849832325,5.027906520499124,5.654831965764363,4.891317539744907,5.5157594084739685,5.85053190920088,5.553285456366009,791454.3194444445,5,2,5,3,8,2,4,1.0,-1,0,-1,1,0,-2,1
3853,5.889334400269118,5.342764879492196,5.40907823768529,4.789122780615633,5.582194369624961,5.935163831168955,5.508413490923968,301631.6534090909,7,E01003945,6,1,3,7,3,4,5.964506875608385,5.293441290093451,5.468668432579827,4.813988123357911,5.476219267574782,5.958674283371758,5.646028038767195,388467.1546391753,9,6,2,2,7,4,6,1.0,2,0,1,-1,0,1,2
3854,6.060229538961221,5.314860659246226,5.457231696325404,4.681456557666983,5.6437453040639864,6.022646130496309,5.636913753647841,569531.5877862596,9,E01003946,5,2,1,8,5,6,6.111388938319414,5.225267326921449,5.650460188102005,4.705128649123629,5.642094935689654,6.17874875104517,5.716903099440094,728625.947368421,9,5,5,0,9,8,7,1.0,0,0,3,-1,1,3,1
3855,5.670857529429829,5.3880760126254135,5.379180661019157,4.942813648897059,5.473554246565875,5.900381445884705,5.530252221752615,532563.8823529412,5,E01003947,7,1,6,4,3,5,5.783933957754555,5.321522696543548,5.484452826491857,4.8899384383427895,5.536313010474383,5.971042972500041,5.498761577121282,682360.6016949152,7,7,2,3,8,5,3,1.0,2,0,1,-3,4,2,-2
3856,6.034051543251079,5.403569345805734,5.36036112984234,4.7238063927002765,5.580387812884734,5.885479404964549,5.571687761475058,355829.98930481286,8,E01003948,7,1,1,7,3,5,6.096713852056693,5.282963087548425,5.507689971944471,4.795955452568087,5.553930393029085,5.9885041708554025,5.596339135458975,421609.83116883115,9,6,3,1,8,5,5,1.0,1,-1,2,0,1,2,0
3857,6.094680233248349,5.056086931763025,5.906354602040915,4.562181451197328,5.73515518061046,6.274606086056808,5.9235087735899565,295284.7413793103,9,E01003949,2,8,0,9,8,9,5.978341817855835,5.034026222698616,5.827433203205918,4.724525380315202,5.587647060553233,6.148599445819855,5.916551434632503,379062.8333333333,9,2,8,0,9,8,9,1.0,0,0,0,0,0,0,0
3858,5.907081733489859,5.184254549700638,5.574424268870518,4.754064301992285,5.638162582085051,6.115263932737811,5.592737582223169,297865.0689655172,8,E01003950,3,4,2,8,7,6,5.911642235336882,5.174687575210225,5.551703714060061,4.7371422169786515,5.545130338632699,6.022900678894737,5.693864703178406,383159.9393939394,8,4,4,0,8,6,7,1.0,0,1,0,-2,0,-1,1
3859,5.992912874106438,5.351664370106112,5.4131039525232,4.804416309921972,5.577027117533069,5.97789829200314,5.632367203312535,561949.5887096775,8,E01003951,6,2,3,7,4,6,6.0560230419039724,5.226201444367567,5.607802881797155,4.696523294349512,5.6194981833299,6.125380922357241,5.7285661141077675,705031.3958333334,9,5,5,0,9,7,7,1.0,1,-1,3,-3,2,3,1
3860,5.426573591646941,5.048524317534073,5.805665333374687,4.817419583901115,5.362686238081559,5.993324793940005,5.452148962020874,534714.4173913044,2,E01003952,1,7,3,2,4,3,5.406494237210628,4.916113318317998,5.884069467112965,4.887935376515354,5.37229853302893,5.941361389020933,5.5740738289199605,699291.394160584,3,1,8,3,4,4,5,1.0,1,0,1,0,2,0,2
3861,5.7532822367472525,5.018957518614256,5.873976634098933,4.763487212933027,5.527512840735606,6.123659166005941,5.632371671688863,527764.0705128205,6,E01003953,1,8,2,6,7,6,5.7407876676356295,4.87812763699413,5.911309391789183,4.7192647344261935,5.4672197773611755,6.136845042719644,5.744400605647521,655467.6035502958,7,0,9,0,7,8,8,1.0,1,-1,1,-2,1,1,2
3862,5.616393542808035,5.007930785417557,5.79527374195016,4.700636880553287,5.499522253223088,6.059546675371087,5.526238998641139,359580.39130434784,4,E01003954,1,7,1,5,6,5,5.52172301547362,4.942645323158491,5.8954349579197345,4.774084661266591,5.368574085802135,6.045835070090718,5.602592838872777,460548.9702970297,4,1,8,1,4,6,5,1.0,0,0,1,0,-1,0,0
3863,5.755080376901934,5.148542657975228,5.87811626349726,4.696974906229204,5.571402093095164,6.193374385756831,5.616550803184509,296221.75,6,E01003955,3,8,1,7,8,6,5.701347226002177,4.896303828622474,5.881704922582283,4.780219574443629,5.486468771442038,6.0001995172656954,5.742609776434351,380092.3032786885,7,0,8,1,7,5,7,1.0,1,-3,0,0,0,-3,1
3864,5.791082788705825,5.01073083281517,5.872690691947937,4.663496831655502,5.55799135684967,6.182538874149323,5.620904592275619,480628.59,7,E01003956,1,8,1,6,7,6,5.596803406010503,4.992494225502014,5.8368915345357815,4.734436383713847,5.385784221732098,6.079670019771742,5.668369285438372,600735.75,5,1,8,0,5,7,6,1.0,-2,0,0,-1,-1,0,0
3865,6.0249289732712965,5.091651515646295,5.926506322818798,4.6552503279277255,5.666470705807864,6.441632624510881,6.0436011618310275,296523.6703296703,8,E01003957,2,9,1,8,9,9,5.899961391091347,4.9779415905475615,5.900092396140098,4.767774516344071,5.57696887254715,6.334765446186066,5.9671259194612505,380451.2875,8,1,9,1,9,9,9,1.0,0,-1,0,0,1,0,0
3866,5.8446392603218555,5.059287246316671,5.938504885882139,4.721561110578477,5.614165420643985,6.217659577727318,5.813461307436228,321901.046875,7,E01003958,2,9,1,8,8,9,5.771840121295001,5.027395209750614,5.942804920780766,4.707251677641997,5.5105141798655195,6.161785072034544,5.87367041476138,398853.57657657657,7,2,9,0,8,8,9,1.0,0,0,0,-1,0,0,0
3867,5.590267629662821,5.201347122507647,5.551327698486896,4.975681007401017,5.437385596519659,5.793061585465739,5.4652030635471185,622136.2396694215,4,E01003960,3,4,6,4,1,4,5.247812586360507,5.369379138946533,5.335713013013204,5.263584274715847,5.20496998363071,5.607828701866998,5.28882392777337,783517.6666666666,1,7,1,9,1,0,0,1.0,-3,4,-3,3,-3,-1,-4
3868,5.4135551392603265,5.2249018511326195,5.614799804824719,5.090391791124138,5.3876889472385106,5.81054130389536,5.372019140840434,622675.1870503597,2,E01003961,4,5,8,3,2,2,5.211722779273987,5.142616896068349,5.52570372469285,5.182149525249706,5.212478883126202,5.6880709227393655,5.248505712957943,788432.9647058824,1,3,3,8,1,0,0,1.0,-1,-1,-2,0,-2,-2,-2
3869,5.416155031094184,5.139481718723591,5.547691239760472,4.97085398206344,5.531736607734974,5.789886781802545,5.309045211626933,625110.4038461539,2,E01003963,3,4,6,6,1,1,5.305617809295654,5.100885220936367,5.42789668128604,5.020572037923904,5.480749436787197,5.752086889176142,5.3568740629014515,793856.4761904762,2,3,2,6,7,1,1,1.0,0,0,-2,0,1,0,0
3870,5.561510656404932,5.282933896287866,5.4358588785206505,5.001078752749557,5.412499491774708,5.740973451815614,5.395473974013547,520595.94036697247,4,E01003964,5,2,7,3,1,2,5.518963491243701,5.260099760947689,5.5040693004285135,5.047564714666335,5.40319258214966,5.812939167022705,5.39186181849049,647066.5604838709,4,5,3,6,5,2,2,1.0,0,0,1,-1,2,1,0
3871,5.292420245947376,5.150820898432886,5.5685261295687765,5.067578153264138,5.340494770196177,5.702991908596408,5.279828204262641,617550.75,1,E01003966,3,4,8,2,0,1,5.2962648116105,5.129087054137642,5.5405196839190545,5.065423379553125,5.349644088576026,5.707915077818201,5.321255554544165,783491.7234042553,1,3,3,7,4,0,1,1.0,0,0,-1,-1,2,0,0
3872,5.32625117057409,5.380219636819302,5.372828984871889,5.049169818560283,5.282238391729502,5.753126034369836,5.362262936738821,625386.5897435897,1,E01003967,7,1,7,1,1,2,5.027841369311015,5.283359708208026,5.29119721325961,5.249441883780739,5.121506094932556,5.594780972509673,5.19229307680419,793222.2424242424,0,6,0,9,0,0,0,1.0,-1,-1,-1,2,-1,-1,-2
3873,5.234532426084791,5.426611692564828,5.456270657266889,5.112615178312574,5.304039265428271,5.694388978821891,5.123868824754442,619184.6428571428,0,E01003968,7,2,8,1,0,0,5.288307268278939,5.451170674392155,5.3679426499775476,5.276545514379229,5.246820259094238,5.665753715378898,5.232853443281991,786117.0428571429,1,8,1,9,2,0,0,1.0,1,1,-1,1,1,0,0
3874,5.368821453603899,5.157509765269594,5.535174323164898,5.026442358952872,5.387275608429998,5.710230694054077,5.259351393450862,624516.2546583851,2,E01003969,3,3,7,3,0,1,5.330943103422198,5.078219540635048,5.55394891200707,5.06532543165642,5.297573904544986,5.6986452801185745,5.395548256517154,792177.649122807,2,2,4,7,2,0,2,1.0,0,-1,1,0,-1,0,1
3875,5.366920525497861,5.35951493051317,5.495060775015089,5.186550364229414,5.35763764778773,5.721001227696736,5.207377937104967,620873.1555555556,2,E01003970,6,3,9,2,1,0,5.405084439894048,5.354203812959717,5.512553925921277,5.121199927678922,5.2521112910131125,5.648969443832955,5.22101081144519,787748.3048780488,3,7,3,8,2,0,0,1.0,1,1,0,-1,0,-1,0
3876,5.13239208941764,5.411486671326008,5.2320074451730605,5.318650892440309,5.258863799115445,5.513216109986001,5.154102416748696,620017.3829787234,0,E01003971,7,0,9,0,0,0,5.087404968738556,5.419625785350799,5.40369951248169,5.299015011787414,5.242295079231262,5.572731394767761,5.054146904945373,785701.62,0,8,1,9,1,0,0,1.0,0,1,1,0,1,0,0
3877,5.86123583146504,4.814902354989733,5.87019122328077,4.661367176260267,5.616427115031651,6.207796703066145,5.64962443794523,625697.0,7,E01003972,0,8,1,8,8,7,5.894546318698573,4.876640118457176,5.91844130851127,4.719100359323862,5.583612867303796,6.187358050732999,5.765189522021526,793653.5945945946,8,0,9,0,9,8,8,1.0,1,0,1,-1,1,0,1
3878,5.362005175049625,5.184213307366442,5.630318538466496,4.994618673822773,5.396696843318085,5.723204274675739,5.271268049282814,625793.8208955224,2,E01003973,3,5,6,3,1,1,5.319916784763336,5.038626639466536,5.5834871499161975,5.0568973735759135,5.410187840461731,5.695999299225054,5.324660749811875,793828.4342105263,2,2,4,6,5,0,1,1.0,0,-1,-1,0,2,-1,0
3879,5.265487087306692,5.357238600503153,5.503919087239166,5.203501745836059,5.330895824218864,5.653952947303431,5.135936244210201,624981.2537313433,1,E01003974,6,3,9,1,0,0,5.204962411347558,5.408901204081142,5.391065148746266,5.234191373867147,5.206857118536444,5.557852103429682,5.191940437344944,792835.9264705882,1,8,1,9,1,0,0,1.0,0,2,-2,0,0,0,0
3880,5.239331327288983,5.237359647291252,5.492089555924197,5.144644859325455,5.317539299827025,5.720643373857062,5.374172643006566,616545.5060240964,1,E01003975,4,3,9,1,1,2,5.392860120818728,5.156765808377947,5.586792080742972,5.047145415487743,5.420963450840541,5.794477876027425,5.414211794308254,782157.619047619,3,4,4,6,6,1,2,1.0,2,0,1,-3,5,0,0
3881,5.154210760116577,5.213907739639282,5.542944973945618,5.059998600006104,5.370163938522339,5.659284963607788,5.320053936958313,617222.96,0,E01003976,4,3,8,2,0,1,5.255579149377519,5.127661793128304,5.527063220307447,5.078097933444424,5.377082234707432,5.68910116561945,5.44073367205219,782973.6811594203,1,3,3,7,4,0,2,1.0,1,-1,0,-1,2,0,1
3882,5.278860827068706,5.403606924381885,5.558541802259592,5.058840545979175,5.428738275727073,5.745661284897354,5.22486946608994,422361.7912087912,1,E01003977,7,4,8,3,1,0,5.259802198410034,5.2606940578011905,5.440635742860682,5.160222698660458,5.258303653492647,5.745839403657352,5.363452044655295,559192.7764705883,1,5,2,8,2,1,1,1.0,0,-2,-2,0,-1,0,1
3883,5.454869286848767,5.243516194938433,5.557799259034714,4.971733372990448,5.451491733588795,5.784210580410344,5.326236770884825,600907.7425742574,3,E01003978,4,4,6,4,1,1,5.511537150903181,5.1522617941060345,5.563629599642162,5.022647917763261,5.414481881236242,5.856554527913243,5.4629104511796935,765814.0413223141,4,4,4,6,5,2,3,1.0,1,0,0,0,1,1,2
3884,5.275157096909314,5.312296039136029,5.429162159198668,5.100579103941701,5.348941391768771,5.714242333734492,5.251734934617418,617465.3797909408,1,E01003979,5,2,8,2,1,1,5.296492437793784,5.119856081596793,5.465703941371343,5.094451392350131,5.285445229647911,5.763058486050123,5.336108053383762,783254.6849315069,1,3,2,7,2,1,1,1.0,0,-2,0,-1,0,0,0
3885,5.235139299574352,5.3967077902385165,5.3506709030696324,5.221602254822141,5.332502145994277,5.610423485438029,5.134599014690944,616868.8666666667,0,E01003980,7,1,9,1,0,0,5.188579657903085,5.297133279534487,5.2567856300335665,5.2108634526912985,5.193097724364354,5.541758082233942,5.24913845039331,782617.0288461539,0,6,0,9,1,0,0,1.0,0,-1,-1,0,0,0,0
3886,5.2766763637031335,5.04089616778968,5.606068400369174,5.074540432812511,5.458123345305954,5.647491479265517,5.375245493391286,622652.231884058,1,E01003981,1,4,8,4,0,2,5.371776283523182,4.974557922210223,5.734481225779027,5.032763493649753,5.389594847037468,5.759882383140517,5.50004318319721,789840.1975308642,2,1,7,6,5,1,3,1.0,1,0,3,-2,1,1,1
3887,5.404525536511626,5.2857896110841205,5.57758073082992,4.996048627155168,5.397465427006994,5.858867760215487,5.276282364768641,293884.84821428574,2,E01003983,5,4,6,3,2,1,5.363095344437493,5.175381237489206,5.653878986393964,5.0666424972039685,5.297580657181917,5.885414821130258,5.35428195087998,377233.8,2,4,5,7,3,3,1,1.0,0,-1,1,1,0,1,0
3888,5.421531098000956,5.228918941228982,5.537373017944746,4.983623353426888,5.382020899113392,5.844033666105078,5.362417380281743,289357.14093959733,2,E01003984,4,3,6,2,2,2,5.394349701651212,5.144102893204525,5.606257372889026,4.935993490547969,5.271967265523713,5.871996846692316,5.503328392423432,371826.9034482759,3,3,5,4,2,3,3,1.0,1,-1,2,-2,0,1,1
3889,5.178993714483161,5.30897537909056,5.408400595815558,5.184649861486334,5.30818446309943,5.5719629438299885,5.179046107593336,292479.15789473685,0,E01003986,5,1,9,1,0,0,5.12011745373408,5.289358133739896,5.419450083043841,5.1928661717308895,5.192530239952935,5.57819953362147,5.268860610326131,375495.4666666667,0,6,1,8,1,0,0,1.0,0,1,0,-1,0,0,0
3890,5.301838978428707,5.214037351519148,5.4867099946904405,5.100290208219368,5.334720207151966,5.803832885260894,5.310393394710862,292726.5140186916,1,E01003987,4,3,8,2,1,1,5.316806195018528,5.117247475160135,5.456390046858573,5.16199761897594,5.258093045638488,5.897615673305752,5.417217697109188,375815.01801801805,2,3,2,8,2,3,2,1.0,1,-1,-1,0,0,2,1
3891,4.9988580813407895,5.534520559310913,5.230959118843079,5.310896331787109,5.157116341114044,5.456720667362213,4.931226750850677,293207.704,0,E01003988,9,0,9,0,0,0,4.969565044710602,5.44742790253266,5.33062242684157,5.313805265703063,5.085126093764236,5.520098904768626,5.122685443663943,376331.72826086957,0,8,1,9,0,0,0,1.0,0,-1,1,0,0,0,0
3892,4.958352984587352,5.3761008326212565,5.281994142532349,5.258427687486013,5.216265546480814,5.523224898179373,5.080228626728058,293489.7866666667,0,E01003989,6,0,9,0,0,0,5.073126359830929,5.348250753517393,5.346822421007518,5.248547887500329,5.063820208175273,5.561097113392021,5.302412358265888,376719.6898734177,0,7,1,9,0,0,1,1.0,0,1,1,0,0,0,1
3893,5.339549205265939,5.417167321778834,5.434634417295456,5.061426680535078,5.32708868663758,5.72367881052196,5.212821673601866,293901.109375,1,E01003990,7,2,8,1,1,0,5.322466943087994,5.304076843613746,5.503508500604822,5.076318068792356,5.302090914457437,5.762201336406221,5.26805026179192,377303.22147651005,2,6,3,7,3,1,0,1.0,1,-1,1,-1,2,0,0
3894,5.512903685000405,5.089581350782025,5.7659734505326,4.97855215819914,5.481331448056805,5.966912664584259,5.438439467060032,626717.895522388,3,E01003991,2,7,6,5,4,3,5.424005572860305,5.170675818984573,5.634007668172991,5.161800674490027,5.447035757271019,5.745298329237345,5.438129768178269,794922.9189189189,3,4,5,8,6,1,2,1.0,0,2,-2,2,1,-3,-1
3895,5.5959789133071896,5.320503617922465,5.551343399683635,5.111923793156942,5.445472253163656,5.931107432047526,5.442495724360148,627390.9866666667,4,E01003992,6,4,8,4,3,3,5.470322946707408,5.179975219261952,5.573665169569162,5.065036668227269,5.441379626592,5.901645382245381,5.5714547374309635,795707.0256410256,4,4,4,7,6,3,5,1.0,0,-2,0,-1,2,0,2
3896,5.459095407099951,5.298358798027039,5.417676323936099,5.057806831030619,5.4128518643833345,5.828866935911632,5.396286300250462,627532.7857142857,3,E01003993,5,2,8,3,2,2,5.324582494538406,5.2437074828421935,5.439306094728667,5.18911062848979,5.309125631705098,5.793668757910016,5.51005975268353,795847.6666666666,2,5,2,8,3,1,3,1.0,-1,0,0,0,0,-1,1
3897,5.332592491308848,5.2677175561587015,5.561127360661825,5.0659884214401245,5.393081415692965,5.724811198314031,5.261100665728251,626499.2166666667,1,E01003994,5,4,8,3,1,1,5.272112951046083,5.080677480232425,5.538610311058479,5.039920426965729,5.267136469119933,5.692161800415535,5.370877368663384,794668.569105691,1,2,3,6,2,0,1,1.0,0,-3,-1,-2,-1,-1,0
3898,5.341291181584622,5.102969664208432,5.889709609620114,4.895493900522273,5.513497880164613,5.810889827444198,5.582001790087274,625974.3829787234,1,E01003995,2,8,5,5,2,5,5.463548622633281,5.1072711160308435,5.734677992368999,4.808072814815922,5.337742284724587,5.947730541229248,5.608861273840854,794961.7368421053,4,3,7,2,3,4,5,1.0,3,1,-1,-3,-2,2,0
3899,5.617352548483256,5.019062520684423,5.75228835763158,4.8258486051817195,5.489167174777469,5.8959342756786866,5.5458259663066345,626432.2837837838,4,E01003997,1,7,3,5,3,5,5.4687854862875405,5.171624769767125,5.671318464808994,5.031338993046019,5.350701282421748,5.823296093278461,5.49402438600858,794604.2638888889,4,4,6,6,4,2,3,1.0,0,3,-1,3,-1,-1,-2
3900,5.6976799085026695,5.083988765875499,5.8391418144816445,4.751986056566238,5.560408155123393,6.043352657840366,5.6085379265603565,627792.880952381,5,E01003998,2,8,2,6,5,6,5.602162885665893,4.984689348622372,5.8854269027709964,4.78642630451604,5.464245728442544,5.940523817664698,5.630136494887503,796625.1578947369,5,1,8,1,7,4,6,1.0,0,-1,0,-1,1,-1,0
3901,5.730469207241111,5.00615150797857,5.661338126822693,4.847825198957365,5.532326296584247,6.023068418241527,5.641322651954546,627452.095890411,6,E01003999,1,5,4,6,5,6,5.604850077930885,5.060291487959367,5.71673096886164,4.939393613911882,5.341786300079732,5.929558412938178,5.671165018142024,795792.3797468354,5,2,7,4,4,4,6,1.0,-1,1,2,0,-2,-1,0
3902,5.282826277656832,5.297378018282462,5.457327644030253,5.077756292578103,5.325491837833239,5.65550757922988,5.129910608996516,287553.97101449274,1,E01004000,5,2,8,1,0,0,5.328877044907698,5.187833720910634,5.633924321925386,5.094196232498115,5.349002630152601,5.856030590990756,5.432026102187786,369516.170212766,2,4,5,7,4,2,2,1.0,1,-1,3,-1,3,2,2
3903,5.233633880142693,5.350833712397395,5.3992276879044265,5.108214537302653,5.298677382168469,5.755304450387353,5.111617425540546,288226.01801801805,0,E01004001,6,1,8,1,1,0,5.2884046294824865,5.1922156180792705,5.559395716442325,5.068863159272729,5.272829704168366,5.752812352606921,5.446497163152307,370331.53658536583,1,4,4,7,2,1,2,1.0,1,-2,3,-1,1,0,2
3904,5.914839743840985,5.054886581694207,5.8673663880766895,4.757138827225057,5.644959817572338,6.2639770813104585,5.6855863063800625,289246.743902439,8,E01004002,2,8,2,8,8,7,5.866141039423827,4.931603474587929,5.954945964057271,4.766241109225808,5.496873484152119,6.286937768866376,5.794520669594044,371494.93902439025,8,1,9,1,7,9,8,1.0,0,-1,1,-1,-1,1,1
3905,5.436197290142763,5.257691324335857,5.496849072789683,4.99934281423254,5.495203349196795,5.7342690449316525,5.347313247838066,285364.6019417476,2,E01004003,4,3,7,5,1,2,5.463046610355377,5.193152906718077,5.614010932268919,4.9616700410842896,5.330877720205872,5.879893702489358,5.423993043325566,366833.212962963,4,4,5,4,3,3,2,1.0,2,0,2,-3,-2,2,0
3906,5.700328272278026,5.128402501849805,5.778790728520539,4.8091568845813555,5.44915131391105,5.949633220494804,5.445899765370256,286220.5847457627,5,E01004004,2,7,3,4,4,3,5.573012391133095,5.076690447864248,5.788229018894594,4.906302585530637,5.375905967470425,5.958499168282125,5.59880103637923,367929.29850746266,5,2,8,3,4,4,5,1.0,0,0,1,0,0,0,2
3907,5.271971553564072,5.431732890506585,5.472068428993225,5.082758660117785,5.32105112199982,5.676395098368327,5.118246039996545,291748.375,1,E01004005,7,2,8,1,0,0,5.220145593518796,5.215765764402307,5.491526232595029,5.169541587000308,5.253613348629163,5.7049440653427785,5.2685212591420045,374696.1130434783,1,5,2,8,2,0,0,1.0,0,-2,0,0,1,0,0
3908,5.316678582675873,5.372252819083986,5.551388651605636,5.070061218170893,5.412209081271338,5.750643054644267,5.2821977895403665,290042.79365079367,1,E01004006,6,4,8,3,1,1,5.286204993269826,5.130363317846342,5.658744236895147,5.008681849668954,5.264176073875136,5.723333413364323,5.457959479958046,372478.7709923664,1,3,6,5,2,1,3,1.0,0,-3,2,-3,-1,0,2
3909,5.223136342177956,5.392361002453303,5.508154028553074,5.144015883995315,5.319198184094186,5.821767879744708,5.259881156986043,468161.9322033898,0,E01004007,7,3,9,1,2,1,5.099721314477139,5.274554418735817,5.516095923595741,5.112759547155411,5.207538841200656,5.712470382940574,5.227604760498297,582216.7540983607,0,6,3,7,1,0,0,1.0,0,-1,0,-2,0,-2,-1
3910,5.188399861918556,5.270144459936354,5.428732506434122,5.049025809764862,5.32477084795634,5.669622211986118,5.214096595181359,294247.76666666666,0,E01004008,5,2,7,1,0,0,5.277785946073986,5.189021327382043,5.614305107934134,5.03991277558463,5.304276174590701,5.78757160504659,5.4708073627381095,377714.0857142857,1,4,5,6,3,1,3,1.0,1,-1,3,-1,2,1,3
3911,5.4766267355497895,5.239158811869922,5.580213598302893,4.966009798350635,5.4028914640615655,5.8610308707297385,5.361927833643046,294391.6756756757,3,E01004010,4,4,6,3,2,2,5.39378178699149,5.1231823157933025,5.559464618563652,5.013984553515911,5.339734272824393,5.880647655990389,5.370296898815367,377891.2916666667,3,3,4,6,3,3,1,1.0,0,-1,0,0,0,1,-1
3912,5.303758313781337,5.347692865028716,5.518118684751945,5.07779193029069,5.279951126951921,5.814631058458696,5.318555058094493,615082.9561403509,1,E01004011,6,3,8,1,2,1,5.119101954641796,5.197745622907366,5.523699992043632,5.022648163068862,5.193972972461156,5.78015011378697,5.236164718582517,780350.7714285714,0,4,3,6,1,1,0,1.0,-1,-2,0,-2,0,-1,-1
3913,5.402707906723022,5.369541225433349,5.446913732528687,5.022032047271728,5.347791565895081,5.792225759506225,5.333493686676025,614855.496,2,E01004012,6,2,7,2,1,1,5.4029410711423616,5.297682628856869,5.4251930450829935,5.042264574156032,5.293349162800106,5.816640371412743,5.365453725724708,780108.7086614174,3,6,2,6,2,2,1,1.0,1,0,0,-1,0,1,0
3914,5.448247889677684,5.350929148140407,5.542645400478726,4.9331419098944895,5.326565133673804,5.9062278753235224,5.381809051547732,588555.1428571428,3,E01004013,6,3,5,1,3,2,5.383100653432079,5.269478217842653,5.584538791597504,5.073203139698382,5.305841889578042,5.858021325671796,5.353285661677725,747389.793814433,3,6,4,7,3,2,1,1.0,0,0,1,2,2,-1,-1
3915,5.355400419512461,5.461171712986259,5.400611639022827,5.086143672466278,5.378184709438058,5.772623350453931,5.235213009423988,599878.4534883721,2,E01004014,8,1,8,2,1,1,5.29497504234314,5.3051923955838705,5.518854654941363,5.155860918084371,5.303066344605279,5.844616712983122,5.355688431828292,763448.0103092784,1,6,3,8,3,2,1,1.0,-1,-2,2,0,1,1,0
3916,6.119965773462598,5.1508104768607135,5.7331140490828965,4.637822881422408,5.7446697982934,6.260188455790119,5.73222981710903,294365.52459016396,9,E01004015,3,6,0,9,8,8,6.104334097642165,5.096951367916205,5.765104813453479,4.670890308649112,5.688188181779323,6.165613116973486,5.734733478228251,377150.1487179487,9,3,7,0,9,8,7,1.0,0,0,1,0,0,0,-1
3917,5.795291594718689,5.252033769267879,5.593457188780449,4.790166636035867,5.528911734824856,6.040714123477675,5.48463392910892,289970.3287671233,7,E01004016,4,4,3,6,5,4,5.806610480512036,5.181726211783277,5.632386287385948,4.821162717112936,5.446791921200613,6.06198907098012,5.659171031608741,372345.57740585774,8,4,5,2,6,6,6,1.0,1,0,1,-1,0,1,2
3918,6.157358469407251,5.122617511661506,5.792574629461838,4.628656954853081,5.680645834448879,6.2626174446995275,5.812230662334184,290780.40490797546,9,E01004017,2,7,0,9,8,8,6.084160546064377,5.102021158337593,5.7336593282222745,4.728961305618286,5.592055548429489,6.201681773662568,5.781682734489441,373388.535,9,3,7,0,9,8,8,1.0,0,1,0,0,0,0,0
3919,5.958483409073393,5.092312766333758,5.850508948503914,4.645593497712733,5.624494211821906,6.235027794784072,5.7367943505109364,291941.1920903955,8,E01004018,2,8,0,8,8,8,5.876248933629292,5.076056242570645,5.803753828420872,4.804168287719168,5.501884109217946,6.125181038786725,5.790557626980107,374860.47804878047,8,2,8,1,7,7,8,1.0,0,0,0,1,-1,-1,0
3920,5.6233763805655546,5.289727079775906,5.693498016327851,4.818203158156816,5.5452967457068985,6.055041963739913,5.410554677941079,288736.5503875969,5,E01004019,5,6,3,6,6,3,5.666989328605788,4.991281190088817,5.811233290604183,4.902970689748015,5.4804557253207475,6.062586722629411,5.622529059648514,370718.3660714286,6,1,8,3,7,6,5,1.0,1,-4,2,0,1,0,2
3921,5.843401767874277,5.230848379032587,5.51459062740367,4.803730540378119,5.641711981065812,5.983269235139252,5.4373060785314085,289313.0215053763,7,E01004020,4,3,3,8,4,3,5.689367017481062,5.1589617504013905,5.659688186645508,4.822158320744832,5.547327582041422,6.02001609272427,5.583356490400102,371632.65555555554,6,4,6,2,8,6,5,1.0,-1,0,3,-1,0,2,2
3922,5.881241908697325,5.01775412693202,5.928292165292758,4.744148750171483,5.58880338824798,6.187563900635621,5.656642486001844,295987.09345794393,7,E01004021,1,9,2,7,8,7,5.766200727325375,5.004274876440986,5.914976156364053,4.755147124751139,5.480467279078597,6.1276135565870895,5.813167905403396,379836.0508474576,7,1,9,1,7,7,8,1.0,0,0,0,-1,0,-1,1
3923,5.364416468975156,5.290541000837504,5.495728088672771,5.102855478608331,5.380607688842818,5.7084630304990815,5.311986277269763,614281.5523255814,2,E01004022,5,3,8,2,0,1,5.3853007337665035,5.203671819597318,5.535365337824953,5.096573270486863,5.378221128526972,5.825075198932248,5.378869912900977,779448.3535911603,3,4,3,7,4,2,1,1.0,1,-1,0,-1,2,2,0
3924,5.613548692195646,5.1995253649450115,5.586731328118232,4.852468626153085,5.532004235252257,5.916496744078975,5.4131109147302565,615089.2096774194,4,E01004023,3,4,4,6,3,3,5.570944504883453,5.10341975070138,5.594879006611482,4.967638009377108,5.493884010169342,5.927266408468931,5.547198616821348,780199.8396946564,5,3,4,5,7,4,4,1.0,1,0,0,1,1,1,1
3925,5.461399817953304,5.237544449008241,5.654335352839256,4.93768250698946,5.560016301213478,5.755080091709993,5.454535795717823,443853.02040816325,3,E01004024,4,5,6,6,1,3,5.221349172904843,5.225411333021571,5.5331434460937,5.2488212272769115,5.314461145244661,5.643204098842183,5.358946116244207,561306.655737705,1,5,3,9,3,0,1,1.0,-2,1,-2,3,-3,-1,-2
3926,5.244836127449727,4.988348078624956,5.737046926186003,4.999748715038957,5.486446341050082,5.767404213033873,5.517389384323153,615581.4094827586,1,E01004027,1,6,7,5,1,4,5.40484095139937,4.885531186190518,5.76403919653459,4.998088590882041,5.445138570612127,5.792831018621271,5.616686876470393,781484.6945454546,3,0,7,5,6,1,5,1.0,2,-1,1,-2,1,0,1
3927,5.465065532868062,5.119607831360003,5.66138782194995,4.9351115226745605,5.388112531889469,5.789144161644332,5.492487186685614,616490.1743119266,3,E01004028,2,5,6,3,1,4,5.426405324710636,5.104007720947266,5.685463770168034,5.0331609821695045,5.337324839877331,5.812332408634696,5.436159441790243,782081.9291338583,3,3,6,6,3,2,2,1.0,0,1,1,0,0,1,-2
3928,5.467307629123811,5.219718603677647,5.439410665983795,5.0576746899594545,5.351034778420643,5.768455821980712,5.499573290988963,613739.3548387097,3,E01004029,4,2,8,2,1,4,5.404847424571254,5.20108310715491,5.400741184459013,5.022176718511501,5.28504290300257,5.840448123066365,5.413876637691209,778812.756302521,3,4,1,6,2,2,2,1.0,0,0,-1,-2,0,1,-2
3929,5.456012482113309,5.058043037520514,5.652267637517717,4.892838172117869,5.488242571883731,5.743582479159037,5.486623085869683,613685.0555555555,3,E01004030,2,5,5,5,1,4,5.441305997759797,5.152615452921668,5.5560320726660795,5.0539791389953255,5.456313080565874,5.703245451284009,5.374446210473082,778665.6162790698,3,4,4,6,6,0,1,1.0,0,2,-1,1,1,-1,-3
3930,5.528008706953334,5.333676705415222,5.438843783290907,4.992023156292137,5.342615053571504,5.7924411988806455,5.354489326477051,514172.0229885057,3,E01004031,6,2,6,2,1,2,5.492042725445122,5.304593827775729,5.465562602525116,5.081048079716262,5.260950446769756,5.889073937169967,5.476114817844924,642300.1827956989,4,6,2,7,2,3,3,1.0,1,0,0,1,0,2,1
3931,5.767803092604702,5.210781192316593,5.5163116501372995,4.810292205764252,5.459195705293451,5.941671639970205,5.525794648429723,613685.8932038835,6,E01004032,4,3,3,4,4,5,5.582629234161017,5.158979039147215,5.453587959397514,4.966207098286107,5.409091467002653,5.991209839874843,5.585219700381441,778669.8679245283,5,4,2,5,5,5,5,1.0,-1,0,-1,2,1,1,0
3932,5.444163499854681,5.21537427639398,5.512794928287897,5.028639458295867,5.3237678694912764,5.808671516696299,5.422611525678259,613947.7165354331,3,E01004033,4,3,7,1,2,3,5.39247410312111,5.24375374081694,5.4415210279417625,5.0710226680025645,5.303880088859135,5.847890812673686,5.41965764908143,778999.425925926,3,5,2,7,3,2,2,1.0,0,1,-1,0,2,0,-1
3933,5.757878255844116,5.118410857915879,5.637680426836014,4.910552476644516,5.488408253192902,5.923744220733642,5.518131644725799,614350.63,6,E01004034,2,5,5,5,3,4,5.532369825953529,5.242408232461838,5.5626873016357425,5.0076404537473405,5.4001941317603706,5.861994675227574,5.57030379204523,779544.1619047619,4,5,4,5,5,2,4,1.0,-2,3,-1,0,0,-1,0
3934,5.501570254823436,5.326401902281719,5.481872374078502,4.9416653716045875,5.496241302075593,5.833748149871826,5.3716847595961195,320257.95652173914,3,E01004035,6,2,6,5,2,2,5.430015482248798,5.233263202251926,5.489607503337245,5.038969752288634,5.340537675926762,5.840184850077475,5.481838955994575,407824.56451612903,3,5,2,6,3,2,3,1.0,0,-1,0,0,-2,0,1
3935,5.312842024490237,5.210783030837774,5.723399467766285,5.053815005347133,5.393221445381641,5.750168703496456,5.444991679862142,292199.8125,1,E01004036,4,6,7,3,1,3,5.408942550023397,5.069768473307292,5.7828741518656415,4.975068518320719,5.384304231007894,5.87192951520284,5.4284806044896445,375115.26666666666,3,2,7,5,5,3,2,1.0,2,-2,1,-2,2,2,-1
3936,5.526507439692159,5.331190503333226,5.537440254668559,4.994356502186168,5.482770661677211,5.890425138237062,5.4163088660594845,292490.9917355372,3,E01004037,6,3,6,5,3,3,5.414332013863784,5.33429674918835,5.485569075270966,5.088896443793824,5.317413586002964,5.880591665948187,5.491327195734411,375479.34265734267,3,7,2,7,3,3,3,1.0,0,1,-1,1,-2,0,0
3937,5.369719308920396,5.3235809077055025,5.434598233455267,5.073000256831829,5.360332902425375,5.796751080415188,5.280312486183949,293565.39743589744,2,E01004038,6,2,8,2,1,1,5.283310356405046,5.417808620797263,5.3603620217906105,5.12875676618682,5.203989315032959,5.793264212873247,5.451554527547624,376897.5444444445,1,8,1,8,1,1,2,1.0,-1,2,-1,0,-1,0,1
3938,5.5590496287487525,5.330510189037512,5.563440233173937,4.899597788801287,5.442297014859643,5.872074842453003,5.4227514939733075,443850.40594059404,4,E01004039,6,4,5,4,2,3,5.3736153283250445,5.3009575845998365,5.449789351279582,5.138527000715973,5.271430594111801,5.818923302746694,5.455001154077163,570190.7339449541,2,6,2,8,2,2,2,1.0,-2,0,-2,3,-2,0,-1
3939,5.062617969238895,5.468454815875525,5.43098757184785,5.324452237151135,5.242407305487271,5.616561574497442,5.155165010485156,467243.5977011494,0,E01004040,8,2,9,0,0,0,5.157882223409765,5.271042968245114,5.459960188585169,5.211564131344066,5.281588961096371,5.7006864884320425,5.265513153637157,576163.0705882353,0,6,2,9,2,0,0,1.0,0,-2,0,0,2,0,0
3940,5.1667341652669405,5.344536895814695,5.372882287753256,5.117221579739922,5.397228080975382,5.696810418053677,5.179352929717616,294366.5263157895,0,E01004041,6,1,8,3,0,0,5.079049698294026,5.232078176655182,5.337722239429003,5.1903842932557405,5.187211296329759,5.656311521791432,5.296831929520385,377901.31506849313,0,5,1,8,1,0,0,1.0,0,-1,0,0,-2,0,0
3941,5.353436799276443,5.22178240900948,5.574648796565949,4.975427426989117,5.400042312485831,5.763626238656422,5.203591893589686,297229.00793650793,2,E01004042,4,4,6,3,1,0,5.272232220286415,5.093088039735547,5.581441919819838,5.086893505790607,5.323106138884616,5.749166284288679,5.29347127554368,378444.87074829935,1,3,4,7,3,1,0,1.0,-1,-1,0,1,0,0,0
3942,5.535218689955917,5.119091066659665,5.74412469069163,4.770127763935164,5.561404030697019,5.9761740062751025,5.397741161140741,295380.29411764705,4,E01004043,2,7,2,6,4,2,5.4275279110724775,5.0542781024897865,5.701488558305513,4.997357287538161,5.416673151724929,5.925310390804886,5.3774038662604235,379113.0733944954,3,2,6,5,5,4,1,1.0,-1,0,-1,3,-1,0,-1
3943,5.49924031619368,5.189243651669601,5.691137116530846,5.005875474420087,5.442863961745953,5.811977694774496,5.348874844353775,433703.7586206897,3,E01004044,3,6,7,4,2,2,5.431361459768736,5.133600980043411,5.580016200359051,5.0067341809089365,5.288188374959505,5.892173698315253,5.404022487310263,526309.3653846154,3,3,4,5,2,3,2,1.0,0,0,-2,-2,-2,1,0
3944,5.4350475351861185,5.256096890632143,5.5666490869319185,4.9353941146363605,5.4515520968335744,5.863456634764976,5.5068435973309455,618117.3617021276,2,E01004045,4,4,6,4,2,4,5.4325954827395355,5.10932815508409,5.633013348145918,5.022178268432617,5.374149365858599,5.9546354683962734,5.645181278748946,784064.2,3,3,5,6,4,4,6,1.0,1,-1,1,0,0,2,2
3945,6.20027768611908,4.952811197117642,5.986319597776945,4.561664395504169,5.799959060308096,6.451513692065403,5.8747575089738175,452664.5675675676,9,E01004046,1,9,0,9,9,9,6.095258148092973,4.965612430321543,5.9535222492719955,4.6385011735715365,5.587350804554789,6.25923941009923,5.890461028667918,574831.3157894737,9,1,9,0,9,9,9,1.0,0,0,0,0,0,0,0
3946,5.680125300477191,5.276455525460282,5.668817973718411,4.814706688973962,5.540009696309159,6.035919532543275,5.444497689968202,618615.9024390244,5,E01004047,5,5,3,6,5,3,5.649686675552928,5.157897382701209,5.640797717855611,4.893363791868227,5.468762184501788,6.067236309751459,5.522612612181847,784650.4495412844,6,4,5,3,7,6,4,1.0,1,-1,0,0,1,1,1
3947,5.7881127484639485,5.32910506884257,5.550452556610107,4.814514791965484,5.5135849062601725,6.116698369979859,5.651874787012736,618764.3533333334,6,E01004048,6,4,3,5,7,7,5.778212008513804,5.304235042549494,5.604237828667708,4.818337418901638,5.432809075971288,6.096441143141018,5.670792662252591,784853.7401574804,7,6,5,2,6,7,6,1.0,1,0,1,-1,1,0,-1
3948,5.976518931984901,5.272648343443871,5.665947699546814,4.7093322947621346,5.7020877540111545,6.082875627279281,5.6612972766160965,618205.175,8,E01004049,5,5,1,9,6,7,5.627792725960414,5.193937816222509,5.545029151439667,4.876557928323746,5.492037216822307,5.8657199263572695,5.4472837547461195,784149.25,6,4,3,3,7,2,2,1.0,-2,-1,-2,2,-2,-4,-5
3949,6.159943068138907,5.1005770970727795,5.770177540378036,4.6665077053497885,5.708929935348368,6.075061613154189,5.678947625873245,616340.7009345795,9,E01004050,2,7,1,9,6,7,5.9470118524566775,5.248253111877749,5.674834991655042,4.8069656270165595,5.515398097615088,6.024821187219312,5.633908514053591,781791.5161290322,9,5,6,1,8,6,6,1.0,0,3,-1,0,-1,0,-1
3950,5.9645375701097345,5.192251375088325,5.728682703696764,4.651874786386123,5.644342940587264,6.188827661367563,5.639824991042797,619110.1153846154,8,E01004051,3,6,0,8,8,6,5.752325528909352,5.356018439797331,5.51755248613594,4.976348609963725,5.405608561413347,5.927487315225207,5.5067298776847275,785116.7685950414,7,7,3,5,5,4,3,1.0,-1,4,-3,5,-3,-4,-3
3951,6.002330460046467,4.993308861004679,5.885704042618735,4.653955381167562,5.674739452830532,6.261740065457528,5.788955146806282,617940.3245614035,8,E01004052,1,8,1,9,8,8,5.802850083787312,4.906600204549094,5.91732791597529,4.699468676434007,5.504723526710688,6.2329131521919905,5.853525851124017,783905.472868217,8,1,9,0,8,9,9,1.0,0,0,1,-1,-1,1,1
3952,5.790314052706567,5.142482260677302,5.582232057491195,4.849992275238037,5.573870983079215,5.974000632205856,5.593126567724709,613294.0934579439,6,E01004053,3,4,4,7,4,6,5.654595525897279,5.286375015365834,5.604083118390064,4.916878311001525,5.5207867634539705,5.99265655936027,5.618684617840514,778189.1326530612,6,6,5,4,8,5,5,1.0,0,3,1,0,1,1,-1
3953,5.617744894509904,5.123783982201909,5.550485752941517,4.870848603462905,5.461548904354653,5.8793507184875144,5.674685448742984,612880.7303370787,4,E01004054,2,4,4,4,2,7,5.667496123871246,5.258665823317194,5.548508017094104,4.859711602136686,5.550106667853021,5.956141642161778,5.702172901723292,777646.6883116884,6,5,4,2,8,4,7,1.0,2,3,0,-2,4,2,0
3954,5.689181968763277,5.38918010909836,5.373063681961654,4.93346061025347,5.537993400127856,5.88789168580786,5.513276703946002,613082.3376623377,5,E01004055,7,1,5,6,3,4,5.643745598793029,5.432153997421264,5.439371271133423,5.002606809139252,5.361075346469879,5.994016108512878,5.392977055311203,777932.74,6,8,2,5,4,5,2,1.0,1,1,1,0,-2,2,-2
3955,5.703259761134784,5.285742638011773,5.530171761082278,4.826786495745182,5.483507385684384,5.904704620440801,5.479742166896661,612709.8611111111,5,E01004056,5,3,3,5,3,4,5.614371763148778,5.329761785520634,5.475431365866057,4.98460359052873,5.413122607788569,5.897990352670911,5.488884420462058,777456.1971830986,5,7,2,5,5,3,3,1.0,0,2,-1,2,0,0,-1
3956,5.705529591715928,5.35340306522153,5.4281025795226405,4.884995893383702,5.485984100517651,5.940587299089906,5.454737508550603,613296.2765957447,5,E01004057,6,2,5,5,4,3,5.55115182429367,5.276776494446748,5.48413077940852,4.961656486025508,5.477069143923173,5.917727642177795,5.469060183311841,778201.7018633541,5,6,2,4,7,3,3,1.0,0,0,0,-1,2,-1,0
3957,5.2895513870944715,5.257445777932259,5.457204067543762,5.155561241385055,5.377996082175268,5.769063329043454,5.344945817777555,521084.8493150685,1,E01004058,4,2,9,2,1,2,5.331279256277615,5.215018073717753,5.5624981257650585,4.996694351236026,5.333564660615391,5.72904395725992,5.494903884000248,649295.9444444445,2,5,4,5,3,1,3,1.0,1,1,2,-4,1,0,1
3958,5.6396396126307495,5.295948514701627,5.4479994570955315,4.93740809724686,5.416668210469239,5.858754820857488,5.511268737468313,560709.7943262411,5,E01004059,5,2,6,3,2,4,5.609980162137594,5.220137408910653,5.596859115820664,4.885911305745442,5.417625042108389,5.903810251981784,5.519816642388319,708193.7948717949,5,5,4,3,5,3,4,1.0,0,0,2,-3,2,1,0
3959,5.411989035931501,5.176641716198488,5.750788899985227,5.111574095758525,5.3133270794695076,5.863231905482032,5.311283261938528,286113.2727272727,2,E01004060,3,7,8,1,2,1,5.338443994522095,5.142478983977745,5.685259109255911,4.971478323826845,5.38576987145961,5.887900245600734,5.5045350283041765,366990.4252873563,2,3,6,5,5,3,3,1.0,0,0,-1,-3,4,1,2
3960,5.757513431894699,5.099018090523329,5.772351306556855,4.801232339551785,5.570773099092829,6.0302121415234256,5.570323789679764,409080.4697986577,6,E01004061,2,7,3,7,5,5,5.582100349359023,4.990352828533221,5.731490952846332,4.921308579353186,5.340617409883401,5.996574275004558,5.6105712950229645,518006.0833333333,5,1,7,4,3,5,5,1.0,-1,-1,0,1,-4,0,0
3961,5.210009991076955,5.043729104493794,5.689857135739243,5.028466376296261,5.403082104105699,5.698873584730583,5.095671975821779,295180.4649122807,0,E01004062,1,6,7,3,0,0,5.309056547761873,5.054845939155753,5.620184810106991,5.065792080100256,5.340110709649006,5.764073106168791,5.2808252927911195,378744.7709923664,2,2,5,7,3,1,0,1.0,2,1,-1,0,0,1,0
3962,5.510207687432949,5.094544563537989,5.5925109936640816,4.8735501024967585,5.518218784760206,5.978940668778542,5.392394853708072,297141.1153846154,3,E01004063,2,4,4,5,4,2,5.4436198417851,5.03006247357826,5.649360948904401,4.972587775632825,5.367202228893435,5.8826580474831465,5.511376672397459,378716.3583815029,3,2,5,5,4,3,3,1.0,0,0,1,1,-1,-1,1
3963,5.667302204638111,5.237170595701049,5.668593739165741,4.85891059710055,5.469276942363401,6.075453349522182,5.373558351782714,292679.768707483,5,E01004064,4,5,4,4,6,2,5.691918376563252,5.1798552084660185,5.634935850682466,4.951064825921819,5.432709667993628,6.044113924537879,5.626009744146596,375779.39130434784,6,4,5,4,6,6,6,1.0,1,0,0,0,2,0,4
3964,5.787483446668871,5.07496455164239,5.937293538952818,4.792250731203816,5.550103390570914,6.1881637785694386,5.505220949059666,295819.0198019802,6,E01004065,2,9,3,6,8,4,5.749555511382019,4.940716714534945,5.9702229777586115,4.755668776706584,5.3924700299512995,6.123164220921044,5.744735225890446,379596.9514563107,7,1,9,1,5,7,8,1.0,1,-1,0,-2,-1,-1,4
3965,5.862432571930614,5.028369747526277,5.874835150028632,4.699435018911594,5.575290457019961,6.1438419547507435,5.7532291577114325,602451.487804878,7,E01004066,1,8,1,7,7,8,5.729540126412003,4.942902345127529,5.836491381680524,4.81713067955441,5.466177716078581,6.068013982419615,5.741790983412001,765935.7555555556,7,1,8,2,7,6,7,1.0,0,0,0,1,0,-1,-1
3966,5.294874326332466,5.17536892674186,5.6476073690227695,5.026740944468892,5.375840751441209,5.776075019703045,5.302763464567545,294687.2727272727,1,E01004067,3,5,7,2,1,1,5.329757174620261,5.096246410638858,5.644043505191803,5.104697789901342,5.287298305676534,5.793021195974106,5.439411476636544,378263.0512820513,2,3,5,7,2,1,2,1.0,1,0,0,0,0,0,1
3967,5.274824471937285,5.435883334941334,5.399912488957246,5.13676489972406,5.3215646586484375,5.755763628416592,5.205599274072382,293966.2291666667,1,E01004068,7,1,9,1,1,0,5.297134200457869,5.2898526315031384,5.412331941209991,5.160534409818978,5.247930335998535,5.708008535977068,5.252231401410596,377447.2689655172,1,6,1,8,2,0,0,1.0,0,-1,0,-1,1,-1,0
3968,6.208103373039902,5.059602657054884,5.626725838195145,4.637514557773711,5.661911454136016,6.147618679978729,5.791978782118715,616971.6244343892,9,E01004069,2,5,0,8,7,8,6.190802079127974,5.110032882556379,5.775641184734053,4.5945427867782165,5.7135461822571045,6.240878418267491,5.906085345161009,771206.751004016,9,3,7,0,9,9,9,1.0,0,1,2,0,1,2,1
3969,6.240583364681531,5.05616158182903,5.914975332316532,4.616629819716176,5.691828870645133,6.3947173639010355,5.941607728440275,619608.3225806452,9,E01004070,2,8,0,9,9,9,6.095101781189442,5.088149490681562,5.802525392987511,4.670166473497044,5.493232514370572,6.278470039367676,5.876154421405359,785813.2784090909,9,3,8,0,7,9,9,1.0,0,1,0,0,-2,0,0
3970,5.918830993698864,5.185469858530091,5.73755216017002,4.796949873610241,5.571857115117515,6.159156116043649,5.6238005015908215,619232.6829268293,8,E01004071,3,7,3,7,7,6,5.691718054854351,5.038141075683677,5.807896663313326,4.907667816981025,5.387626929127651,6.1482096003449485,5.713908378196799,785406.5760869565,6,2,8,3,5,8,7,1.0,-2,-1,1,0,-2,1,1
3971,6.179096683477744,4.955142318438261,5.968306663708809,4.5572000581484575,5.656110839966016,6.411033291083116,6.005144117734371,619841.217948718,9,E01004072,1,9,0,8,9,9,6.0576775140602495,4.850969963233564,5.92762266856998,4.693895646313715,5.575268821343363,6.411705822918002,6.0188879001074,779310.0391061453,9,0,9,0,9,9,9,1.0,0,-1,0,0,1,0,0
3972,6.332103593008859,4.8494971096515656,6.010544116156442,4.441729638406208,5.71670845406396,6.488806961263929,6.0034389598029,619790.4285714285,9,E01004073,0,9,0,9,9,9,6.101341501597701,4.875966331876557,5.932864263139922,4.649386650118335,5.545175138013116,6.42842394894567,5.948875077017423,786014.4551724138,9,0,9,0,8,9,9,1.0,0,0,0,0,-1,0,0
3973,6.268658608374511,4.8918852340540235,6.002880655096833,4.57750220482166,5.723669603731505,6.402710473043679,5.964635194406002,619953.4792899408,9,E01004074,0,9,0,9,9,9,6.083346797398159,4.949113529069083,5.915181525094169,4.625692678860256,5.675358831541879,6.309613071169172,5.9168628358840945,786277.6628571429,9,1,9,0,9,9,9,1.0,0,1,0,0,0,0,0
3974,6.159188684295206,5.175954239625557,5.797430421791825,4.660110717894984,5.691738281764236,6.266532744847092,5.827873184400446,510533.0931372549,9,E01004075,3,7,1,9,8,9,6.071902500439997,5.0582023701167,5.798675839215109,4.649806036796744,5.633524833748874,6.274401506876837,5.903210907766264,637268.3789954338,9,2,8,0,9,9,9,1.0,0,-1,1,-1,0,1,0
3975,5.3058466440023375,5.667090291627192,5.007519644999973,5.172425171983477,5.2415644442246085,5.578993050484836,5.017212515227056,383797.7030411449,1,E01004076,9,0,9,0,0,0,5.293166679183119,5.560130416954818,5.055211300716588,5.25816043799645,5.123958715482762,5.6205085808117135,5.1767496086264915,479094.0230263158,1,9,0,9,0,0,0,1.0,0,0,0,0,0,0,0
3976,5.642446985885279,5.277220601466165,5.509041589290941,4.872358413478035,5.506377669116158,6.010097823925872,5.537012429379705,555709.5820895522,5,E01004077,5,3,4,5,5,5,5.53499462054326,5.3197345945697565,5.491168109270243,4.963310630275653,5.426471992180898,5.985061794519424,5.571317618282942,707500.1201923077,4,6,2,5,6,5,5,1.0,-1,1,-1,1,1,0,0
3977,5.608538043981342,5.51746018429023,5.288534740492098,4.883324623796981,5.407461105743584,5.88510992623478,5.277359201039882,555714.6820809249,4,E01004078,8,0,5,3,3,1,5.396070965876182,5.491731684654951,5.26255898612241,5.08767541560034,5.257835856328408,5.797045127178232,5.3055157996714115,707523.96875,3,9,0,7,2,1,1,1.0,-1,1,0,2,-1,-2,0
3978,5.849483948807384,5.2349583471930305,5.657628594442856,4.792461077834284,5.66536323275677,6.240954351979632,5.71818253536557,555982.7674418605,7,E01004079,4,5,3,8,8,7,5.793267209421504,5.079686478457668,5.600335437465798,4.8868178941986775,5.610992250117389,6.213587289506739,5.822911125692454,707883.0852272727,7,2,4,3,9,8,8,1.0,0,-2,-1,0,1,0,1
3979,5.660517182946205,5.333238169550896,5.530624295026064,4.881970340758562,5.5167943723499775,6.036767436563968,5.635717138648033,555153.9,5,E01004080,6,3,4,5,5,6,5.605521643298796,5.2376125358987125,5.50848855780459,4.959991455078125,5.450644136160269,6.02205463935589,5.702613337971698,706734.551724138,5,5,3,4,6,6,7,1.0,0,-1,0,0,1,1,1
3980,5.731446967849249,5.1967688270762,5.571796826169461,4.81841974318782,5.511898861655706,6.060478726519814,5.547372088402132,555779.082278481,6,E01004081,3,4,3,5,6,5,5.633198389235665,5.218213722109795,5.551341051564497,4.956344419542481,5.377739406683865,5.991284948938033,5.428609592073104,707623.0735294118,6,5,4,4,4,5,2,1.0,0,2,0,1,-1,-1,-3
3981,5.695229340073289,5.125557089483501,5.636361608442092,4.794301990641664,5.6693900878855725,6.198545869612536,5.724491182542005,554890.9006622516,5,E01004082,2,5,3,8,8,8,5.490538670398571,5.102083080786246,5.613736486434936,5.0155742424505725,5.406272361896656,6.135629796981812,5.515670713671931,706357.8,4,3,5,6,5,8,4,1.0,-1,1,0,3,-3,0,-4
3982,5.6175458407402035,5.485065231323242,5.425678040981293,4.975000371932984,5.4823988652229305,6.010826780796051,5.451373687982559,566395.94,4,E01004083,8,2,6,5,5,3,5.477723549712788,5.441835270686583,5.266807669943029,5.06833529336886,5.3008035096255215,5.880148895762184,5.318633671511304,721423.0340909091,4,8,0,7,3,3,1,1.0,0,0,-2,1,-2,-2,-2
3983,6.2462197509466435,5.3498059539233935,5.55388500363219,4.591449024630528,5.827073112188601,6.204519066623613,5.829389437507181,568012.9607843137,9,E01004084,6,4,0,9,8,9,6.0270338120213545,5.355996291475942,5.522928256437598,4.771448627886069,5.580758563075882,6.17541345372143,5.7335222750545976,723468.4422310757,9,7,3,1,9,8,7,1.0,0,1,-1,1,0,0,-2
3984,6.217144253193519,5.340735076696087,5.532853285471599,4.550432153612549,5.877394800762452,6.16513494859662,5.759744368101421,566831.1091617934,9,E01004085,6,3,0,9,7,8,5.97731413979748,5.400268617507333,5.414190792938486,4.791353716395208,5.5621949157279555,6.129774858348102,5.656486353438919,722039.1784232365,9,8,1,1,8,7,6,1.0,0,2,-2,1,-1,0,-2
3985,5.722935844572355,5.343454949644081,5.450158848725691,4.920224422193402,5.570276291674168,5.998319853226651,5.6234156325977285,562562.0347490348,6,E01004086,6,2,5,7,5,6,5.561673487115789,5.349212123729565,5.480580422613356,4.99399554155491,5.324255920339514,5.999910147101791,5.595913265369557,716181.7148148149,5,7,2,5,3,5,5,1.0,-1,1,0,0,-4,0,-1
3986,6.205265906184771,5.295253636712712,5.682471946517438,4.58145893637038,5.822098864198296,6.2539604354243705,5.950454619823474,567801.0995260663,9,E01004087,5,6,0,9,8,9,5.85584921249445,5.276536685833032,5.602151754397701,4.851015631127472,5.554140172718804,6.201408736371763,5.785079143473491,723187.2705314009,8,6,4,2,8,8,8,1.0,-1,1,-2,2,-1,0,-1
3987,5.581586074398224,5.44405244919191,5.316432303692921,4.9915119826075545,5.441294242818672,5.91066064892045,5.468494680272528,566347.3975903614,4,E01004088,7,1,6,4,3,4,5.378162697451004,5.382291916190394,5.19808097233046,5.130343419037118,5.266434648179061,5.848316289731208,5.362507903023271,721379.4900662252,2,8,0,8,2,2,1,1.0,-2,1,-1,2,-2,-1,-3
3988,5.3333512072293265,5.636211370522121,5.169718409484288,5.21453924448985,5.327983166811602,5.619023554729965,5.047161937884565,566820.4339622641,1,E01004089,9,0,9,1,0,0,5.260186452463449,5.518410885190389,5.264127277466188,5.144648123936481,5.322883723730064,5.803185902446149,5.1388918463006075,722033.5542168674,1,9,0,8,3,1,0,1.0,0,0,0,-1,2,1,0
3989,6.0096612173578015,5.382498405290686,5.397485395099806,4.784072393956392,5.626690866636193,5.83806558277296,5.451668597304303,572347.9043478261,8,E01004090,7,1,3,8,2,3,5.568395498796558,5.430303465390036,5.294207963537662,5.089661019913693,5.350672804717476,5.741738573033759,5.309663937446919,728946.0709219858,5,8,0,7,4,1,1,1.0,-3,1,-1,4,-4,-1,-2
3990,6.299636242264196,5.2309588633085555,5.814737557737451,4.551790161509263,5.9205717111888685,6.390574855553476,5.944381602186906,571783.4526315789,9,E01004091,4,7,0,9,9,9,5.938277816772461,5.253884135759794,5.583754249719473,4.734362089939607,5.5736012746126224,6.132388910880455,5.870378514436575,728186.641025641,9,5,4,0,9,8,9,1.0,0,1,-3,0,0,-1,0
3991,6.5696265450529685,5.150560021624951,5.851587983399012,4.360244258873431,6.049904021390638,6.503257120171958,6.023657206088136,571698.0395480226,9,E01004092,3,8,0,9,9,9,6.21909966064975,5.260942511139165,5.638651466913254,4.626229542862709,5.682737027395043,6.2619721120654175,5.771652305553324,728092.1889250814,9,5,5,0,9,9,8,1.0,0,2,-3,0,0,0,-1
3992,5.996712125483013,5.389515568812688,5.5467635705357505,4.782044529914856,5.661396277092752,6.09164356191953,5.75682250729629,573047.7202380953,8,E01004093,7,4,2,8,6,8,5.779143388243927,5.286876193408308,5.43994971184895,4.910908144780959,5.404466489265705,6.090843844687802,5.870702881922667,729863.5172413794,7,6,2,3,5,7,9,1.0,-1,-1,-2,1,-3,1,1
3993,5.991435568706662,5.1305027124928495,5.77550054063984,4.624534268005221,5.645830411537021,6.285878721405478,5.71923252063639,572614.0098039216,8,E01004094,2,7,0,8,9,7,5.732190185739088,5.282108112823131,5.573092974433603,4.8381976896478225,5.452749372452729,6.150965877281603,5.641395390495774,729313.3643410853,7,6,4,2,6,8,6,1.0,-1,4,-3,2,-2,-1,-1
3994,5.994000446289144,5.299297436120662,5.663882998709983,4.70546220021045,5.713072729871628,6.181535583861331,5.751974883231711,573515.2234042553,8,E01004095,5,5,1,9,7,8,5.913130523246012,5.215083550523828,5.622675634460685,4.782626879068069,5.612790232823219,6.16956995446005,5.867278000454844,730447.6790123457,8,5,5,1,9,8,9,1.0,0,0,0,0,0,1,1
3995,6.243842136859894,5.199397359788418,5.8358659654855725,4.539778657257557,5.828794941306114,6.286855325102806,5.841900819540024,572112.6875,9,E01004096,3,8,0,9,9,9,6.008551459714591,5.284260280161019,5.647005308105285,4.775619361774031,5.5690258899367,6.18212437916951,5.72614373356463,728630.4939759036,9,6,5,1,9,8,7,1.0,0,3,-3,1,0,-1,-2
3996,5.781509305959866,5.323186446119238,5.560705330636766,4.809073879395002,5.465748976778101,6.060653543766634,5.504514908349073,563779.0679012346,6,E01004097,6,4,3,4,6,4,5.570356201293857,5.317436600840369,5.462710727092832,5.004892458056295,5.347407081099444,5.996336688829023,5.603058258461398,717367.2616279069,5,6,2,5,4,5,5,1.0,-1,0,-2,2,0,-1,1
3997,6.0942068279237676,5.136273600105056,5.792153248213287,4.668952843300382,5.737432429665013,6.300932520314267,5.881468554188435,561337.8571428572,9,E01004098,3,7,1,9,9,9,5.878027759930667,5.162617893779979,5.688900288413553,4.77110958274673,5.493414044380188,6.223857772700927,5.898246203275288,715352.2132352941,8,4,6,1,7,9,9,1.0,-1,1,-1,0,-2,0,0
3998,5.7410666798290455,5.269916602812315,5.523179849825407,4.850305613718535,5.456274426610846,5.897312775411104,5.4371252549322024,557829.4894736842,6,E01004099,5,3,4,4,3,3,5.581353643549932,5.217392773906211,5.494896971591385,4.891302086312675,5.3589931202576295,5.88525566605709,5.427140199550064,710366.9461883408,5,5,3,3,4,3,2,1.0,-1,0,0,-1,0,0,-1
3999,5.6943153473887484,5.155011795923073,5.657088272655106,4.814881521415196,5.586471314700145,6.114282032228866,5.676403577758296,559027.6522911051,5,E01004100,3,5,3,7,7,7,5.612163298523303,5.212358624664779,5.594529084323608,4.916336074932334,5.4101190253631355,6.098505278223569,5.677403075793355,711756.4639175257,5,5,4,4,5,7,6,1.0,0,2,-1,1,-2,0,-1
4000,5.77260647309537,5.3450990773194675,5.677899761705209,4.795703160052268,5.612990375386168,6.217801351420927,5.685734972259067,559337.4039735099,6,E01004101,6,6,3,8,8,7,5.503930299889808,5.234653676257414,5.557544022603752,4.956104452313941,5.38967466198541,6.080751844480926,5.7418205761442,712298.5816993464,4,5,4,4,5,7,7,1.0,-2,-1,-2,1,-3,-1,0
4001,6.017673728672881,5.142755215570807,5.688362408990729,4.65039711782377,5.719952271953566,6.159102225412517,5.733166507389992,560139.5890410959,8,E01004102,3,6,0,9,7,8,5.794960906155302,5.2398862861344035,5.5509351712267545,4.887637898255298,5.412241630644595,6.073894596777821,5.675658449742467,713472.7819905214,7,5,4,3,5,7,6,1.0,-1,2,-2,3,-4,0,-2
4002,5.6391464642116,5.242492079734802,5.678223328930991,4.761528073038374,5.56542106611388,6.076673025744302,5.5682112872600555,560622.0928571429,5,E01004103,4,6,2,7,6,5,5.450521091486784,5.241576348375154,5.628806194203012,4.947609696612262,5.3844076699058485,6.034563072575819,5.65072303250332,714048.1073825504,3,5,5,4,5,6,6,1.0,-2,1,-1,2,-2,0,1
4003,6.0066077810345275,4.989409183010911,5.77901026985862,4.565030696897796,5.755358382427331,6.380817900281964,5.900017143740799,569959.3636363636,8,E01004104,1,7,0,9,9,9,5.830570132368141,5.150165027214421,5.684938894377814,4.79244969619645,5.587437871429655,6.25311545199818,5.860110247300731,725859.2777777778,8,4,6,1,9,9,9,1.0,0,3,-1,1,0,0,0
4004,6.074097375715932,5.229418692088896,5.628674679706173,4.627301269961942,5.701081233639871,6.188944338790832,5.829559951539962,570617.0846774194,9,E01004105,4,5,0,9,8,9,5.89123617929797,5.26520051590858,5.566380906489588,4.829509224141797,5.543342135125591,6.1763798930952625,5.797492923275117,726704.1612903225,8,6,4,2,8,8,8,1.0,-1,2,-1,2,-1,0,-1
4005,6.329083538406035,5.289844330969979,5.543579027582617,4.534722184784272,5.8309386912514185,6.187260659301982,5.793493333984824,570963.0411764706,9,E01004106,5,3,0,9,8,8,6.144355589343656,5.368502523309441,5.397770062890104,4.704542651612272,5.647053037279395,6.103026555430505,5.67338385569152,727165.4838709678,9,7,1,0,9,7,6,1.0,0,2,-2,0,0,-1,-2
4006,5.8392331303972185,5.242198832107313,5.733879361008153,4.663826458381884,5.6392955259843305,6.180338644258904,5.789203629349217,569920.0848484848,7,E01004107,4,6,1,8,7,8,5.594359326780888,5.26276517472072,5.657158569982874,4.856319276212949,5.448931854370742,6.0120882025936195,5.608359587819953,725877.3684210526,5,6,6,2,6,5,5,1.0,-2,2,0,1,-2,-2,-3
4007,6.018335044384003,5.503247185804998,5.104748848273274,4.763065640690662,5.580067441490667,5.760981307510187,5.353696089053789,569848.6140684411,8,E01004108,8,0,2,7,1,2,5.994401700213804,5.568356479628611,5.047837562076116,4.891688627105649,5.368896002284551,5.719467562740132,5.29203397439698,725745.520338983,9,9,0,3,4,1,0,1.0,1,1,0,1,-3,0,-2
4008,6.038386293780276,5.395701842986065,5.557375713383957,4.719207123442963,5.800711567863162,6.234248171319495,5.678489547231536,570141.8344988344,9,E01004109,7,4,1,9,8,7,5.850735556299441,5.288833813689579,5.548868643903287,4.8403306826252805,5.624510925506877,6.1464589722802705,5.585407842542524,726127.6355140187,8,6,4,2,9,8,5,1.0,-1,-1,0,1,0,0,-2
4009,5.6985982631557075,5.322462525517268,5.570297242872391,4.868475425949495,5.489068829224085,6.037717076544147,5.655715751731022,571567.0557491289,5,E01004110,6,4,4,5,5,7,5.649283975678704,5.3011806078597425,5.48666405930536,4.966087246109656,5.345922506740152,5.992241310146588,5.573675817819872,727754.5017667845,6,6,2,5,4,5,5,1.0,1,0,-2,1,-1,0,-2
4010,5.763903996165918,5.293488805391351,5.501494417385179,4.845145228565956,5.550666933157006,6.086703799208816,5.663436326445366,567041.75,6,E01004111,5,3,4,6,6,7,5.539064342053092,5.236567821334954,5.536911486980304,5.017121861328432,5.370945505161381,6.054009491474784,5.657453212306727,722650.9095477387,4,5,3,6,4,6,6,1.0,-2,0,0,2,-2,0,-1
4011,6.133432687794576,5.257452373133331,5.5626231085081566,4.714314803236821,5.645480908331324,6.1862213005785085,5.724437288573531,574357.975409836,9,E01004112,4,4,1,8,8,8,5.988246764183044,5.24404317855835,5.566204421043396,4.778143198013305,5.570288281440735,6.097541935920716,5.751938512325287,731481.292,9,5,4,1,9,7,8,1.0,0,1,0,0,1,-1,0
4012,6.329007826494367,5.328271630105008,5.6159533418519665,4.5350875175847545,5.852638658066367,6.305821823270134,5.83406581191088,574385.2359550562,9,E01004114,6,5,0,9,9,9,6.1652336597442625,5.318700470306255,5.5545548143210235,4.688687156306373,5.7587349291200995,6.227928598721822,5.800663940553312,731417.5185185185,9,6,4,0,9,9,8,1.0,0,0,-1,0,0,0,-1
4013,5.7393834202002125,5.159312266830011,5.754091661872593,4.776851801162071,5.611745612841126,6.196884298155494,5.787135251024936,562841.2127659575,6,E01004115,3,7,2,8,8,8,5.460234946757555,5.234981333464384,5.654516439139843,5.0164408080279825,5.333123957365752,6.088040754199028,5.724263694137335,716867.35,4,5,5,6,3,7,7,1.0,-2,2,-2,4,-5,-1,-1
4014,5.906919986323307,5.344644579134489,5.4996795855070415,4.794700253637213,5.695705993551957,6.162426966115048,5.786199472452465,564435.5473684211,8,E01004116,6,3,3,9,7,8,5.7406884003908205,5.357224026704446,5.45454774147425,4.911299479924716,5.5560635401652405,6.103329351620796,5.840003793056194,719058.1897435897,7,7,2,3,8,7,9,1.0,-1,1,-1,0,-1,0,1
4015,5.875757108132045,5.045034664869308,5.839506298303604,4.778013475735983,5.807095899184545,6.31960498491923,5.843999309341113,43222.691666666666,7,E01004117,1,8,2,9,9,9,5.6134032334468165,5.113408491592999,5.720658555511356,4.953835597333982,5.535088097402292,6.2120926065962445,6.044467680213987,52058.589147286824,5,3,7,4,8,8,9,1.0,-2,2,-1,2,-1,-1,0
4016,5.566223158407464,5.206615521794274,5.6286957869454035,4.982855454323784,5.480671362902122,6.056013996638949,5.682276183965976,563713.7830687831,4,E01004118,4,5,6,5,6,7,5.393523707568089,5.2315786274794105,5.525238312293436,5.146828113315261,5.342215538581955,5.991439022750498,5.668270455342587,718229.9299065421,3,5,3,8,4,5,6,1.0,-1,1,-2,2,-1,-1,-1
4017,5.639867489100896,5.271043702175743,5.677892877344499,4.911515663241782,5.592453495800844,6.173857737702933,5.7052446722287184,563400.2807017544,5,E01004119,5,6,5,7,7,7,5.300062822872365,5.259998231949891,5.5100118902308,5.145372191829794,5.324484892850797,6.008557590507191,5.6376662924444885,717738.0710059172,1,5,3,8,3,5,6,1.0,-4,0,-3,3,-4,-2,-1
4018,5.978883723544467,5.2001905669072634,5.756618692616748,4.7357374809350175,5.7435353774174,6.331140594117961,6.044320010835198,564119.6114649682,8,E01004120,3,7,2,9,9,9,5.838973928646869,5.136473519256316,5.7215351570083435,4.7705364686897,5.592047284884625,6.250144631029611,6.031394912535886,718632.7168674698,8,3,7,1,9,9,9,1.0,0,0,0,-1,0,0,0
4019,5.765792362051072,5.2030497493307575,5.719608587377212,4.738508451218698,5.676407429127911,6.236222112880034,5.766668871337292,13168.320261437908,6,E01004121,4,6,2,9,8,8,5.524391486037592,5.223825530976242,5.6157761086588325,4.92687772001539,5.449525869410971,6.137091310868352,5.736784539607741,21064.490683229815,4,5,5,4,6,8,7,1.0,-2,1,-1,2,-3,0,-1
4020,5.826285460802514,5.330888902108501,5.5237938175051235,4.815047556021082,5.614696401310718,6.163805623692791,5.842560191792766,384056.6771653543,7,E01004122,6,3,3,8,7,9,5.819628703421441,5.240956724553868,5.596801997094914,4.845017709593842,5.632955010386481,6.214313674664152,5.863482887330263,466451.6666666667,8,5,4,2,9,8,9,1.0,1,-1,1,-1,1,1,0
4021,5.551421490999369,5.351463713707068,5.4183763978827715,4.860930996572869,5.458861558355837,5.95348256164127,5.367844608094957,243911.67094017094,4,E01004123,6,2,4,4,4,2,5.355043849486897,5.326849473753009,5.3277142238786634,5.040039230071777,5.246285355388058,5.825620941420043,5.347121778332042,313661.6832740214,2,7,1,6,2,2,1,1.0,-2,1,-1,2,-2,-2,-1
4022,5.359176342080279,5.604988338501473,5.396440814181072,5.062383776757775,5.340577052860725,5.954810049475693,5.299186235520898,245872.0487804878,2,E01004124,9,1,8,2,4,1,5.172598219499355,5.3429447082969235,5.439108891215751,5.168752654781186,5.147967055561097,5.783878785807912,5.371783771165988,315894.2845528455,0,7,2,8,0,1,1,1.0,-2,-2,1,0,-2,-3,0
4023,5.414257739041303,5.519582868696333,5.358708085240544,4.990872808404871,5.3829055111687465,5.90509226730278,5.415746864971814,261367.63963963964,2,E01004125,8,1,6,2,3,3,5.235402084233468,5.310074929605451,5.384415350462261,5.092492972549639,5.179782569408417,5.829133104859737,5.463260207259864,324465.3859649123,1,6,1,7,1,2,3,1.0,-1,-2,0,1,-1,-1,0
4024,5.402674249843159,5.586764627853326,5.422171174952414,4.877815654847474,5.315800339774748,5.925932445357331,5.381939795164936,261772.4778761062,2,E01004126,9,2,4,1,3,2,5.17801894346873,5.386994341015816,5.349399598439534,5.0884542296330135,5.135253359874089,5.765042914946874,5.338366851210594,337935.80833333335,0,8,1,7,0,1,1,1.0,-2,-1,-1,3,-1,-2,-1
4025,5.471350179864214,5.508240298791365,5.36659233446245,4.949587189531946,5.360724645775634,5.986151040374459,5.5190453815769835,459800.32467532466,3,E01004127,8,1,6,2,4,4,5.393737024108836,5.295930463195647,5.458252948402558,4.981493825880473,5.25004793253521,6.024400827868673,5.61135330376209,579541.8456375839,3,6,2,5,2,6,5,1.0,0,-2,1,-1,0,2,1
4026,5.27521350955175,5.547334812889415,5.379172387201924,5.073659813108523,5.265532916242426,5.892534192928598,5.408638971896211,486337.4214876033,1,E01004128,9,1,8,1,3,3,5.0490564718967725,5.330273113330873,5.310019138480435,5.195893614232039,5.1050036053697605,5.775502860045233,5.4838268456338835,628512.3529411765,0,7,0,9,0,1,3,1.0,-1,-2,-1,1,-1,-2,0
4027,5.562688663948414,5.4992932538653525,5.377413400383883,4.946908486443896,5.490668187307757,5.9010773772417116,5.407937690962193,244343.83139534883,4,E01004129,8,1,6,5,3,3,5.581501240888353,5.374178294318815,5.4197706135597015,4.9784253506370675,5.37031371224651,5.964653555200903,5.582413023348012,314111.26519337017,5,7,1,5,4,4,5,1.0,1,-1,0,-1,-1,1,2
4028,5.489429742583234,5.466856173273018,5.390536373135322,5.050047999096227,5.408427019072667,5.922354999504959,5.380210032680524,467453.12703583064,3,E01004130,8,1,7,3,3,2,5.29816121286189,5.4921398515532,5.344811218024711,5.149224185731989,5.185195424500302,5.842661647754308,5.328320632672169,608359.5532544379,1,9,1,8,1,2,1,1.0,-2,1,0,1,-2,-1,-1
4029,5.538844610355338,5.296166331792365,5.623958220287245,4.901696894241839,5.485188254896475,6.089077540806362,5.618913045951298,542295.6479591837,4,E01004131,5,5,5,5,6,6,5.3061153218918236,5.358309463741853,5.464106439315167,5.181605634001112,5.287705823932726,5.952015928386413,5.576816999420677,688691.3195876288,2,7,2,8,2,4,5,1.0,-2,2,-3,3,-3,-2,-1
4030,5.453358875098804,5.343507550286908,5.6763490835825605,4.987702623326728,5.50319474639622,6.095180572347438,5.610598905712155,563115.304964539,3,E01004132,6,6,6,5,6,6,5.19067243640385,5.324931360426403,5.478019904522669,5.315387229124705,5.2775158030646185,5.892576989673433,5.577808918460967,717350.6031746032,1,7,2,9,2,3,5,1.0,-2,1,-4,3,-3,-3,-1
4031,5.448193353155385,5.2878905586574385,5.721929527711177,4.868513304254283,5.521363188391146,6.118927176447882,5.619976153408271,562663.6231884058,3,E01004133,5,6,4,6,7,6,5.146537001044662,5.38346991803911,5.505829702483283,5.206319930818346,5.266069600317214,5.945594091768618,5.609741417566935,716696.8888888889,0,8,3,9,2,4,5,1.0,-3,3,-3,5,-4,-3,-1
4032,5.546227728278891,5.372309462538043,5.582400142567829,4.941590481012771,5.4770473143429435,6.009452314052767,5.671648739032375,248744.9077669903,4,E01004134,6,4,6,4,5,7,5.365924376277297,5.36159267391957,5.531586706358502,5.072724815265674,5.324136209599849,5.949721999011689,5.568158657897806,319964.4694835681,2,7,3,7,3,4,4,1.0,-2,1,-1,1,-1,-1,-3
4033,5.720546864823207,5.227340336614007,5.774171757218022,4.779404650598565,5.674807791741903,6.328141330872606,5.812809080085499,245805.74496644296,6,E01004135,4,7,2,9,9,9,5.496659630897061,5.2298390713314085,5.689756396632866,4.977281743248037,5.451816910865323,6.190914078846874,5.825338318843969,315986.644295302,4,5,6,5,6,8,8,1.0,-2,1,-1,3,-3,-1,-1
4034,5.6130312513297715,5.310846986065449,5.69993280189138,4.826212245813558,5.51763361440578,6.229668224361581,5.7511741074038225,328989.8943661972,4,E01004136,5,6,3,5,8,8,5.366093001089806,5.2339789778733055,5.581284847141298,5.046322174308714,5.3556746500582735,6.03553280357487,5.68977712304139,445841.2314049587,2,5,4,6,4,6,7,1.0,-2,0,-2,3,-1,-2,-1
4035,5.623331730285387,5.22221342432365,5.617935068821639,4.8211455566159795,5.456588865665907,6.006353130501307,5.486875407481461,560339.0,5,E01004137,4,5,3,4,5,4,5.534643366074687,5.11222993516173,5.491220292620634,4.98680086285656,5.360507045116724,5.909746634398456,5.542588786929065,713565.4293193717,4,3,2,5,4,3,4,1.0,-1,-1,-3,2,0,-2,0
4036,5.420311951637268,5.409362193390175,5.4293649797086365,4.955917757528799,5.340140335648148,5.870504057848895,5.3463845464918345,559885.0222222222,2,E01004138,7,2,6,2,2,2,5.380581568365228,5.350205880321869,5.528642860177445,4.9936079831972515,5.219893692290946,5.967034256621583,5.473854661804356,712981.5205479452,2,7,3,5,1,4,3,1.0,0,0,1,-1,-1,2,1
4037,5.6697146985679865,5.2937069945037365,5.579899231903255,4.868716344237328,5.4658795185387135,6.050710009410977,5.5422100787982345,559925.7421875,5,E01004139,5,4,4,4,5,5,5.457229707257968,5.147461385591655,5.534572491409086,5.018238627318794,5.259593311776507,6.017055469201812,5.515291747471965,713214.6524822694,3,4,3,6,2,5,3,1.0,-2,-1,-1,2,-2,0,-2
4038,5.325880542397499,5.353125247088346,5.5935245318846265,4.961550652980804,5.422668771310286,5.891817352988503,5.332528355446729,560863.5909090909,1,E01004140,6,4,6,3,3,1,5.191753431090286,5.249912582337856,5.5127914143460135,5.1974474638700485,5.329870072858674,5.833230804119792,5.3251704062734335,714257.5625,1,5,3,9,3,2,1,1.0,0,-1,-1,3,0,-1,0
4039,5.674307409922282,5.413639303048452,5.601512032084995,4.834047008885277,5.54623577064938,6.022950699594285,5.582665937476688,560301.3222222222,5,E01004141,7,4,4,6,5,5,5.576814885889546,5.3152158488048595,5.520434706398611,4.979087899240215,5.382160851124967,6.031014126338316,5.548972131161207,713489.4494382022,5,6,3,5,5,6,4,1.0,0,-1,-1,1,-1,1,-1
4040,5.332342829154088,5.2539793152075545,5.573589011339041,5.093481453106953,5.362208072497294,5.788029334178337,5.388633151237781,561038.2884615385,1,E01004142,4,4,8,2,1,2,5.387533593596074,5.115291803343254,5.562574707834345,5.0872087524648295,5.337737472852071,5.806231337262873,5.448520664164895,714411.701754386,3,3,4,7,3,2,2,1.0,2,-1,0,-1,1,1,0
4041,5.614646558858911,5.218694779337669,5.607610680619064,4.804478271883362,5.460657526035698,6.078789290116758,5.383662407495538,561753.0102040817,4,E01004143,4,5,3,4,6,2,5.524699630275849,5.075755515406208,5.575018311059603,4.858954221971573,5.41620280537554,6.047215279712472,5.593434362001316,715360.7096774194,4,2,4,2,5,6,5,1.0,0,-2,-1,-1,1,0,3
4042,5.861183542890597,5.361155048844778,5.554770848472711,4.766800163966145,5.714101511814873,6.175250611329441,5.722483159321819,527189.5888324874,7,E01004144,6,4,2,9,7,8,5.672066414300265,5.320838128457047,5.461607593325942,4.89926308365495,5.437545394113926,6.092296504078896,5.681936731360888,678611.8262910799,6,7,2,3,6,7,7,1.0,-1,1,-2,1,-3,0,-1
4043,5.779734540076656,5.342320721113045,5.547478681302253,4.846471690494596,5.677657186985016,6.109257754478746,5.716611557334434,524096.30534351146,6,E01004145,6,4,4,9,6,7,5.5438129504521685,5.2700149718151295,5.487824921539607,5.018638327557554,5.364480078861278,6.025093549468611,5.687519120059133,672056.1039426523,5,6,2,6,4,6,7,1.0,-1,0,-2,2,-5,0,0
4044,5.788996773001588,5.3051732763832,5.524083398006581,4.856071940910669,5.539362323872837,6.0808952281504505,5.61998251338064,561339.0987654321,6,E01004146,5,3,4,6,6,6,5.673370861238049,5.218151475537208,5.560385313341694,4.891731169146876,5.395109587330972,6.044402247090494,5.508952923743956,714794.8451612904,6,5,4,3,5,6,3,1.0,0,0,1,-1,-1,0,-3
4045,5.76455886105457,5.403455878596708,5.5389098388602935,4.819854076368263,5.655557352376271,6.095740795135498,5.654894007257669,560230.578313253,6,E01004147,7,3,3,8,6,7,5.546299656683749,5.36661144752394,5.4946553422646085,4.987006181343035,5.421022869646549,5.999592472206462,5.698279971426183,713387.5113636364,5,7,3,5,6,5,7,1.0,-1,0,0,2,-2,-1,0
4046,5.483291988503443,5.604534083849763,5.400583015729303,5.062982275877913,5.332245202097174,5.837364355995231,5.360663653236546,561757.5136986302,3,E01004148,9,1,8,1,2,2,5.339135318332248,5.3748452257227015,5.319636506504483,5.11091884860286,5.197968650747229,5.793556418242278,5.454776099876121,715369.1037037037,2,7,0,7,1,1,2,1.0,-1,-2,-1,-1,0,-1,0
4047,5.738852461179097,5.372784121440408,5.510761335247853,4.837174076200183,5.587619702021281,6.023241448272121,5.554586781830084,560475.4699453552,6,E01004149,6,3,4,7,5,5,5.548743226605913,5.423181040131527,5.438432002845018,5.031847651885903,5.392196597612423,5.936831035043882,5.621711262542268,713703.0760869565,5,8,2,6,5,4,5,1.0,-1,2,-1,2,-2,-1,0
4048,5.9729838946769975,5.236198090273758,5.652399118604331,4.772960183949306,5.606580552355997,6.034438141461076,5.643799102511899,570040.9655172414,8,E01004150,4,5,2,7,5,6,5.683430124501713,5.281019709149345,5.610891887399017,4.924772160952209,5.434359307171868,5.934920744817765,5.5657365136459225,725486.4590163934,6,6,5,4,6,4,4,1.0,-2,2,0,2,-1,-1,-2
4049,6.233297378962277,5.137597961280182,5.782145176225036,4.515493933481115,5.840386257826827,6.262170962704957,5.769529084212907,570743.5801526718,9,E01004151,3,7,0,9,8,8,5.92230240503947,5.183683372283166,5.644123502479967,4.764970019806263,5.496135083279868,6.153984958811324,5.711122981337613,726977.2635658914,8,4,5,1,7,8,7,1.0,-1,1,-2,1,-2,0,-1
4050,6.077656182774737,5.248409368509164,5.683267546577688,4.647099089037421,5.759663011398784,6.115820892018043,5.733960096090118,571755.9509202454,9,E01004152,4,6,0,9,7,8,5.873690162957048,5.201542315536371,5.677175007052928,4.7617141554475495,5.581231147883325,6.078539123082294,5.700900506040903,728041.3687150838,8,4,6,1,9,7,7,1.0,-1,0,0,1,0,0,-1
4051,6.2624667993112775,5.1502479655402045,5.7693562808157015,4.584653780239971,5.904864617756435,6.230285089556911,5.8509327103109925,571760.2689075631,9,E01004153,3,7,0,9,8,9,5.8925218120698,5.208405256271362,5.663708173459576,4.7266380056258175,5.556807228634434,6.118046958600321,5.683187098272385,728166.9193548387,8,5,6,0,8,7,7,1.0,-1,2,-1,0,-1,-1,-2
4052,6.250250189254682,5.196737377593915,5.828292762239774,4.517599048713843,5.928871497511864,6.382080166290204,5.885116995622714,571002.0625,9,E01004154,3,8,0,9,9,9,5.9340425768206195,5.286355506989263,5.540188558640018,4.833207808515077,5.528289379612092,6.2639344943467,5.93508312074087,727222.6129032258,9,6,3,2,8,9,9,1.0,0,3,-5,2,-1,0,0
4053,6.130538575684846,5.194915883576692,5.862174870362923,4.6616017498187166,5.761767279745928,6.275070645915928,5.73660206349928,572724.8656716418,9,E01004155,3,8,1,9,8,8,5.792677789708994,5.178870885041508,5.7008155662648,4.837926473930804,5.474941149245214,6.105183061892099,5.702974188066747,729428.4525547446,7,4,6,2,7,7,7,1.0,-2,1,-2,1,-2,-1,-1
4054,5.943784194462227,5.247722070325505,5.720042319008798,4.786155464071216,5.650093723427165,6.10926216840744,5.702683612252727,565730.7272727273,8,E01004156,4,6,3,8,6,7,5.838951968484455,5.240658049782117,5.6730192253987,4.810516801145342,5.557101940943135,6.170559810267554,5.74793175690704,720593.9791666666,8,5,6,2,8,8,8,1.0,0,1,0,-1,0,2,1
4055,6.028002497761748,5.221927858369295,5.677183890065481,4.732644120621127,5.717770235483036,6.2366010006084,5.881048976681953,573278.1627906977,8,E01004157,4,6,2,9,8,9,5.770905163628714,5.20890643801008,5.672577742167881,4.859231514930725,5.552755631038121,6.169480800628662,5.8651661729812625,730309.5257142857,7,5,6,2,8,8,9,1.0,-1,1,0,0,-1,0,0
4056,6.160528552595269,5.218201241795978,5.694786110883037,4.630693535325388,5.750091750785788,6.192287429930672,5.830411111236249,572929.9365079365,9,E01004158,4,6,0,9,8,9,5.959085656249004,5.2059008265319076,5.651220057321631,4.742583066872928,5.571021820540014,6.216138430263685,5.787618961671124,729949.8097826086,9,4,5,1,9,8,8,1.0,0,0,-1,1,0,0,-1
4057,5.684550639152527,5.341010232925415,5.581212779998779,4.862622126579285,5.503109208106995,6.083369649887085,5.616171845436096,562253.544,5,E01004159,6,4,4,5,6,6,5.381257482277331,5.2591379760771755,5.480554135270821,5.062844191410745,5.216067915739015,5.968067919561105,5.606125140374945,716042.2635658914,2,5,2,7,1,4,5,1.0,-3,-1,-2,3,-4,-2,-1
4058,5.895657613994629,5.265209541088197,5.650327706724648,4.714143233570626,5.634258746131649,6.213195484828174,5.70316246466908,563821.6991869919,7,E01004160,5,5,1,8,8,7,5.7006725103690705,5.200732592878671,5.626503481947142,4.8963772788130004,5.411846811401433,6.137183602513938,5.75608726205497,718255.75,7,4,5,3,5,8,8,1.0,0,-1,0,2,-3,0,1
4059,5.835234605482895,5.470276667253814,5.523995780596768,4.8198254621812024,5.549108040593836,6.1379404485660745,5.687683631033793,562819.0583941606,7,E01004161,8,3,3,6,7,7,5.585137326542924,5.3815053468797265,5.394719810020633,5.066435454337578,5.26934945971016,6.061596459489528,5.867277393496133,716927.3333333334,5,8,1,7,2,6,9,1.0,-2,0,-2,4,-4,-1,2
4060,5.904342861808076,5.233983830529816,5.733349612780979,4.785413894118095,5.688595355773459,6.1027247784089065,5.695423673610298,563672.3673469388,8,E01004162,4,6,3,9,6,7,5.729715845099202,5.114567272089146,5.618696150956331,4.9309890237119465,5.504867940037339,6.025308260211238,5.613732150307408,717418.5185185185,7,3,5,4,8,6,5,1.0,-1,-1,-1,1,-1,0,-2
4061,5.473251183621295,5.448381796750155,5.518582863621898,4.955941983631679,5.462912698225542,5.994118936959799,5.58238583849622,525329.3818181818,3,E01004163,8,3,6,4,4,5,5.2607636991384865,5.294135139600651,5.442457373077805,5.14870091145103,5.228503856304529,5.877578582312609,5.529554213221009,654036.6283783783,1,6,2,8,1,3,4,1.0,-2,-2,-1,2,-3,-1,-1
4062,5.854134106222605,5.258528145751512,5.638572108538853,4.746392477454478,5.581171455410864,6.13590931892395,5.808240185583258,557919.4161849711,7,E01004164,4,5,2,7,7,8,5.643198975649747,5.286591339111328,5.616023020310835,4.945774167956728,5.41241955684893,6.090838420752323,5.716161480816928,710462.8606060606,6,6,5,4,5,7,7,1.0,-1,2,0,2,-2,0,-1
4063,5.439353700456673,5.516812748749163,5.412113963558687,5.0397292102515365,5.368354187331386,5.87340138810973,5.417003474422008,558593.5977653632,2,E01004165,8,2,7,2,2,3,5.353990688690772,5.367473236719767,5.422620517779619,5.036788888466664,5.241018489079598,5.858046554907775,5.4642449128322115,711348.8512820513,2,7,1,6,1,2,3,1.0,0,-1,-1,-1,-1,0,0
4064,5.974250371470773,5.1513341284968375,5.753523516508699,4.693882932692218,5.682931459023178,6.1160632657127145,5.700588088094091,557770.4662576687,8,E01004166,3,7,1,9,7,7,5.827290294463174,5.195927328533596,5.641572768228096,4.805691906583239,5.512356876629835,6.062604339499223,5.765274617407057,710274.7134502924,8,4,5,1,8,6,8,1.0,0,1,-2,0,-1,-1,1
4065,5.360910344714961,5.48705180124803,5.3851335876244155,4.980985519314601,5.329145867962483,5.907179109321153,5.402633804920291,559137.347107438,2,E01004167,8,1,6,1,3,2,5.2555129743855575,5.273793992297403,5.3874048487893464,5.0109346529533125,5.263727491271907,5.943581698269679,5.508414741220145,712018.9913793104,1,6,1,6,2,4,3,1.0,-1,-2,0,0,1,1,1
4066,5.683039247554584,5.254998108766375,5.614805117140722,4.792612463888461,5.6900694909757075,6.119367515953788,5.835324671146643,559437.9489051095,5,E01004168,4,5,3,9,7,9,5.408918627044734,5.164855452144847,5.622215388452306,4.979015471304164,5.4268593937158585,6.111977549160228,5.838761403280146,712419.4779411765,3,4,5,5,6,7,9,1.0,-2,0,0,2,-3,0,0
4067,5.355367627036705,5.560338994090476,5.315424407466074,5.009596641144056,5.393298676844394,5.795578217238523,5.3248682129249145,357724.21348314604,2,E01004169,9,1,7,3,1,1,5.1642115763995955,5.469484640204388,5.304534559664519,5.161718949027684,5.18006543232047,5.749395391215449,5.363970624363941,430649.1195652174,0,9,0,8,1,1,1,1.0,-2,0,-1,1,-2,0,0
4068,5.710535003149763,5.223338115722575,5.651924086377976,4.8189290654152,5.5296874179485,6.094792680537447,5.650339013084452,557668.7765957447,6,E01004170,4,5,3,6,6,7,5.508873130548446,5.2260992769251535,5.652741753481289,5.041123414422102,5.420305108641558,6.0424888146752345,5.650068630509198,710190.9679144385,4,5,5,6,6,6,6,1.0,-2,1,0,3,0,0,-1
4069,5.869284189295494,5.181895331404675,5.596077116056421,4.7978391983043185,5.615949105942386,6.119591363545122,5.794635450702974,557035.9827586206,7,E01004171,3,4,3,8,7,8,5.770305099417862,5.249209607689126,5.564666669924282,4.889677106755451,5.444096705288563,6.067843544830397,5.6621877255949,709387.2572815533,7,5,4,3,6,6,6,1.0,0,2,0,0,-2,-1,-2
4070,5.734829505936045,5.281125880655695,5.55670006353347,4.837266686509867,5.505823336663793,6.053107130722921,5.510051641307894,556834.9180327869,6,E01004172,5,4,4,5,5,4,5.535245982968077,5.269113369134008,5.628211515290396,4.9550618152229156,5.400493412601705,5.937067552488678,5.606963093183478,709063.1734693878,4,6,5,4,5,4,5,1.0,-2,1,1,0,0,-1,1
4071,5.710933787900894,5.255585001140345,5.6563639640808105,4.793402820337014,5.500284701097207,6.1733999936307065,5.624316951290506,556496.606557377,6,E01004173,4,5,3,5,7,6,5.6320090072833935,5.194279519927423,5.605543891325691,4.927840067061368,5.444234427237353,6.03566971677818,5.519020579508599,708565.8874172185,6,4,5,4,6,6,4,1.0,0,0,0,1,1,-1,-2
4072,5.6850703179836275,5.19481970568498,5.669601575533549,4.773622452219327,5.5387933403253555,6.143434828519821,5.661997750401497,556503.2,5,E01004174,3,6,2,6,7,7,5.668766121380031,5.101614008657634,5.77541677840054,4.919520101509988,5.502144725061953,6.049524299800396,5.545793853700161,708595.7890625,6,3,7,4,7,6,4,1.0,1,0,1,2,1,-1,-3
4073,5.724550187587738,5.315016909004891,5.565741988077556,4.802292947083304,5.5044059867728246,6.0493916289447105,5.523923090875965,557198.404109589,6,E01004175,5,4,3,5,5,4,5.602581579544965,5.357064892263973,5.403628908886629,4.914254482353435,5.313999757345985,6.006658801611732,5.632788011607002,709491.8882352941,5,7,1,3,3,5,6,1.0,-1,2,-3,0,-2,0,2
4074,5.711306196710337,5.258219118740247,5.580331045648326,4.840994564346645,5.519220362538877,6.152192441276882,5.649223595080168,557321.8260869565,6,E01004176,4,4,4,6,7,7,5.593211653599372,5.194465498740857,5.64619172169612,4.8750382423400875,5.382109223879301,6.071157147334172,5.725367888120505,709651.0846153846,5,4,5,3,5,7,7,1.0,-1,0,1,-1,-1,0,0
4075,6.022208533748504,5.1913865812363165,5.748112586236769,4.661298905649493,5.707877181422326,6.175580398498043,5.790064830164756,567932.2322580646,8,E01004177,3,7,1,9,7,8,5.774089538756712,5.202225108941396,5.713648475246665,4.796765468738697,5.55879184934828,6.150123285658566,5.650703431647501,723389.8086419753,7,4,6,1,8,8,6,1.0,-1,1,-1,0,-1,1,-2
4076,5.624315803631758,5.162458250919978,5.722641111948551,4.907573527250534,5.446877390910418,6.049787862178607,5.629727270358648,562909.1538461539,5,E01004178,3,6,5,4,5,6,5.541055376766718,5.026769917610793,5.766665210500795,4.898646004715858,5.456853125527588,6.0686514042971424,5.646565557223314,717108.0467836257,5,2,7,3,7,7,6,1.0,0,-1,1,-2,3,2,0
4077,5.966618007421493,5.15735617056489,5.782895413041115,4.785383687913418,5.607520417869091,6.306258670985699,5.942564275860787,568161.73125,8,E01004179,3,7,3,7,9,9,5.632971495579762,5.07920695717927,5.73596847285131,4.923849055721502,5.502638907189581,6.213065142844133,5.772888145629008,723650.6178343949,6,2,7,4,7,8,8,1.0,-2,-1,0,1,0,-1,-1
4078,6.157109301241618,5.250101153812711,5.695515742377629,4.563122685939547,5.7821573586690995,6.288026424627455,5.922244074325713,569413.7738095238,9,E01004180,4,6,0,9,9,9,6.0115025370432855,5.2232873097753725,5.738561715757797,4.743805794273248,5.6454646527012695,6.233924832525132,5.778213728832293,725221.0464135021,9,5,7,1,9,9,8,1.0,0,1,1,1,0,0,-1
4079,6.039542878566145,5.21419097290558,5.6895455795080485,4.656879571830334,5.756216386548516,6.209420251197556,5.755172782203778,568660.3537414966,9,E01004181,4,6,1,9,8,8,5.941610654195149,5.191919126293876,5.678160095756704,4.752339923020565,5.596651974952582,6.139460937543348,5.585167772842176,724318.3106060605,9,4,6,1,9,8,5,1.0,0,0,0,0,0,0,-3
4080,5.678260089515091,5.223947475482891,5.714599389534492,4.819796432148326,5.5237067241173285,6.1193651998197875,5.622444481044621,557964.4285714285,5,E01004182,4,6,3,6,7,6,5.48305024870907,5.19113976553262,5.677597471030362,4.939766968589232,5.353564451975995,5.930678565818143,5.459767847176058,710857.686746988,4,4,6,4,4,4,3,1.0,-1,0,0,1,-2,-3,-3
4081,5.486949567892114,5.508616742633638,5.363601241792951,4.943539780824363,5.376196466335634,5.884321164111702,5.338582209178379,242453.9863945578,3,E01004183,8,1,6,2,3,2,5.28569488958879,5.308904227343473,5.391771817207337,5.1067736842415545,5.1917658589103,5.826113818631027,5.520239667458967,311744.58181818185,1,6,1,7,1,2,4,1.0,-2,-2,0,1,-1,-1,2
4082,5.448685863661388,5.600226726796892,5.4140396931814765,4.993386077502417,5.4412643814843795,5.904605604353405,5.403569479783376,242360.88888888888,3,E01004184,9,2,6,4,3,2,5.227736354770517,5.4235748455936745,5.4334807270451595,5.103689967241502,5.279162755586151,5.915802010916229,5.453953363841638,311587.3909774436,1,8,2,7,2,3,2,1.0,-2,-1,0,1,-2,0,0
4083,5.590904553204973,5.489892012236134,5.271618235190183,4.88666208058793,5.455616395205062,5.886366787335731,5.385673290056898,242381.72185430463,4,E01004185,8,0,5,4,3,2,5.5354648524482775,5.392432696067247,5.293179428017379,4.979745621649211,5.32318241404207,5.881523227531638,5.494716450672022,311628.0268456376,4,8,0,5,3,3,3,1.0,0,0,0,0,-1,0,1
4084,5.510250536458833,5.4142598541719575,5.454834410122463,5.043044793818678,5.421129920652935,5.946737476757595,5.397904702595302,242681.88392857142,3,E01004186,7,2,7,3,4,2,5.38940463917596,5.284249183109829,5.451964269365583,5.102058001075473,5.274648571014405,5.9684704337801255,5.491619896888733,312021.40714285715,3,6,2,7,2,5,3,1.0,0,-1,0,0,-1,1,1
4085,5.460836483882024,5.47254813467706,5.436671125305282,4.979121960960068,5.437788860781209,5.985891788155882,5.489934713690431,242465.2097902098,3,E01004187,8,2,6,4,4,4,5.299723101737804,5.23596595731893,5.47553368977138,5.124248104884212,5.354137270074141,5.855581556047712,5.34218922952064,311692.992481203,1,5,2,8,4,2,1,1.0,-2,-3,0,2,0,-2,-3
4086,5.425451039536599,5.294939485795659,5.496760837139528,4.9821632339910495,5.4123550624203824,5.884607865035168,5.398040310736814,334797.6319018405,2,E01004188,5,3,6,3,3,2,5.41694961730824,5.262049510035404,5.512200864248498,5.013680641041246,5.32394764312478,5.889074048330618,5.403732475153236,438121.3953488372,3,6,3,6,3,3,2,1.0,1,1,0,0,0,0,0
4087,5.588895541540584,5.501129585023252,5.308579110210727,4.975624537616042,5.451835167333947,5.8836328531644355,5.455111689449097,241963.98136645963,4,E01004189,8,0,6,4,3,3,5.557047548817425,5.435484338824342,5.325842657467214,4.928930864828389,5.3624128321321995,5.951287827840665,5.52695623621708,311100.7073170732,5,8,1,4,4,4,4,1.0,1,0,1,-2,0,1,1
4088,5.796129878050362,5.30588472045325,5.723291979895698,4.758900598762861,5.693245448318183,6.256123248268576,5.815080451030357,554072.7450980392,7,E01004190,5,6,2,9,8,9,5.601306842594612,5.277392908567336,5.645868288307655,4.904841412131379,5.4368001062695575,6.178432530019341,5.817120797023541,706875.737804878,5,6,5,3,6,8,8,1.0,-2,1,-1,1,-3,0,-1
4089,5.519811610032243,5.315333218602409,5.620284470898366,4.941110080445719,5.470130999185885,6.111578301379555,5.639556465093156,564157.9298245613,3,E01004191,5,5,6,4,7,6,5.39794234458138,5.35507161547156,5.581127649195054,5.068704953614403,5.359967490504769,6.044395793185514,5.516434266987969,718755.2,3,7,4,7,4,6,4,1.0,0,2,-1,1,0,-1,-2
4090,5.711831358762888,5.420298135363972,5.4879527275378885,4.883795469790906,5.483939897763979,6.07545804977417,5.497598604722456,72724.86713286713,6,E01004192,7,3,5,5,6,4,5.557398225279416,5.37141545940848,5.47038884233026,4.928752974201651,5.3251464198617375,6.076411186947542,5.6303122513434465,122844.9588235294,5,7,2,4,3,7,6,1.0,-1,0,-1,-1,-2,1,2
4091,5.447434295119578,5.418680010503427,5.552587894345984,5.040426970217269,5.473893172479089,5.988085226516503,5.479316145009388,298280.61849710986,3,E01004193,7,4,7,4,4,4,5.36200050369324,5.486422217993373,5.381250846816833,5.172834244597868,5.314238899682899,6.068865132619099,5.584903102323233,347257.2409638554,2,9,1,8,3,7,5,1.0,-1,2,-3,1,-1,3,1
4092,5.504126586131195,5.554858896269727,5.417636618685367,5.001677579844176,5.467243733690746,5.906741375353799,5.398938775062561,276795.9104477612,3,E01004194,9,2,7,4,3,2,5.380075757452052,5.452453937461908,5.364555842584843,5.189714954911376,5.296509499172513,5.893087020880884,5.460862150295175,357320.726618705,2,8,1,8,2,3,3,1.0,-1,-1,-1,1,-2,0,1
4093,5.512724343980296,5.246063396502077,5.639283042275504,4.840177361884813,5.503117562010047,6.054862602373188,5.600819523414869,160111.01123595505,3,E01004195,4,5,4,5,6,6,5.467031072095497,5.211346611534197,5.597843372944704,4.986088578848495,5.3346045644012925,6.02094702499429,5.638334274291992,196385.3505154639,4,5,4,5,3,6,6,1.0,1,1,-1,1,-2,0,0
4094,5.628360488697102,5.25639438472296,5.6056932163865945,4.8138984967219205,5.591375997191982,6.172448757447694,5.757592867079534,561759.3815789474,5,E01004196,4,4,3,7,7,8,5.419465094436834,5.39297087840092,5.382267871756612,5.089965096226445,5.328249728238141,5.974682289877055,5.673051523573605,710991.2530864198,3,8,1,7,3,5,6,1.0,-2,4,-3,4,-4,-2,-2
4095,5.1814587922069615,5.268681363686503,5.482752966481214,5.160278135171816,5.338627363716424,5.592955137764275,5.174415271375432,642160.1955307262,0,E01004197,5,3,9,2,0,0,5.227967322468758,5.032625812888146,5.728289732933044,5.069579852223396,5.35798348903656,5.704200893640518,5.268919649124146,814268.22,1,2,7,7,4,0,0,1.0,1,-3,4,-2,2,0,0
4096,5.211198817438154,5.250445501128239,5.38826314015175,5.237005982826005,5.272212135258005,5.5451283241385845,5.222361169644256,640684.5522388059,0,E01004198,4,1,9,1,0,0,5.176701013592706,5.125272268834322,5.612735962522203,5.194446411685667,5.247075101603633,5.59346844493479,5.288341484208038,812527.5652173914,0,3,5,8,2,0,0,1.0,0,-1,4,-1,1,0,0
4097,5.171924087507971,5.299929561286137,5.527480145980572,5.100978536852475,5.354677335969333,5.696803627343013,5.224437871883655,640927.7586206896,0,E01004199,5,3,8,2,0,0,5.121508215603075,5.272235797162642,5.542121146854601,5.109885136286418,5.378144690864964,5.698934617795442,5.332842145049781,812816.3157894737,0,6,3,7,4,0,1,1.0,0,1,0,-1,2,0,1
4098,5.258210078433708,5.128682913603606,5.607213444179958,4.9585097939879805,5.494529158980758,5.726324823167589,5.362461140862218,641201.6296296297,1,E01004200,2,5,6,5,1,2,5.271607769698631,5.107933195625863,5.668795132055515,4.959595674421729,5.3822343451220815,5.81394156014047,5.474960706582883,813334.5,1,3,6,4,5,2,3,1.0,0,1,1,-2,0,1,1
4099,5.847019064810969,5.00771957732016,5.783443518223301,4.710898464725863,5.612115475439256,6.05495064104757,5.536721689085806,640808.7338709678,7,E01004201,1,7,1,8,6,5,5.653009005955288,5.047281437686512,5.763329727309091,4.772436634770462,5.554586002869265,6.003051368253572,5.562143287488392,812456.1517857143,6,2,7,1,8,5,4,1.0,-1,1,0,0,0,-1,-1
4100,5.135998156605934,5.198053827091139,5.492429774634692,5.053878919202454,5.299761198004898,5.7257363966533115,5.226726201115822,642446.3163265307,0,E01004202,3,3,7,1,1,0,5.257116708904505,5.144567705690861,5.705048069357872,5.09438689922293,5.40688144788146,5.716169486443202,5.3789569810032845,814875.1041666666,1,3,6,7,5,0,1,1.0,1,0,3,0,4,-1,1
4101,5.232294748226802,5.103245515376329,5.660173858205478,5.028910069415967,5.362175423651934,5.730373834570249,5.293468511352937,641153.96875,0,E01004203,2,5,7,2,1,1,5.308987356268841,5.085295859627101,5.646239015330439,5.045398474776227,5.366702770150226,5.7155959751295,5.292984528126924,813055.8173913043,2,3,5,6,4,0,0,1.0,2,1,0,-1,2,-1,-1
4102,5.630069399873416,5.17265968852573,5.655762543280919,4.973509983883964,5.500577479600906,5.964067098167208,5.600078754954868,644560.0972222222,5,E01004204,3,5,6,5,4,6,5.580196890486292,5.193251634218607,5.667096620582672,4.975080116685614,5.540615346058305,5.894816435963275,5.54822428686073,817466.9759036144,5,4,6,5,8,3,4,1.0,0,1,1,-1,3,-1,-2
4103,5.221540472593652,5.265903237354324,5.5338212926703765,5.036105260791548,5.295718022139676,5.5879133264702485,5.4176372849797625,641845.6626506024,0,E01004205,5,3,7,1,0,3,5.301489962310326,5.0192503493006635,5.583432485417622,5.0459849209320256,5.363884925842285,5.75613574283879,5.399870338963299,813794.8048780488,2,2,4,6,4,1,2,1.0,2,-3,1,-1,3,1,-1
4104,5.287532681599259,5.149237843230367,5.599786125123501,4.966684985905886,5.428705561906099,5.713562272489071,5.299685453996062,640771.484375,1,E01004206,3,4,6,3,0,1,5.357562693072037,5.017221059597714,5.527554676566325,4.957724005403653,5.393365087643476,5.775539539229702,5.345845962913943,812594.9154929577,2,2,3,4,5,1,1,1.0,1,-1,-1,-2,2,1,0
4105,5.414413943484023,5.060979094054248,5.785159732844378,4.906357259363742,5.428983250179806,5.884322482186395,5.4547873300475045,640034.8378378379,2,E01004207,2,7,5,3,3,3,5.353480041890904,5.108713524928992,5.7723827742148135,5.046612924423771,5.445769907771677,5.846922556559245,5.443350465401359,811698.6666666666,2,3,7,6,6,2,2,1.0,0,1,0,1,3,-1,-1
4106,5.356093683712919,5.0642434677607575,5.651675202477146,4.895122047881006,5.445889636664323,5.783293000409301,5.464178029080512,654477.1197183098,2,E01004208,2,5,5,4,1,3,5.454513937455636,4.962095020435474,5.828913775196781,4.968508132298788,5.40191821080667,5.859629880057441,5.541638386691058,831950.074074074,3,1,8,5,5,2,4,1.0,1,-1,3,0,1,1,1
4107,5.336942120240285,5.062532255282769,5.571526087247408,4.998140431367434,5.425129826252277,5.811409762272468,5.400581307136095,640457.9807692308,1,E01004209,2,4,7,3,2,2,5.43658987681071,5.008204948334467,5.6956986094278,4.955924974547492,5.413009938739595,5.8184987968868676,5.544245509874253,812181.6666666666,3,2,6,4,5,2,4,1.0,2,0,2,-3,2,0,2
4108,5.3493618626113335,5.19929247164945,5.564174881768883,4.9483961730922035,5.487231495183543,5.616245391172007,5.381932495930873,641140.8807339449,1,E01004211,3,4,6,5,0,2,5.346225392214859,4.953870200658146,5.650741814058038,4.9900670255286785,5.377970448777646,5.7205344061308265,5.444869176496433,813106.5189873418,2,1,5,5,4,1,2,1.0,1,-2,1,-1,-1,1,0
4109,5.115419411039972,5.164589219279104,5.452935404591746,5.0212775546234925,5.380151985527633,5.565218149841606,5.251772504348259,640694.2597402597,0,E01004212,3,2,7,2,0,1,5.095427534454747,4.93224319282331,5.647865468577335,5.1115873951660955,5.303791086297286,5.616267746373227,5.252227640151977,812535.5789473684,0,1,5,7,3,0,0,1.0,0,-2,3,0,1,0,-1
4110,5.261387529698285,5.316351123831489,5.461379674347964,5.149141073226929,5.233456768772819,5.739203669808128,5.2484142780303955,504373.13636363635,1,E01004214,5,2,9,0,1,1,4.988998068462719,5.357820944352583,5.491331711682406,5.279476074738936,5.206931402466514,5.673975875160911,5.153260590813376,655905.9818181818,0,7,2,9,1,0,0,1.0,-1,2,0,0,1,-1,-1
4111,5.529095136636013,5.27362915229153,5.624288236772692,4.908299757016672,5.40255000945684,5.882609856289786,5.551862497587462,522913.00675675675,3,E01004215,5,5,5,3,3,5,5.372936507517641,5.119108433750543,5.630855710668997,5.113228610970757,5.3085140734910965,5.882352123206312,5.520570467141542,671249.1420454546,2,3,5,7,3,3,4,1.0,-1,-2,0,2,0,0,-1
4112,5.5743174011057075,5.2160653444853695,5.507767363028093,5.1038194786418565,5.406124510548332,5.884221949360588,5.530920112674886,313119.1818181818,4,E01004216,4,3,8,3,3,5,5.566189490831816,5.125770738491645,5.688985962134141,5.019630230390108,5.383376605235613,5.982720558459942,5.62731622503354,409965.8846153846,5,3,6,6,5,5,6,1.0,1,-1,3,-2,2,2,1
4113,5.418800325104685,5.383652962337841,5.4007239139441285,4.9619249184926355,5.3311569011572635,5.76635802081137,5.3315490592609756,306863.95151515154,2,E01004217,7,1,6,1,1,1,5.482702535390854,5.294757072627545,5.561340503394604,5.049481879174709,5.330530127882957,5.889490082859993,5.4463723346591,392790.9875,4,6,4,6,3,3,2,1.0,2,-1,3,0,2,2,1
4114,5.487556431253077,5.43508146172863,5.485343411817389,5.025447179705409,5.412183469634945,5.834406381946499,5.362320405952001,279131.39830508473,3,E01004218,7,3,7,3,2,2,5.368885509534316,5.165751897205006,5.577490180188959,5.056256236813285,5.308266061002558,5.844286136193709,5.413437533378601,359182.45454545453,2,4,4,6,3,2,2,1.0,-1,-3,1,-1,0,0,0
4115,4.989384820235187,5.352656156338495,5.2722861371163665,5.247417712006076,5.095333140471886,5.5341116020391725,5.292435774515415,503677.7629310345,0,E01004219,6,0,9,0,0,1,5.011469409772844,5.2951577080018595,5.373620309612968,5.295692544994933,5.113741647113454,5.583161524750969,5.358822377342166,643175.4545454546,0,6,1,9,0,0,1,1.0,0,0,1,0,0,0,0
4116,5.414848915601181,5.324894414109699,5.546713053169897,4.958181421635515,5.315470639931953,5.77477306228573,5.435350215030929,494659.6440677966,2,E01004221,6,4,6,1,1,3,5.371919317448393,5.168164021579932,5.589347704082516,5.023751624932526,5.336442195777352,5.834064593551852,5.489942986068996,632567.2127659575,2,4,4,6,3,2,3,1.0,0,-2,0,0,2,1,0
4117,5.126209299460701,5.3634996704433275,5.53296830135843,5.10429320231728,5.2194968337598056,5.683003228643666,5.264265601531319,644720.9913043479,0,E01004222,6,3,8,0,0,1,5.082260929970515,5.228433203697205,5.644837813150315,5.135015327589852,5.208344197273254,5.7113070351736885,5.394039233525594,817778.0476190476,0,5,5,8,1,0,2,1.0,0,-1,2,0,1,0,1
4118,5.434535178612537,5.403494730709106,5.389394717892324,5.054324674794055,5.348497372912609,5.831670612800778,5.384560016196544,644574.7007874015,2,E01004223,7,1,7,2,2,2,5.423262749847613,5.3421903398999,5.4351194762347035,5.058509269304443,5.3158657822692605,5.79310922769078,5.388753001104321,817270.1315789474,3,7,2,6,3,1,1,1.0,1,0,1,-1,1,-1,-1
4119,4.831847292423248,5.58411399936676,5.064889413356781,5.448960845470428,5.043436327934265,5.335124799251556,4.969263351440429,634677.396,0,E01004224,9,0,9,0,0,0,4.985914344248706,5.359842273878725,5.3491513602537655,5.305933571433368,5.1095329963997616,5.5325729520353555,5.1578588575532995,787650.9623287672,0,7,1,9,0,0,0,1.0,0,-2,1,0,0,0,0
4120,5.471743721101019,5.027627517779668,5.754051986667845,4.853328294224209,5.428432858652538,5.896767944097519,5.37633437746101,518676.47222222225,3,E01004225,1,7,4,3,3,2,5.362319649082341,4.929645437083832,5.710949905931133,5.092776228303778,5.279168788700888,5.82937844158852,5.437105539726884,662034.5342465753,2,1,6,7,2,2,2,1.0,-1,0,-1,3,-1,-1,0
4121,5.238473072494428,5.204621758657632,5.632861388098333,5.123605733065261,5.30805304615768,5.694993744191435,5.087131857872009,638668.9072164949,1,E01004226,4,5,8,1,0,0,5.135492706785397,5.080986915802469,5.750008927316082,5.056654351098197,5.30516614719313,5.747642582776595,5.17215168719389,809833.8469387755,0,2,7,6,3,1,0,1.0,-1,-2,2,-2,2,1,0
4122,5.592498657226563,4.903403256416321,6.081370216369629,4.826070349693298,5.4343938045501705,6.00802220916748,5.579324761390686,638789.72,4,E01004228,0,9,3,3,5,5,5.59641767699143,4.873248089593032,6.011476002068355,4.8932077391394255,5.378375718511384,5.98049164804919,5.682826484482864,810049.6206896552,5,0,9,3,4,5,7,1.0,1,0,0,0,1,0,2
4123,5.563879171049739,5.080969688404037,5.735767220876303,4.885429439774478,5.473409269229475,5.908715911658414,5.43417492401169,638434.7590361446,4,E01004229,2,6,5,4,3,3,5.36826242685318,5.095304055213928,5.665996160507202,4.962385846376419,5.311205744743347,5.822408893108368,5.46327885389328,809619.27,2,3,6,4,3,2,3,1.0,-2,1,0,-1,-1,-1,0
4124,5.539930818391883,5.093530291059743,5.843554710305256,4.8291250788647195,5.4855150989864185,5.948240083196889,5.5484778881073,639129.0434782609,4,E01004230,2,8,3,5,4,5,5.475885526207853,5.043052079263798,5.716441191917609,4.9857573528920325,5.395873644135215,5.893746939572421,5.6199690665095305,810482.3884297521,4,2,7,5,5,3,5,1.0,0,0,-1,2,0,-1,0
4125,5.381067789263195,5.117917650275761,5.690734730826484,5.05559905204508,5.432107577721278,5.755862040652169,5.336690455675125,626320.0,2,E01004231,2,6,7,3,1,2,5.254294975807793,5.1411424890944835,5.678710645750949,5.1384094545715735,5.22021138040643,5.807484771076002,5.440382431996496,795449.9868421053,1,3,6,8,1,2,2,1.0,-1,1,0,1,-2,1,0
4126,5.5697795869587186,5.0477752343758,5.748890306566145,4.855745637333476,5.443405894966392,5.923974847460126,5.635055024307091,638736.8881118881,4,E01004232,1,7,4,4,3,6,5.546611094961361,4.8995399921118805,5.849511216286899,4.913644869311327,5.365376864971758,5.912838197889782,5.652606574045557,809992.9591836735,5,0,8,3,4,3,6,1.0,1,-1,1,-1,0,0,0
4127,5.485431348735636,5.269079154187983,5.6955945979465135,4.928107096390291,5.419273262674158,5.911042955788699,5.409791992469267,643728.7272727273,3,E01004233,5,6,5,3,3,3,5.479607869002779,5.1995472221051235,5.6278843313960705,5.022766953807766,5.4340841729762195,5.9072349334167225,5.32124045541731,816699.8813559322,4,4,5,6,6,3,1,1.0,1,-1,-1,1,3,0,-2
4128,5.8904682066408505,5.109505784885766,5.772656336493556,4.733840569252391,5.607618226598731,6.054051180056927,5.665446254704565,641743.6905829597,7,E01004234,2,7,2,7,5,7,5.82893505953424,5.018849762354029,5.69394583196684,4.834975539264591,5.553982756654238,6.0082682003073975,5.670239106301339,813823.7419354839,8,2,6,2,8,5,6,1.0,1,0,-1,0,1,0,-1
4129,5.18977794280419,5.5650830543958225,5.263668894767761,5.214191986964299,5.229430927680089,5.32348128924003,5.251067409148583,517184.23076923075,0,E01004235,9,0,9,0,0,1,5.067873388528824,5.313661992549896,5.1624407060444355,5.305863041430712,5.088880434632301,5.398473277688026,5.107433564960957,660270.625,0,6,0,9,0,0,0,1.0,0,-3,0,0,0,0,-1
4130,5.184059868093397,5.471274753085902,5.288308849100207,5.207162093920786,5.170820360300971,5.630359193340677,5.248864877419393,517636.1393442623,0,E01004236,8,0,9,0,0,1,5.123369576469544,5.424534502529329,5.3717054426670074,5.2384412211756555,5.128903650468396,5.689716137224628,5.3136529287984295,660813.2983870967,0,8,1,9,0,0,1,1.0,0,0,1,0,0,0,0
4131,5.060297667980194,5.496221640530755,5.321740409907172,5.343065878924201,5.269686909282909,5.485547644250533,5.1540619660826295,517507.20588235295,0,E01004237,8,1,9,1,0,0,5.151425949164799,5.377407942499433,5.406047446387155,5.241188310441517,5.30242257458823,5.662964701652527,5.473183665956769,660627.119047619,0,7,1,9,3,0,3,1.0,0,-1,0,0,2,0,3
4132,4.758575201576407,5.680946339260448,5.003535289656032,5.487462017211047,4.962714830311862,5.3337470320138065,4.97738764015111,515709.88636363635,0,E01004238,9,0,9,0,0,0,4.928190394242605,5.416832289596399,5.2175205027063685,5.424983114997546,5.031101582944393,5.506836849947771,5.188931372265021,658278.5875,0,8,0,9,0,0,0,1.0,0,-1,0,0,0,0,0
4133,5.2312193563643925,5.443816229383996,5.435856788716418,5.167920435996765,5.2594854844377394,5.760338874573403,5.229486111630785,515582.60638297873,0,E01004239,7,2,9,0,1,1,5.190590206939395,5.243740446496718,5.507859902806802,5.200087390323676,5.261621724260916,5.747870444071175,5.371476193465809,658007.9900990099,1,5,3,9,2,1,1,1.0,1,-2,1,0,2,0,0
4134,5.582382810359099,5.100805698608865,5.777247088296073,4.890672318789424,5.5005772162456905,5.938783669958309,5.4246538463903935,523396.2244897959,4,E01004240,2,7,5,5,4,3,5.279839745434848,5.202120360461149,5.550846203890714,5.1214374130422415,5.204647506367077,5.845130469582298,5.272605685754256,679841.1090909091,1,4,4,8,1,2,0,1.0,-3,2,-3,3,-4,-2,-3
4135,5.38464723808178,5.293681346851846,5.478346361630205,5.05150017876556,5.379189520642377,5.730010937953341,5.2541158423907515,581108.7826086957,2,E01004241,5,2,7,2,1,1,5.207570329690591,5.251455345214942,5.307615750875229,5.201609478547023,5.248630725420439,5.756144341750023,5.299953670073778,749280.358974359,1,5,0,9,2,1,0,1.0,-1,0,-2,2,0,0,-1
4136,4.9869031062492954,5.393151318109952,5.3538707082088175,5.33451895897205,5.159448375151707,5.540473422637352,5.091686985125908,516597.3461538461,0,E01004242,7,1,9,0,0,0,5.055630131643646,5.269460695130484,5.501294828596569,5.292236487881667,5.222457858980919,5.644041263327306,5.221245402381534,664036.9387755102,0,6,3,9,1,0,0,1.0,0,-1,2,0,1,0,0
4137,5.090562762557596,5.4541906507118885,5.378839114437932,5.188888859057772,5.219234660915706,5.682300659193509,5.186878994755123,514249.2463768116,0,E01004243,8,1,9,0,0,0,5.154699789716842,5.381279455854537,5.417997999394194,5.249416766437233,5.247056603431702,5.651283368996695,5.211158306040662,656095.8510638297,0,8,1,9,2,0,0,1.0,0,0,0,0,2,0,0
4138,5.176458100634297,5.39961294865045,5.481068451573529,5.20720048495165,5.247443105292133,5.650344957516888,5.1989231710358865,512497.6220472441,0,E01004244,7,2,9,0,0,0,5.176443337310444,5.294313858855855,5.478886274857954,5.233103832331571,5.19120224497535,5.707545011693781,5.254577791690826,655988.7909090909,0,6,2,9,1,0,0,1.0,0,-1,0,0,1,0,0
4139,4.9668191198318725,5.5335124503998525,5.238235157633585,5.350738829090481,5.043549677682301,5.532835029420399,5.051238226512122,514223.5,0,E01004245,9,0,9,0,0,0,5.113468202826095,5.390650819425714,5.328407358633329,5.257199061243502,5.124715164916156,5.618232678060663,5.242657725125143,656088.3150684931,0,8,1,9,0,0,0,1.0,0,-1,1,0,0,0,0
4140,5.097851381108567,5.540632316389599,5.344180314927487,5.240610801690334,5.198675406945719,5.539462642089741,5.104782830219011,513807.24324324325,0,E01004246,9,1,9,0,0,0,5.079732240020455,5.370911211162419,5.439975415731405,5.214688429584751,5.208323897479416,5.661349250124647,5.292136693929697,655564.512987013,0,7,2,9,1,0,0,1.0,0,-2,1,0,1,0,0
4141,4.972935587446266,5.497277352297417,5.345236882985195,5.291155196795954,5.1480706339684605,5.562030284204216,5.15867184701367,514480.8971962617,0,E01004247,8,1,9,0,0,0,5.101111592991011,5.4223779035466055,5.481508751000677,5.21377075037786,5.144391956073897,5.726498708128929,5.264973795839718,656369.5535714285,0,8,2,9,0,1,0,1.0,0,0,1,0,0,1,0
4142,5.076079435053125,5.516297382591045,5.240531467758449,5.365866751797431,5.187868683739046,5.582781209354907,5.152287938953501,513208.93805309734,0,E01004248,8,0,9,0,0,0,5.003930217077752,5.39911055064001,5.268941403437061,5.310590663877856,5.093932334114523,5.660533820881563,5.20583385780078,654729.6638655462,0,8,0,9,0,0,0,1.0,0,0,0,0,0,0,0
4143,5.100540702706141,5.548823451364277,5.182775360858993,5.250046349519136,5.2205157801015485,5.4920603060564455,5.083574232676171,513810.2913907285,0,E01004249,9,0,9,0,0,0,5.073432157730915,5.4972056185705425,5.196315637001624,5.268312495841077,5.15774034748416,5.510979212952789,5.138571890853566,655593.4674556213,0,9,0,9,0,0,0,1.0,0,0,0,0,0,0,0
4144,5.124497876109847,5.282237318624933,5.447728852191603,5.174011974449617,5.256197573190712,5.661480044744101,5.327387747994388,513791.4578313253,0,E01004250,5,2,9,0,0,1,5.111639510501515,5.312381172722036,5.472920363599604,5.219015514308756,5.254865993152965,5.666723935441538,5.238064127889547,655539.3863636364,0,6,2,9,2,0,0,1.0,0,1,0,0,2,0,-1
4145,5.506982160286165,5.123997045234895,5.669266549634262,4.947647521193598,5.501401417691943,5.978242605504855,5.48186701284328,728667.4788732395,3,E01004251,2,6,6,5,4,4,5.314287498757079,5.211579971261077,5.4990344519143575,5.048118318830218,5.320636932666485,5.731246618124155,5.27854291161338,925306.4505494506,2,5,3,6,3,1,0,1.0,-1,3,-3,0,-2,-3,-4
4146,5.12393751713114,5.230950198042283,5.544361289488066,5.178535704219013,5.258787271079667,5.687909401884866,5.376927375793457,648497.3119266055,0,E01004252,4,3,9,0,0,2,5.076310953155893,5.13450624610557,5.625027109364995,5.179803473050477,5.1850592464697165,5.716186116953365,5.494146821928806,833100.0983606557,0,3,5,8,1,0,3,1.0,0,-1,2,-1,1,0,1
4147,5.405030389626821,5.4560142137386185,5.453047694983305,5.031534633150807,5.41429360486843,5.815202129107934,5.353621700295696,543503.3703703703,2,E01004253,8,2,7,3,2,2,5.416792171934377,5.3807913064956665,5.4892747122308485,5.079389036220053,5.3813643621361775,5.805599645946337,5.325677874813909,705035.1652173913,3,8,2,7,5,2,1,1.0,1,0,0,0,2,0,-1
4148,5.12576085546591,5.272830987498708,5.411091554773985,5.083256564001097,5.2348619490644355,5.551103216888261,5.3267227567895485,728474.897810219,0,E01004254,5,1,8,0,0,1,5.1170579311324325,5.23692840555819,5.372760425980498,5.160166227236027,5.203747080593574,5.585823809228292,5.352447035109124,925074.2012195121,0,5,1,8,1,0,1,1.0,0,0,0,0,1,0,0
4149,5.4579922169969795,5.132452767146261,5.491158504235117,4.929015998254743,5.420562666759157,5.664393774250097,5.339988105129778,711875.7280701754,3,E01004255,3,3,5,3,0,2,5.382705956697464,5.075928410186487,5.5956142141538505,4.971153418807423,5.388467725585489,5.754915151525946,5.487562955302351,899575.8455882353,3,2,4,5,5,1,3,1.0,0,-1,1,0,2,1,1
4150,5.421262586116791,5.258175311982631,5.4811193406581875,5.063712081313133,5.487975706160069,5.8099311396479605,5.363146375119686,497181.9625,2,E01004256,4,2,8,5,2,2,5.372474485828031,5.206310632728761,5.582147698248586,5.040171968360101,5.352430700294433,5.806781513075674,5.367776789011494,638295.1290322581,2,4,4,6,4,2,1,1.0,0,0,2,-2,-1,0,-1
4151,5.42807220088111,5.12363831938049,5.6537465401637705,4.999296469452941,5.498813289183158,5.748199839650849,5.5830409673996915,496999.0740740741,2,E01004257,2,5,7,5,1,5,5.408533757665883,5.025744533538818,5.632789628402047,5.0482464976932695,5.450888042864592,5.808261863045071,5.503964818042258,635335.3478260869,3,2,5,6,6,2,3,1.0,1,0,0,-1,1,1,-2
4152,5.1762297718952865,5.472837003377768,5.300058447397673,5.026759806351784,5.213950189260336,5.426679712075454,5.282880897705372,676341.3717948718,0,E01004258,8,0,7,0,0,1,5.270832492546602,5.141463080590421,5.384686150334098,5.052587816661054,5.159549354152246,5.716899877244776,5.585798254067248,856043.1704545454,1,3,1,6,0,0,5,1.0,1,-5,1,-1,0,0,4
4153,5.504660468631321,5.0024716589185925,5.7543201658460825,4.867850481139289,5.4581728749805025,5.832773841751946,5.496146093474494,640153.6777777778,3,E01004259,1,7,4,4,2,4,5.37251761962067,4.958563925190405,5.722549239342863,4.90614491565661,5.406050549312071,5.805857636711814,5.431448722427541,811751.9886363636,2,1,7,3,5,2,2,1.0,-1,0,0,-1,1,0,-2
4154,5.060179065966952,5.308369906052299,5.64860763411591,5.152079416357952,5.2314445661461875,5.771430730819702,5.295428528301958,639912.1594202898,0,E01004260,5,5,9,0,1,1,5.0759029937417885,5.154590416895716,5.596104013292413,5.10645100631212,5.2550521367474605,5.70536346655143,5.282385548478679,811494.9736842106,0,4,4,7,2,0,0,1.0,0,-1,-1,-2,2,-1,-1
4155,5.199082024635807,5.227360871530348,5.617635434673678,5.018514975424735,5.27818464848303,5.881189096358515,5.317490506556727,639234.5,0,E01004261,4,5,7,1,3,1,5.368693027231428,5.079956102371216,5.677219030592177,4.986940524313185,5.418511327107748,5.885830518934462,5.60606798198488,810667.5,2,2,6,5,6,3,5,1.0,2,-2,1,-2,5,0,4
4156,5.314069253692299,5.166229637907298,5.5369109043235945,5.0362367844888585,5.310170479598475,5.821055799083137,5.34170243156826,639461.8111587983,1,E01004262,3,3,7,1,2,2,5.280467235600507,5.129967803425259,5.496691565160398,5.041481076346503,5.224136827610157,5.614508169668692,5.233064262955277,810944.1185185185,1,3,3,6,1,0,0,1.0,0,0,0,-1,0,-2,-2
4157,5.419156103077049,4.988241574007594,5.818369708375303,4.884754118091332,5.295790659453341,5.907282686519052,5.483099687599136,639641.5928143712,2,E01004263,1,7,5,1,3,4,5.445412086636833,5.044000083141112,5.81140051263102,4.921270961172126,5.434995498550072,5.877154915520315,5.42293521661437,811168.213483146,3,2,8,4,6,3,2,1.0,1,1,1,-1,5,0,-2
4158,5.304759295170124,5.458278472606953,5.4394443658682015,5.024633664351243,5.3913334222940295,5.736181611281175,5.137554539166964,639193.3846153846,1,E01004264,8,2,7,3,1,0,5.4608448333427555,5.319281601514972,5.577523634081981,4.977412243358424,5.480236671010002,5.939640482918161,5.4371780332971795,810544.0327868853,4,6,4,5,7,4,2,1.0,3,-2,2,-2,4,3,2
4159,5.4039094636314795,5.091035171558983,5.720085630918804,4.917044821538423,5.454729567076031,5.908320672888505,5.485353671877008,639969.5894736842,2,E01004266,2,6,5,4,3,4,5.300064015388489,5.041558825969696,5.718910791873932,4.934106229543686,5.418451316356659,5.8067219042778015,5.400485687255859,811579.45,1,2,7,4,6,2,2,1.0,-1,0,1,-1,2,-1,-2
4160,5.300751596948375,5.242986010468525,5.527448227094568,5.1123559112134185,5.323534970698149,5.670686592226443,5.31804797442063,583382.2086956522,1,E01004267,4,3,8,1,0,1,5.1218611523996,5.141231487779057,5.516625463572982,5.131504145323062,5.170668575498793,5.640504535506754,5.351485154208015,751471.3921568628,0,3,3,8,0,0,1,1.0,-1,-1,0,0,-1,0,0
4161,5.023297691345215,5.323934745788574,5.3032463947931925,5.45657377243042,5.148375185330709,5.403410689036051,4.926579900582632,637917.0666666667,0,E01004268,6,0,9,0,0,0,5.1336801551109135,5.25521239014559,5.519170927446942,5.134835817093073,5.350761729617451,5.803048488705657,5.347339275271394,809043.1162790698,0,5,3,8,4,1,1,1.0,0,-1,3,-1,4,1,1
4162,5.0862815101941425,5.3048717419306435,5.540821305910746,5.039595331086053,5.228561458322737,5.650351071357727,5.29219586054484,638581.7555555556,0,E01004269,5,3,7,0,0,1,5.200629425900323,5.157292540584292,5.655158385634422,5.197403535246849,5.357986771634647,5.741437518170902,5.261245292212282,809780.1517857143,1,4,5,9,4,1,0,1.0,1,-1,2,2,4,1,-1
4163,5.316288404423615,5.15436292825074,5.6684758159621005,4.995634571231645,5.37124939108717,5.815353619641271,5.3991909530656095,640956.8793103448,1,E01004270,3,5,6,2,2,2,5.264043713609378,5.094072182145384,5.612366173002455,5.096720406578647,5.289106528792116,5.73586764269405,5.4079682777325315,812262.7708333334,1,3,5,7,2,1,2,1.0,0,0,0,1,0,-1,0
4164,5.196852202822522,5.326376813214,5.467960258809532,5.19081278108969,5.259204935736772,5.674341755669292,5.259193318646129,662450.0609756098,0,E01004271,6,2,9,0,0,1,5.1829771754447,5.204637826158759,5.561730398220963,5.1967702742373,5.2665235259559715,5.741571686241064,5.302080896463287,834064.6629213484,0,4,4,9,2,1,1,1.0,0,-2,2,0,2,1,0
4165,5.0993898923580465,5.237156453499427,5.517539831308218,5.157221511694101,5.244978486574613,5.698778117620028,5.286440819960374,711201.0615384616,0,E01004272,4,3,9,0,0,1,5.0663781210780146,5.276125437021255,5.587373444437981,5.1950796216726305,5.254195758700371,5.695610907673836,5.27317970842123,898390.3125,0,6,4,8,2,0,0,1.0,0,2,1,-1,2,0,-1
4166,5.324255576793184,5.380398476377446,5.485484480857849,5.1542242930290545,5.272044884397628,5.799342102192818,5.318757374235925,705405.8510638297,1,E01004273,7,3,9,1,1,1,5.235703171932534,5.259671505999892,5.523917541928487,5.174291234310359,5.1956667189728725,5.812653963696467,5.389462497136364,906457.904109589,1,5,3,8,1,2,1,1.0,0,-2,0,-1,0,1,0
4167,5.440625464761412,5.369647894586835,5.54579250843494,5.084693403987141,5.42501357623509,5.828997655348345,5.358197627129493,278889.06493506493,2,E01004274,6,4,8,3,2,2,5.343196739869959,5.335682153701782,5.538612329258639,5.0788783059400675,5.317502856254578,5.773561253267176,5.482878102975733,358731.56470588234,2,7,3,7,3,1,3,1.0,0,1,-1,-1,0,-1,1
4168,5.4800499787136,5.192586043659522,5.651103044042782,4.943568617713694,5.449585622670699,5.943307966602092,5.510610908878093,279027.6836734694,3,E01004275,3,5,6,4,4,4,5.39606657005706,5.150168719156733,5.626694614032529,5.033486678915204,5.380217752366696,5.881928423665604,5.406432808570142,358957.0188679245,3,4,5,6,4,3,2,1.0,0,1,0,0,0,-1,-2
4169,5.42064686985903,5.29444093205208,5.472525336021601,5.061925377956657,5.55110935277717,5.811446187108062,5.611617881198262,279246.37209302327,2,E01004276,5,2,8,6,2,6,5.452950692602566,5.179071747830936,5.560133278369904,5.046974529113088,5.476861889873232,5.900242941720145,5.611911328775542,359231.91071428574,3,4,4,6,7,3,5,1.0,1,-1,2,-2,1,1,-1
4170,4.849057964164845,5.523011626118291,5.04215398670113,5.466227498367755,4.929026847338155,5.2576266187820995,5.175905110192125,563970.6350364963,0,E01004277,8,0,9,0,0,0,4.742680307378106,5.450848189904728,5.058338797028689,5.488416875747436,4.86371446165809,5.3388840935447,5.289263978361446,721961.4010695188,0,8,0,9,0,0,0,1.0,0,0,0,0,0,0,0
4171,5.307750362745473,5.30660651099514,5.515963230334537,5.091844568789845,5.354184540224747,5.741149862047652,5.342179808818119,550160.2676056338,1,E01004280,5,3,8,2,1,2,5.274716143097196,5.207440198886962,5.5527176558971405,5.083800429389591,5.2999076048533125,5.7768270671367645,5.4528571012474245,712718.2380952381,1,5,4,7,3,1,2,1.0,0,0,1,-1,1,0,0
4172,5.991767753873552,5.441707924434117,5.4968135561261855,4.695079827308655,5.629565756661552,5.96196186201913,5.530320497921535,279022.6,8,E01004281,7,3,1,8,4,5,5.809918238761577,5.3281673142250545,5.431239924532302,4.8021096143316715,5.443961876503964,5.862798563977505,5.47376772444299,358845.89361702127,8,7,2,1,6,2,3,1.0,0,0,-1,0,-2,-2,-2
4173,5.640327117084402,5.205672372758916,5.6166798857461036,4.931087430599517,5.580286281298747,5.94057609444171,5.490727897238942,696950.7964601769,5,E01004283,4,5,5,7,4,4,5.677160450390407,5.22006750507515,5.621147509382553,4.8774667397266676,5.557815855290709,5.933842849330742,5.539714171105072,883856.974789916,6,5,5,3,8,4,4,1.0,1,1,0,-2,1,0,0
4174,5.339330727659811,5.270847486698721,5.523011254513357,5.009000527577137,5.385161244024442,5.746591661858746,5.320951995887156,678136.7322834645,1,E01004284,5,3,7,2,1,1,5.293294064606292,5.203995411909079,5.593560116200507,5.1177342088916635,5.370107106015652,5.795146727863746,5.315961843804468,859459.4556962026,1,4,4,7,4,1,1,1.0,0,-1,1,0,2,0,0
4175,5.166255801532402,5.3214345868564985,5.545935426147199,5.062856333450187,5.329815471632798,5.761106503367936,5.383754483619985,728989.9871244635,0,E01004285,6,4,8,1,1,2,5.064898618496954,5.020027299411595,5.554761537350714,5.20678189676255,5.229920689947903,5.683403493836522,5.445924420841038,925753.046875,0,2,4,9,1,0,2,1.0,0,-4,0,1,0,-1,0
4176,5.16256757196552,5.184059730546917,5.533955275655507,5.151149293619715,5.289755914025678,5.60297144958359,5.368486479370894,728931.2934131736,0,E01004286,3,3,9,1,0,2,5.161218211593398,5.1383955370948975,5.54843662733055,5.1838702265038545,5.223344037331731,5.586733905665846,5.345226186585713,925667.9759036144,0,3,3,8,1,0,1,1.0,0,0,0,-1,0,0,-1
4177,5.327514510684543,5.280088347858853,5.644235510296292,5.051431997617086,5.306752853923374,5.779201518164741,5.485526344511244,729653.2444444444,1,E01004287,5,5,7,1,1,4,5.140952791856683,5.305106489554696,5.538848374200904,5.192122804081959,5.153877551140993,5.709490776062012,5.446770421836687,926550.195652174,0,6,3,8,0,0,2,1.0,-1,1,-2,1,-1,-1,-2
4178,5.219130135562322,5.261375874689181,5.49508340717995,5.200388157204406,5.311459851591555,5.576429781848437,5.251102289108381,729247.3698630137,0,E01004288,5,3,9,1,0,1,5.183087743561844,5.2101281799119095,5.519337560938693,5.147824218903465,5.169231621698401,5.7018518886346925,5.407586059351077,926050.264367816,0,5,3,8,0,0,2,1.0,0,0,0,-1,-1,0,1
4179,5.204773064582579,5.235928566225113,5.601794651759568,5.046585386799228,5.294343374108755,5.772377078251172,5.310556784752877,729406.6559139785,0,E01004289,4,4,7,1,1,1,5.206064560978683,5.159079400534482,5.561770581707512,5.170558491932977,5.147900887371338,5.709921981870513,5.37686014175415,926275.5979381443,1,4,4,8,0,0,1,1.0,1,0,0,1,-1,-1,0
4180,5.305427463615642,5.288528624702902,5.467277537373936,5.019599683144513,5.458366043427411,5.7824108705801125,5.4332086689331955,639738.9411764706,1,E01004290,5,2,7,4,1,3,5.360746393300066,5.040517363885437,5.706524345609877,4.92099860099831,5.303409012881192,5.867598393950799,5.503582229517927,811364.404040404,2,2,6,4,3,3,3,1.0,1,-3,4,-3,-1,2,0
4181,5.560549977663401,4.964500802057284,5.665447649655041,4.824311683843802,5.652298156205599,5.783266181344384,5.558540859737912,613599.4504504504,4,E01004291,1,5,3,8,1,5,5.511888535499573,4.9715507678985595,5.6125443067550655,4.922188714981079,5.52201191329956,5.7423671569824215,5.515803497314453,778684.088,4,1,5,4,8,1,4,1.0,0,0,0,1,0,0,-1
4182,5.716662864186871,5.213375372673148,5.5733302422423865,4.846656815329594,5.51711036909872,5.95353800147327,5.56493561481362,615487.0597014925,6,E01004292,4,4,4,5,4,5,5.569577284481214,5.145824454832768,5.52207392886065,5.002989573755126,5.5272272635197295,5.874457459518875,5.552557309468587,780711.231884058,5,4,3,5,8,3,4,1.0,-1,0,-1,1,3,-1,-1
4183,5.335070836410094,5.190536427363921,5.512882420855962,5.045730586802022,5.357695214534074,5.706144819098912,5.454374158650301,387794.87078651687,1,E01004293,3,3,7,2,0,3,5.3141172004468515,5.128964657133276,5.525343815485637,5.127527602393218,5.231989333725939,5.713482761623884,5.433900749442553,489651.83838383836,2,3,3,8,1,0,2,1.0,1,0,0,1,-1,0,-1
4184,5.184238708625405,5.164545228252303,5.540949721120845,5.16420354075351,5.400464190601629,5.642683766656003,5.36143405693399,592574.5084745763,0,E01004294,3,3,9,3,0,2,5.188759259838876,5.045988127833507,5.560200052183182,5.106718004075556,5.3812253664100105,5.648003212089747,5.4600492227272905,759610.0765027322,0,2,4,7,5,0,3,1.0,0,-1,1,-2,2,0,1
4185,5.056374770099834,5.273354184829582,5.437848426527896,5.123925970772565,5.391826888262215,5.555498680825961,5.235995193659249,728277.7457627119,0,E01004295,5,2,8,3,0,1,5.189457660540938,5.171774134039879,5.494844689965248,4.983984149992466,5.527128051966429,5.65730082988739,5.369383830577135,922555.265625,0,4,3,5,8,0,1,1.0,0,-1,1,-3,5,0,0
4186,5.33449934720993,5.286116190254688,5.3454396545886995,5.0822081714868546,5.359754808247089,5.609126187860966,5.346559451520443,613263.475,1,E01004296,5,1,8,2,0,2,5.251477326832566,5.274518727087507,5.3871129201907735,5.16904396870557,5.343569090553358,5.605734313235564,5.38236890002793,793990.9705882353,1,6,1,8,4,0,1,1.0,0,1,0,0,2,0,-1
4187,5.455776620220829,5.0125499669607585,5.62530753519628,4.958995422759614,5.510371301081274,5.678818142259276,5.4605790500517015,616208.935064935,3,E01004297,1,5,6,5,0,3,5.300046595774199,5.131715436985618,5.568171619114123,5.0623327242700675,5.374560323514436,5.6552651104174165,5.5159839881093875,793496.3052631579,1,3,4,7,4,0,4,1.0,-2,2,-1,1,-1,0,1
4188,5.165978819131851,5.229453680606989,5.45771568784347,5.184458659245418,5.191284764271516,5.60442163852545,5.302226648880885,729751.0769230769,0,E01004298,4,2,9,0,0,1,5.15416157245636,5.1550843242941236,5.544239932093127,5.2240443661295135,5.235487177454192,5.633915816915446,5.32773325772121,926715.775862069,0,4,3,9,1,0,1,1.0,0,0,1,0,1,0,0
4189,5.33156505936668,5.340816747574579,5.636711472556705,5.223952032270885,5.368201548144931,5.706770437104361,5.302603471846807,725680.7619047619,1,E01004300,6,5,9,2,0,1,5.2384635891233176,5.214592530613854,5.497459896973202,5.054066093195052,5.352004125004723,5.666133003575461,5.315685536180224,924982.4523809524,1,5,3,6,4,0,1,1.0,0,-1,-2,-3,2,0,0
4190,5.164732167165574,5.169559617565103,5.586626578683722,5.088867830903562,5.367416192407477,5.648221603811604,5.364712888247346,726991.8767123288,0,E01004301,3,4,8,2,0,2,5.195591411420277,4.992880397609302,5.741850818906512,4.984198223267283,5.413948174033846,5.641839163643973,5.309189270649638,922672.1071428572,1,1,7,5,5,0,1,1.0,1,-2,3,-3,3,0,-1
4191,5.1208766251802444,5.1285441517829895,5.641222173968951,5.141558441023032,5.354990467429161,5.7364300936460495,5.248796579738458,729092.2291666666,0,E01004302,2,5,9,2,1,1,5.139270848887307,5.088024927888598,5.641618497031075,5.080491409982954,5.362521924291339,5.647684703554426,5.291067320959908,925624.2285714286,0,3,5,7,4,0,0,1.0,0,1,0,-2,2,-1,-1
4192,5.116894468394193,5.3369421323140465,5.283105507041469,5.178317606810367,5.261875792705651,5.494237438115206,5.161526706724456,697967.6545454545,0,E01004303,6,0,9,1,0,0,5.152988747410152,5.312460586428642,5.362680269972138,5.198646426200867,5.274256149063939,5.562733979328819,5.285456595213517,894219.5815217391,0,6,1,9,2,0,0,1.0,0,0,1,0,1,0,0
4193,5.004007361437145,5.109270230719917,5.509174127327769,5.106703011613143,5.319310442397469,5.588382184505463,5.133657689157285,729793.8157894737,0,E01004304,2,3,8,1,0,0,5.09997213434899,5.099997329985959,5.645838031823608,5.1000537625674545,5.359880277480202,5.61012601852417,5.266825852722957,926838.2988505748,0,3,5,7,4,0,0,1.0,0,1,2,-1,3,0,0
4194,5.225203939106153,5.140293184829795,5.585772397725479,5.031726476938828,5.2713464641052745,5.692739753619485,5.334240956150967,729381.4673913043,0,E01004305,3,4,7,1,0,1,5.108084216885183,5.115426053946045,5.506987056512942,5.080603122711182,5.223995071718062,5.668848051421944,5.331948637962341,926249.0229885058,0,3,3,7,1,0,1,1.0,0,0,-1,0,0,0,0
4195,5.237579801747965,4.919451199298681,5.7115751421728795,4.9474707328996,5.5458984070046,5.693499070267345,5.302702257799548,531175.3372093023,0,E01004306,0,6,6,6,0,1,5.236079166332881,4.939025322596232,5.764096878965696,4.984829991062482,5.5117867906888325,5.672168747584025,5.3655620833237965,726771.7333333333,1,1,7,5,8,0,1,1.0,1,1,1,-1,2,0,0
4196,5.160157826882374,4.821098120152196,5.755285181576693,5.072545335262636,5.542371436010433,5.663936525206022,5.439050951336004,46172.03164556962,0,E01004307,0,7,8,6,0,3,5.2993462673214635,4.745076706534938,5.891374658739738,4.911661480602465,5.503953608029197,5.694673060230091,5.518079106317183,52966.612440191384,1,0,8,3,8,0,4,1.0,1,0,1,-5,2,0,1
4197,5.37744448368366,5.170623511534471,5.55251920406635,4.895266012045053,5.534067707795363,5.688706313646756,5.379785941197322,653289.6307692308,2,E01004308,3,4,5,6,0,2,5.346721099770588,5.174263340839441,5.592800558477208,4.927652232888816,5.412729007610376,5.707248421682828,5.382338548052138,826551.9420289855,2,4,4,4,5,0,1,1.0,0,1,0,-1,-1,0,-1
4198,5.270948840626355,4.926078563106471,5.757869921881577,4.9868787927874205,5.403081559929355,5.764553766826103,5.392820627524935,658984.3189655172,1,E01004309,0,7,6,3,1,2,5.251222950570724,4.933098035700181,5.820924594121821,5.011846730814261,5.347623599802747,5.740711128010469,5.595736291478662,836175.7205882353,1,1,8,6,4,1,5,1.0,0,1,1,0,1,0,3
4199,5.201028793652853,4.933020604451498,5.7517871602376305,4.860127983093261,5.500628916422526,5.68016005674998,5.255566411018371,59936.84,0,E01004310,0,7,4,5,0,1,5.158057115191505,4.756772903033665,5.799737464813959,4.968665404546829,5.476743040766035,5.6636323043278285,5.44336820557004,54990.45714285714,0,0,8,5,7,0,2,1.0,0,0,1,1,2,0,1
4200,5.577451864878337,5.061212646166483,5.755379215876261,4.874550919532776,5.556714855829875,5.840199208259582,5.487952864964803,633017.7866666666,4,E01004311,2,7,4,6,2,4,5.497206371950816,4.993675247732416,5.800707458013512,4.87299803366144,5.5999160818306795,5.859760577420154,5.486752057650003,796047.3855421686,4,1,8,3,9,2,3,1.0,0,-1,1,-1,3,0,-1
4201,5.7475253740946455,5.027267780059423,5.69974195651519,4.778953992403471,5.640168792162186,5.971927263797858,5.727410285900801,646956.0512820513,6,E01004312,1,6,2,8,4,8,5.28092147263003,5.176371020330509,5.5849969857175585,4.952194673914305,5.532694594960817,5.813377612073657,5.40638452852276,820253.8732394367,1,4,4,4,8,2,2,1.0,-5,3,-2,2,0,-2,-6
4202,5.3368356522825575,5.084496758647801,5.6713928893669365,5.057493147161818,5.411832229378297,5.792144861417947,5.44609564972907,643965.030927835,1,E01004313,2,6,8,3,1,3,5.311236117748504,4.9868742417781915,5.634083725036459,4.9873960576158884,5.440783736553598,5.798469315183923,5.390891856335579,816337.659574468,2,1,5,5,6,1,2,1.0,1,-1,-1,-3,3,0,-1
4203,5.403974859664838,4.988239840914805,5.654137464861075,4.916320203493039,5.401139295349519,5.6793250143527985,5.362841362754504,646849.5208333334,2,E01004314,1,5,5,3,0,2,5.346720402147255,4.994772476308486,5.6805733956542666,4.965122691556519,5.415458489866817,5.692000821524975,5.378821510894626,820128.2450980392,2,1,6,5,5,0,1,1.0,0,0,1,0,2,0,-1
4204,5.54259814780492,5.089441006000225,5.710781656778776,4.916845999084986,5.553966189806278,5.83726441860199,5.433284663237059,647350.0288461539,4,E01004315,2,6,5,6,2,3,5.478780632433684,5.027945777644282,5.730674279254416,4.873845581386401,5.5592206332994545,5.743802079947098,5.4287138866341635,820814.1217391305,4,2,7,3,8,1,2,1.0,0,0,1,-2,2,-1,-1
4205,5.451591522265703,4.934666752815247,5.771514281248435,4.787025965177095,5.610631698217148,5.731944108620668,5.677289198606442,647741.717948718,3,E01004316,0,7,3,8,1,7,5.5808366678528865,4.89903237051883,5.896613636259305,4.834516333321393,5.605200743271133,5.720930838988999,5.548677294941272,821279.3389830509,5,0,8,2,9,1,4,1.0,2,0,1,-1,1,0,-3
4206,5.131396890909244,5.194085266039922,5.455216636413183,5.069823306034773,5.378112841875125,5.551457930833865,5.20877434962835,606703.0256410256,0,E01004317,3,2,8,2,0,0,5.13888507993133,4.983981747538955,5.686137952627959,5.063445944697769,5.413628782166375,5.633631699615055,5.343538408809238,753005.837037037,0,1,6,7,5,0,1,1.0,0,-2,4,-1,3,0,1
4207,5.457437379360199,5.199507141113282,5.619562687873841,4.971294620037079,5.498725547790527,5.737023272514343,5.445705704689026,647129.42,3,E01004318,3,5,6,5,1,3,5.3124853996130135,5.0043858711536116,5.578306526404161,5.019364564235394,5.31265082175915,5.682431243016169,5.34405886209928,820481.2153846154,2,1,4,6,3,0,1,1.0,-1,-2,-1,0,-2,-1,-2
4208,5.232854112456827,5.18986259208006,5.583298347978031,5.135693649684682,5.3013872931985295,5.675771143857171,5.343019664988798,730035.4352941177,0,E01004319,3,4,8,1,0,2,5.1711801108048885,5.135750299813796,5.661042867874612,5.144872300478877,5.402257021592588,5.674983006350848,5.338363974678273,927123.7551020408,0,3,6,8,5,0,1,1.0,0,0,2,0,4,0,-1
4209,5.035765661383575,4.976795237019377,5.866952248339383,5.046335683678681,5.303179486742559,5.652077186782405,5.344183141330503,730217.6603773584,0,E01004321,1,8,7,1,0,2,5.08337269650131,4.946715479991475,5.794890786780686,5.059157318756228,5.274712670044821,5.653101078799514,5.399844924934575,927314.7049180327,0,1,8,6,2,0,2,1.0,0,0,0,-1,1,0,0
4210,5.049747409139361,5.166755315235683,5.572513498578753,5.185660711924235,5.249314849717276,5.566204125540597,5.260382324173337,708739.7333333333,0,E01004322,3,4,9,0,0,1,5.051928303859852,5.078939182890786,5.617637910224773,5.186706874105665,5.260282761520809,5.617174247900645,5.356669797941491,901570.7870370371,0,2,5,8,2,0,1,1.0,0,-1,1,-1,2,0,0
4211,5.326312134295334,5.027094930778315,5.663246693434538,4.848561952143539,5.475056559951217,5.766973745675735,5.48751766151852,729846.5308641975,1,E01004323,1,5,4,4,1,4,5.41746912913376,5.001001362050517,5.767187590009711,4.843246039379848,5.492353988497444,5.810684812202882,5.58308415064651,926859.1123595505,3,1,7,2,7,2,5,1.0,2,0,2,-2,3,1,1
4212,5.4951933715857715,5.171160744685753,5.720855652117262,5.003376357695636,5.350490700964834,5.8632680902294085,5.49264734399085,710447.6470588235,3,E01004324,3,6,7,2,2,4,5.253261553123593,5.232846554368734,5.5495467856526375,5.118495289236307,5.293712243437767,5.778734605759382,5.435490606352687,899810.828125,1,5,4,7,2,1,2,1.0,-2,2,-2,0,0,-1,-2
4213,4.998668075626732,4.990944254092681,5.780439965745323,5.136271874109904,5.382682624026241,5.579434409100785,5.480940437724447,730385.358974359,0,E01004325,1,7,9,2,0,4,5.023307787047492,4.924753070760656,5.778452500590571,5.127897458606296,5.363267291916741,5.545161531589649,5.391102356380887,927545.8888888889,0,1,7,8,4,0,2,1.0,0,0,0,-1,2,0,-2
4214,5.131800729036331,5.19103814959526,5.683691248297691,5.087406820058822,5.337244933843612,5.669797891378403,5.359529833495617,729892.0625,0,E01004326,3,6,8,2,0,2,5.142797926420807,5.070673532383417,5.754625569107712,5.142943780909302,5.304065728700289,5.804132717911915,5.461449288552807,926896.0,0,2,7,8,3,1,3,1.0,0,-1,1,0,1,1,1
4215,5.426127614080906,5.217254477739334,5.652121755480766,5.012047055363655,5.409608201682568,5.868957854807377,5.415244297683239,510109.775,2,E01004327,4,5,7,3,2,3,5.333751738756552,5.187253147706218,5.452065999480499,5.184887648999006,5.297625133360939,5.736069475097218,5.341970984963165,651048.5862068966,2,4,2,8,3,1,1,1.0,0,0,-3,1,0,-1,-2
4216,5.534770662033999,5.109195882523501,5.786562577441886,4.829040869518563,5.395410059778778,6.046333233515422,5.438980670990767,510841.73148148146,4,E01004328,2,7,3,3,5,3,5.459586093017647,4.938772901758417,5.744188665269731,5.028162527728725,5.353203215040602,5.82684707856393,5.519422563346657,651889.1531531531,3,1,7,6,4,2,4,1.0,-1,-1,0,3,1,-3,1
4217,5.709229727782826,5.079222584714984,5.862501316731519,4.716931145970184,5.557974253550614,6.214813548739594,5.694493546344266,509588.198019802,6,E01004329,2,8,1,6,8,7,5.6234947311768835,4.975569428653892,5.785415356312323,4.861967223499893,5.345469556817221,6.004210708338186,5.681754536584976,650336.4587155964,6,1,7,2,4,5,7,1.0,0,-1,-1,1,-2,-3,0
4218,5.67883857732178,5.070840111342809,5.8560474559824955,4.739299811342711,5.516965039314762,6.158733044901202,5.60098091120361,510496.65591397847,5,E01004330,2,8,2,5,7,6,5.570214248195137,4.996485154653333,5.809341701035647,4.836918417940435,5.361776324891553,6.048650006658023,5.563418067607683,651537.0927835051,5,1,8,2,4,6,4,1.0,0,-1,0,0,-1,-1,-2
4219,5.43101383222116,5.166016826758513,5.715258778752507,4.867486238479614,5.382386907800898,6.031353087038608,5.391742566684345,503495.69369369367,2,E01004331,3,6,4,2,5,2,5.399198843183972,5.03653411978767,5.637190730231149,4.9630621069953555,5.220535182952881,5.896660309746152,5.458426062266032,643432.2571428572,3,2,5,5,1,3,3,1.0,1,-1,-1,1,-1,-2,1
4220,5.658905204461545,5.022011788523927,5.75945524050265,4.890496815953936,5.500177031877089,6.123278445127059,5.617828429961691,510799.52040816325,5,E01004332,1,7,5,5,7,6,5.40349080225434,5.1958494222525395,5.602351671517497,5.022821180748217,5.289044056275879,5.903229153517521,5.5577374552235455,651821.3838383838,3,4,4,6,2,3,4,1.0,-2,3,-3,1,-3,-4,-2
4221,5.478209208874476,4.985830573808579,5.767824229739961,4.9059683212212155,5.4120604537782215,6.015873730182648,5.407744128079641,510475.75,3,E01004333,1,7,5,3,5,3,5.433139338725951,5.023071731009135,5.770278104921666,5.007340409406802,5.406583748212674,5.941264632271557,5.4450578471509425,651483.7926829269,3,2,7,5,5,4,2,1.0,0,1,0,0,2,-1,-1
4222,5.292049531055533,5.28403400597365,5.544919113750043,5.038806084705436,5.365183550378551,5.759651010451109,5.177480685970058,510532.9456521739,1,E01004334,5,4,7,2,1,0,5.102243541513832,5.258278749521496,5.4762444241533,5.1470827165159205,5.213111386715787,5.6722668432494965,5.188572622039943,651523.3786407767,0,5,2,8,1,0,0,1.0,-1,0,-2,1,-1,-1,0
4223,5.171800400151147,5.231948341263665,5.587362321217855,4.92825460963779,5.268584783871969,5.774540487925211,5.343502944045596,511066.5888888889,0,E01004335,4,4,5,1,1,2,5.1507834803383306,5.135772707327357,5.576705307330725,5.190219012071502,5.197308791133593,5.750154866362518,5.246601038383988,652203.5188679246,0,3,4,8,1,1,0,1.0,0,-1,0,3,0,0,-2
4224,5.33353394714754,5.342378764899809,5.404885567835907,5.081377291857307,5.229926160022394,5.775750607696931,5.306689402060722,512177.44029850746,1,E01004336,6,1,8,0,1,1,5.272630985029813,5.300043655263966,5.375240133548605,5.216424035203868,5.133535658902136,5.747746291653863,5.283525021322842,653645.3172413793,1,6,1,9,0,1,0,1.0,0,0,0,1,0,0,-1
4225,5.5540219950019765,5.18217662058839,5.679583372326072,4.942696175444016,5.395409460461468,5.995432724646472,5.396946957351965,511540.8623853211,4,E01004337,3,6,6,3,4,2,5.311543154950235,5.2360329686426645,5.564975331811344,5.003467923285914,5.252184158446742,5.910374582982531,5.459219156527052,652687.6176470588,2,5,4,5,2,3,3,1.0,-2,2,-2,-1,-1,-1,1
4226,6.187075911498651,4.831440360080905,6.042008397055835,4.511912934663819,5.651968889120148,6.491575194568169,6.013828450586738,511647.68292682926,9,E01004338,0,9,0,8,9,9,5.970286331525663,4.821032797417989,5.990606924382652,4.696152288739274,5.389574354741631,6.318647591079154,5.916663761545972,652793.0487804879,9,0,9,0,5,9,9,1.0,0,0,0,0,-3,0,0
4227,5.595593312640249,5.182500116619063,5.68817804330661,4.760002792617421,5.362882199110808,6.061211006141003,5.403064493779783,511075.1728395062,4,E01004339,3,6,2,2,6,2,5.6989912584230495,5.000361295489522,5.838218201290477,4.765450805812687,5.251925061275433,6.063905006879336,5.457884079450137,652185.3116883116,6,1,8,1,2,6,3,1.0,2,-2,2,-1,0,0,1
4228,5.314807393401861,5.391106636822224,5.394094931334257,5.082848726212978,5.250781837850809,5.792680362612009,5.370283483713865,511554.9625,1,E01004340,7,1,8,0,1,2,5.3426888301605135,5.333226392908794,5.444064085076495,5.138351582899326,5.218798699175439,5.75091005098529,5.333871023684013,652674.8841463415,2,7,2,8,1,1,1,1.0,1,0,1,0,1,0,-1
4229,5.632487054855105,5.160820076389919,5.60402778784434,4.852412152858007,5.484397125622583,5.989216312529549,5.501388607517121,510996.45238095237,5,E01004341,3,4,4,5,4,4,5.540839981315727,5.123497680613869,5.647942568126478,4.922167181072378,5.365701990916317,5.922711843834784,5.451916561987167,652082.969924812,5,3,5,4,4,4,2,1.0,0,0,1,0,-1,0,-2
4230,5.639422687108085,5.218708986403958,5.703111843774782,4.811908529108803,5.4804369763239915,6.073725601170687,5.5007218674525316,604000.0738255034,5,E01004342,4,6,3,5,6,4,5.554621644318104,5.156497472690211,5.722885895106527,4.883351012236542,5.289845839970642,6.009143917096986,5.502413170205222,766891.5625,5,4,7,3,2,5,3,1.0,0,0,1,0,-3,-1,-1
4231,5.472083678728418,5.2941473465931566,5.534895844097379,5.026487274260461,5.308861235274544,6.017381358750259,5.385108434701268,603276.506329114,3,E01004343,5,3,7,1,5,2,5.371213901427485,5.2438833482803835,5.556954996047481,4.978315823308884,5.20778940262333,6.00379979225897,5.47678141209387,766061.5612903226,2,5,4,5,1,5,3,1.0,-1,0,1,-2,0,0,1
4232,5.365874005885835,5.530252796538333,5.267248597043626,5.1377733342191005,5.168733881382232,5.700451573412469,5.193718590634934,604269.8808510639,2,E01004344,9,0,9,0,0,0,5.227532664222033,5.362275106489926,5.323834535252353,5.240534557355359,5.079388713088271,5.753994322678434,5.30964185785285,767270.1838565023,1,7,0,9,0,1,1,1.0,-1,-2,0,0,0,1,1
4233,5.716865645904167,5.152209623187196,5.7513795810587265,4.926712772425483,5.5153328717923635,6.136156206037484,5.353978279758902,603501.225490196,6,E01004345,3,7,5,5,7,2,5.4922769724154,5.1688997091031545,5.687905641163097,4.887246225394454,5.259437264180651,6.124434730585883,5.562572251347935,766292.7352941176,4,4,6,3,2,7,4,1.0,-2,1,-1,-2,-3,0,2
4234,5.576000761616138,5.229186209597329,5.586014110912648,4.863979006922523,5.454304661861686,6.003759775974954,5.44923242580059,607594.1085271317,4,E01004346,4,4,4,4,5,3,5.368259523012867,5.334464000512476,5.471894558161905,5.057975564100971,5.221298310038161,5.876041012267544,5.401943630551639,771089.8287671233,2,7,2,6,1,3,2,1.0,-2,3,-2,2,-3,-2,-1
4235,5.85874105514364,5.001748903000609,5.936215372795754,4.6649013136295565,5.580174030141627,6.299439697823626,5.685251993067721,604634.8936170213,7,E01004347,1,9,1,7,9,7,5.610169633575108,4.98889914802883,5.904082052085711,4.747618289097495,5.360176330027373,6.2368015439614,5.631663924973944,767668.554347826,5,1,9,1,4,9,6,1.0,-2,0,0,0,-3,0,-1
4236,5.538041057410063,5.174377491739061,5.678775344071565,4.984250537554423,5.314060162614893,5.98554644672959,5.368138699178343,603564.4444444445,4,E01004348,3,6,6,1,4,2,5.379903060059215,5.165426283381706,5.570412784814835,5.017081106818,5.2132801884828615,5.914125373197156,5.40652337739634,766377.5,2,4,4,6,1,3,2,1.0,-2,1,-2,0,0,-1,0
4237,5.772915899468381,5.488796183367095,5.312719673060915,4.75813851116947,5.504603006052629,5.914919133391677,5.497808087385442,674422.971291866,6,E01004349,8,1,2,5,3,4,5.738005148995783,5.4176778768755725,5.347756906268523,4.866384428800996,5.3886581819082044,5.907770762738493,5.502660557781298,854772.3659793815,7,8,1,3,5,3,3,1.0,1,0,0,1,0,0,-1
4238,5.5753941859888,5.434532086486402,5.446080507791561,4.904242314722227,5.393217855173608,5.878689542412758,5.4010861198539315,601601.6630434783,4,E01004350,7,2,5,3,2,2,5.602773874183821,5.334614416289199,5.5620796354742,4.945461798235367,5.39486449533473,5.947995580610682,5.4866173019826086,764053.8633879782,5,7,4,4,5,4,3,1.0,1,0,2,-1,2,2,1
4239,5.854307032594777,5.3048277280547405,5.597780263183092,4.738837447431353,5.546108342180348,6.079477407715538,5.595272349588798,605973.7979797979,7,E01004351,5,4,2,6,6,6,5.670292484945584,5.226930550343014,5.6310680320225845,4.7902663347016965,5.452548914622766,5.96431683629288,5.585550455849406,772797.518134715,6,5,5,1,6,4,5,1.0,-1,0,1,-1,0,-2,-1
4240,5.89683053232509,5.366319961801788,5.426547972055582,4.7739174828021484,5.482075802320559,5.966335438412322,5.488167756760614,598601.4733727811,7,E01004352,6,2,2,5,4,4,5.929637637489286,5.334018367709535,5.427731442761112,4.796456874707045,5.50693602789016,5.991365183999528,5.402874243207824,760537.7272727273,9,7,2,1,8,5,2,1.0,2,1,0,-1,3,1,-2
4241,5.8598156133666635,5.430543362163007,5.441624954808503,4.79106232477352,5.534056447446346,6.01553201302886,5.649524491745979,597722.08984375,7,E01004353,7,2,3,6,5,7,5.896471501310209,5.288524288327301,5.587700063698136,4.755368993200105,5.575680273702775,6.096696162132468,5.626672024014352,759469.4061302682,8,6,4,1,9,7,6,1.0,1,-1,2,-2,3,2,-1
4242,5.620994108287912,5.202534076414611,5.615525387881095,4.845278789599736,5.424214360483906,6.0186804010157,5.5477772857013505,598426.6228070175,5,E01004354,3,5,4,3,5,5,5.682319401050436,5.094766911144914,5.862190246582031,4.794626630585769,5.483499457918365,6.13822816651443,5.670206484301337,760437.551724138,6,3,8,1,7,8,6,1.0,1,0,3,-3,4,3,1
4243,5.926605840374653,5.348633850427499,5.683772144461036,4.729737519321585,5.580282707859699,6.2153568626346445,5.785575859528735,600145.962406015,8,E01004355,6,6,2,7,8,8,5.788441515323398,5.20608223858376,5.688697676676357,4.768440968928284,5.621006379783375,6.250105154115471,5.800702373334467,762495.4200743494,7,4,6,1,9,9,8,1.0,-1,-2,0,-1,2,1,0
4244,5.796615092480769,5.402327267361469,5.487271721734375,4.818168359701751,5.540017336118416,6.068087540689062,5.50614318105041,605396.618852459,7,E01004356,7,3,3,6,6,4,5.825759639663081,5.2528230346018265,5.632152474695636,4.783452440173395,5.5452850653279215,6.101496729158586,5.673516112469858,768610.0080645161,8,5,5,1,8,7,6,1.0,1,-2,2,-2,2,1,2
4245,5.923245018508834,5.3530999797249805,5.565777720533652,4.737124291168252,5.639719349478707,6.1042915310351376,5.653743667045825,600158.7005076142,8,E01004357,6,4,2,8,6,7,5.85379921251805,5.260049304770465,5.611166182474874,4.776673410406064,5.604337501765496,6.1037355427765965,5.670425890079096,762401.2763819095,8,5,5,1,9,7,6,1.0,0,-1,1,-1,1,1,-1
4246,5.883550158513137,5.284796512204837,5.625639926374348,4.816982289544897,5.5909011067907795,6.104685448353587,5.647036416078705,599734.5620915033,7,E01004358,5,5,3,7,6,7,5.7868549613391655,5.225406744900872,5.77357033888499,4.818762648339365,5.600117166837056,6.1755559117186305,5.7940467747987485,762164.9901960784,7,5,7,2,9,8,8,1.0,0,0,2,-1,2,2,1
4247,5.778321974161194,5.204942747587111,5.635193158213685,4.820925778732067,5.510463098200356,6.150020673507598,5.6669363379478455,598899.268292683,6,E01004359,4,5,3,5,7,7,5.828022761778398,4.894018986008384,5.830495119094849,4.807408679615367,5.4338766661557285,6.371644887057218,5.691878600554033,761208.0,8,0,8,1,6,9,7,1.0,2,-4,3,-2,1,2,0
4248,5.776619074465353,5.349806829343868,5.69565768332421,4.752739726742612,5.630392211901991,6.205341210848169,5.788187461563304,599124.0443037974,6,E01004360,6,6,2,8,8,8,5.664482664088814,5.150208857594704,5.773661316657553,4.880158059451045,5.602230008767576,6.149601819563885,5.778801032475063,761376.2857142857,6,4,7,3,9,8,8,1.0,0,-2,1,1,1,0,0
4249,5.882793527383071,5.167327670656013,5.697331533629513,4.7139388569713345,5.598810121152528,6.206932611014011,5.706671752873257,606837.3727810651,7,E01004361,3,6,1,7,8,7,5.97260831996619,5.074076004775174,5.8014144725110155,4.729307470551456,5.641821591250868,6.293068746486342,5.775652820805469,770272.7891566266,9,2,8,0,9,9,8,1.0,2,-1,2,-1,2,1,1
4250,5.932195289801526,5.468258464208213,5.444561096288824,4.792059729817093,5.481309680528538,5.902943140716963,5.465477995975043,588401.1666666666,8,E01004362,8,2,3,5,3,4,5.68935494161957,5.4670503667337975,5.283295557273561,5.0122083016295935,5.29993088209807,5.8252546692369,5.458964230409309,749070.711442786,6,9,0,6,3,2,3,1.0,-2,1,-2,3,-2,-1,-1
4251,5.809860395249866,5.166463213307517,5.663500168777648,4.810920288449242,5.459998424847921,6.103585382870265,5.543271648883819,592263.4285714285,7,E01004363,3,5,3,4,6,5,5.6601864866247755,5.168712043426406,5.610311604441612,4.939087343887544,5.2972373626601525,6.045063243785375,5.6577818835845015,753609.234741784,6,4,5,4,2,6,6,1.0,-1,1,0,1,-2,0,1
4252,5.604050793395137,5.166216427916723,5.695065973610278,4.926066473619827,5.4250537496528874,6.060255061711697,5.5327540470274865,591591.2317880795,4,E01004364,3,6,5,3,6,5,5.224205145195349,5.21824408911947,5.545395379635825,5.148828028742947,5.197530926163517,5.930468570830217,5.498776676049873,751683.4179104478,1,5,3,8,1,4,3,1.0,-3,2,-3,3,-2,-2,-2
4253,5.546501186158922,5.001316462826525,5.797068758907481,4.893641216123206,5.41741755986825,6.001145870257647,5.451853913119716,588297.2393162394,4,E01004365,1,7,5,3,5,3,5.531541237644121,4.958646540548287,5.894460813671935,4.861311391288159,5.311365843987932,6.044329217835968,5.593799808446099,748716.8333333334,4,1,8,2,3,6,5,1.0,0,0,1,-3,0,1,2
4254,5.951223566912223,5.105263556259266,5.705697540499738,4.663626629949192,5.585649031947776,6.148875418492562,5.6241907520570615,588420.4782608695,8,E01004366,2,6,1,7,7,6,5.853240194802101,5.134093078283163,5.668861676867191,4.843109191610263,5.388795113334289,6.1017839175004225,5.640623889863491,748857.9182692308,8,3,6,2,5,7,6,1.0,0,1,0,1,-2,0,0
4255,5.834569620636274,4.951656428148162,5.918807825952206,4.746449335566107,5.515865729664856,6.228024395007007,5.637919806084543,588504.0660377359,7,E01004367,1,8,2,5,8,6,5.785104906783913,4.910670761792165,5.853743889421787,4.831760133212468,5.353345644923876,6.230954728036557,5.7124415816001175,748949.6603773584,7,1,8,2,4,9,7,1.0,0,0,0,0,-1,1,1
4256,5.808599980740712,5.108413704510393,5.764011664637204,4.80440370687123,5.5091023609556,6.108486233086421,5.527315993761194,587757.0948275862,7,E01004368,2,7,3,5,6,5,5.5857992152537195,5.107553382550389,5.526695082995517,5.006915271774797,5.348048611120745,5.958979538649567,5.3786958505299465,748112.0909090909,5,3,3,5,4,4,1,1.0,-2,1,-4,2,-1,-2,-4
4257,5.808059732119243,5.084450337621901,5.86581925286187,4.74569269683626,5.491292640897963,6.198043505350749,5.617819168832567,551714.8888888889,7,E01004369,2,8,2,5,8,6,5.606356078451807,5.051372272627694,5.851431733959323,4.937794930332309,5.335989595769526,6.051901366684463,5.6237370037770535,704633.6703296703,5,2,8,4,3,6,6,1.0,-2,0,0,2,-2,-2,0
4258,5.67555277781053,5.053991097753698,5.7991436611522325,4.736870949918574,5.46408776586706,6.133848309516907,5.584983320669695,573435.7727272727,5,E01004370,1,7,2,4,7,6,5.40615845317683,5.042479766301872,5.782927101308649,4.959039864461284,5.362582023478737,5.990444977421406,5.571258170545594,726859.4958677687,3,2,7,4,4,5,5,1.0,-2,1,0,2,0,-2,-1
4259,5.888352918213811,4.94572132928618,6.005619916422614,4.655142150048552,5.586216924519374,6.297494457713489,5.834419429302216,550099.4655172414,7,E01004371,1,9,1,7,9,9,5.847197535684553,4.938380054498123,5.90382499816054,4.73980626211328,5.422600390547413,6.170342542357364,5.745986719252699,697804.033898305,8,1,9,1,6,8,8,1.0,1,0,0,0,-1,-1,-1
4260,6.159993692142208,5.059287181714686,6.073042610796486,4.539829079697772,5.662456545887924,6.562478626646647,5.981320875446971,535050.8780487805,9,E01004372,2,9,0,8,9,9,5.978916133704939,4.85966851052485,6.055997230504689,4.667287321467149,5.482696530066039,6.208594786493402,5.8437808030530025,685230.9605263158,9,0,9,0,7,8,9,1.0,0,-2,0,0,-1,-1,0
4261,5.665773443553759,4.958077719246131,5.875435860260673,4.797617615133092,5.451206027597621,6.107972925987797,5.630297980446747,518229.47826086957,5,E01004373,1,8,3,4,6,6,5.762573212007933,4.935748148568069,5.908905267715454,4.779292215274859,5.448318744007545,6.082441115681129,5.616047515144831,661508.3164556962,7,1,9,1,6,7,5,1.0,2,0,1,-2,2,1,-1
4262,5.521763243875303,5.314435390325693,5.55947530352986,4.975588194140188,5.223508239626051,5.91450247064337,5.373357846186711,512619.74125874124,3,E01004374,5,4,6,0,3,2,5.5011748961500215,5.120341350097914,5.601987274917397,4.965075520244804,5.248841509625718,5.939608890462566,5.54750432275437,654066.0878378379,4,3,4,5,2,4,4,1.0,1,-2,0,-1,2,1,2
4263,5.727183953771052,5.016371179301784,5.876872107667743,4.703752629037173,5.516808707759066,6.196730741914713,5.497311238972646,517915.9811320755,6,E01004375,1,8,1,5,8,4,5.694222589161085,4.858295772386634,5.791496770278267,4.819468658903371,5.435208773612976,6.035665544219639,5.600612630014834,661166.2782608696,6,0,8,2,6,6,5,1.0,0,-1,0,1,1,-2,1
4264,5.686484630618777,5.102981681270259,5.643373606460435,4.81793267599174,5.399238783333983,6.042950176766941,5.5126440940158705,514092.125,5,E01004376,2,5,3,3,5,4,5.633950174865076,4.986027806492175,5.7007262423887095,4.837638880236674,5.378367691727008,6.022916373559984,5.5297771601353665,656174.4576271187,6,1,6,2,4,6,4,1.0,1,-1,1,-1,1,1,0
4265,5.706733251611392,5.504252808292707,5.19422195189529,4.935066026449204,5.281578663653797,5.768143316109975,5.274204549855656,602204.6333333333,5,E01004377,8,0,6,1,1,1,5.605727858635602,5.483833052835412,5.1790520782628775,5.061261811638405,5.137630564073173,5.746129251316766,5.273480877362562,764804.2872928177,5,9,0,7,0,1,0,1.0,0,1,0,1,-1,0,-1
4266,5.920900526078972,5.132230375264142,5.800485260583259,4.720742620326377,5.6120148011156035,6.312044957199612,5.629809822585131,602531.4864864865,8,E01004378,3,7,1,8,9,6,5.630665436893905,5.07949435386528,5.706122554078394,4.855534130213212,5.394366300024954,6.134257984810135,5.651159880112629,765163.7278911564,6,2,6,2,5,8,6,1.0,-2,-1,-1,1,-3,-1,0
4267,5.680564219156901,5.3406396261851,5.654664785861969,4.858981619675954,5.479660091400146,6.065150351524353,5.5277262457211815,602589.4066666666,5,E01004379,6,5,4,5,6,5,5.368642561363451,5.250575136415886,5.59389720252066,5.0202586289608115,5.2461474541461826,5.941932061946753,5.530082062518958,765316.2545454545,2,5,4,6,2,4,4,1.0,-3,-1,-1,2,-3,-2,-1
4268,6.033617549193533,5.2910825974062865,5.494957724370455,4.626730958411568,5.665305757522583,6.0962405794545225,5.631733850428932,601610.4578947368,8,E01004380,5,3,0,8,6,6,5.708499495642526,5.277459021977016,5.43863740171705,4.908331165994917,5.45326890536717,5.908452640260969,5.495353612218584,764118.5428571429,7,6,2,3,6,3,3,1.0,-1,1,-1,3,-2,-3,-3
4269,5.8125366915104,5.125460358553155,5.805504019177238,4.7227236884971,5.534325278775636,6.157687896905943,5.63547787416813,602707.3313953489,7,E01004381,2,7,1,6,7,6,5.678912353084748,4.992834257074149,5.74137372640242,4.845437561891165,5.307258954967361,6.084691597036569,5.633384158812373,765402.7771084338,6,1,7,2,3,7,6,1.0,-1,-1,0,1,-3,0,0
4270,5.572712855136141,5.268880731247841,5.514945545095078,4.917282197069614,5.342820038186743,5.869593295645206,5.34072700333088,603477.0319148937,4,E01004382,5,3,5,2,2,2,5.30106171911413,5.3429462259466,5.420136620781639,5.181932350722226,5.248358828371221,5.8203900185498325,5.313878282633695,766253.7454545455,2,7,1,8,2,2,1,1.0,-2,2,-2,3,0,0,-1
4271,5.722862204139152,5.248829952786478,5.604185950220301,4.851146093915018,5.451852793104194,6.098808977041352,5.565015934826283,602545.511235955,6,E01004383,4,4,4,4,6,5,5.472790054454925,5.255945916388445,5.484986348516622,4.990813523341137,5.28747593749101,5.988525574374351,5.607170379085905,765250.7898089172,4,5,2,5,2,5,5,1.0,-2,1,-2,1,-2,-1,0
4272,5.606184235681289,5.403863850363058,5.492225963357501,4.957650162597403,5.443288469766554,5.958919137010077,5.448179386803324,598506.0521327014,4,E01004384,7,3,6,4,4,3,5.358384261740015,5.403991344127249,5.467478270226336,5.103446678912386,5.350500999613011,5.833005227941148,5.222562835571614,759961.159574468,2,8,2,7,4,2,0,1.0,-2,1,-1,1,0,-2,-3
4273,5.993797075047213,5.367953170047087,5.487674387062297,4.742873243724598,5.613394609619589,5.992777727631962,5.559748547918656,600998.9411764706,8,E01004385,6,3,2,8,4,5,5.7193301523124775,5.342284870671702,5.36497849880994,4.914026415610051,5.403661510446569,5.964741592878823,5.522327875698005,763517.5494505494,7,7,1,3,5,4,4,1.0,-1,1,-2,1,-3,0,-1
4274,5.908753089574509,5.345761657793284,5.517996400981755,4.799968556408242,5.573052359865858,6.101885441577796,5.645409437485071,599841.1168831169,8,E01004386,6,3,3,7,6,6,5.872602652841144,5.234487722979652,5.544684557782279,4.808573961257935,5.550002519289652,6.098538562986586,5.629392631848654,762189.213888889,8,5,3,2,8,7,6,1.0,0,-1,0,-1,1,1,0
4275,5.829647004181612,5.326170073333362,5.652018482803453,4.822525420087449,5.514058053916227,6.161111951719785,5.630666048814219,601812.0992907801,7,E01004387,6,5,3,5,7,6,5.6188771417912315,5.178107814753757,5.652713770375533,4.880134973455878,5.386008148684221,6.116420125260072,5.568764850497246,764364.8970588235,5,4,5,3,5,7,4,1.0,-2,-2,0,0,0,0,-2
4276,6.125400184835278,5.057219417590015,5.879186040950271,4.578984823616795,5.7105846989829585,6.1886616997748805,5.680463702423768,602047.0754716981,9,E01004388,2,8,0,9,8,7,5.791615397115297,5.112007441399973,5.777066354510151,4.813019976585726,5.586254323585124,6.154386491715154,5.748316210282,764612.9430379746,7,3,7,2,9,8,8,1.0,-2,1,-1,2,0,0,1
4277,5.732472566420158,5.517879579783467,5.391431661299717,4.913530908494329,5.466033237951773,5.898439288629916,5.4983948881243485,597865.1934156378,6,E01004389,8,1,5,4,3,4,5.680704059833434,5.370539838511769,5.5776843094244235,4.862888096018535,5.478611012202937,5.968547825696992,5.550209176831129,759455.268292683,6,7,4,2,7,5,4,1.0,0,-1,3,-3,3,2,0
4278,5.90206425609412,5.430942574584925,5.396556461298907,4.807247856700862,5.49027855694294,5.998634002826832,5.66822465426392,597755.5555555555,8,E01004390,7,1,3,5,5,7,5.930983949947908,5.315096770407837,5.524545465590637,4.791235890002609,5.485744373646774,6.029595946300925,5.590275760330906,759350.12716763,9,6,3,1,7,6,5,1.0,1,-1,2,-2,2,1,-2
4279,5.684465272086007,5.173666058551698,5.615909355027335,4.885771192255474,5.372875948746999,6.012714688267026,5.5125474362146285,535186.8035714285,5,E01004391,3,5,5,2,5,4,5.47900003679963,5.160514010939488,5.538698975429979,4.994431542795758,5.219908649838248,5.952949361745701,5.511270640894424,683108.9418604651,4,4,3,5,1,4,3,1.0,-1,1,-2,0,-1,-1,-1
4280,5.541284592906434,5.127871363606285,5.674882695902532,4.951799310631489,5.445797374500102,5.883237594336122,5.378584764111581,592407.91959799,4,E01004392,2,6,6,4,3,2,5.43689182959497,5.146916249766946,5.614989757537842,4.955691609531641,5.312731957683961,5.871209356933832,5.429174887016416,753428.765625,3,4,5,4,3,3,2,1.0,-1,2,-1,-2,-1,0,0
4281,5.851164622184558,5.101883736431089,5.758522971063598,4.704363696595543,5.526683678993812,6.194696726962032,5.736212542933276,593709.4017094017,7,E01004393,2,7,1,6,8,8,5.611593159385349,5.0293151772540545,5.615138165847115,4.903255795395893,5.323112936641859,6.131769456034121,5.6240090898845505,755003.4347826086,5,2,5,3,3,8,6,1.0,-2,0,-2,2,-3,0,-2
4282,5.985908947207711,5.027931686152112,5.906785298477519,4.659026563167572,5.530364705757662,6.297818996689537,5.834272278980776,593277.1704545454,8,E01004394,1,8,1,6,9,9,5.80425183219139,4.9889569728061405,5.7582434524189345,4.881117398088628,5.347389144126815,6.204351225284615,5.807260731253961,754535.0505050505,8,1,7,3,4,8,8,1.0,0,0,-1,2,-2,-1,-1
4283,5.794185734401315,5.2300105822288385,5.560369788590124,4.943965326931517,5.469303906974146,6.162889121952704,5.35504090887005,543862.593220339,7,E01004395,4,4,6,4,7,2,5.561841951153142,5.175122120516087,5.549989318459984,4.937534937044469,5.2594955771919185,6.07612695732737,5.424059898872685,699059.6178861789,5,4,4,4,2,7,2,1.0,-2,0,0,-2,-2,0,0
4284,5.676312802329896,5.020364777436332,5.730335892192901,4.858313955957928,5.442054206416721,6.115199550749764,5.429516280454303,591639.880952381,5,E01004396,1,6,4,4,7,3,5.5238368416254495,4.995471134649969,5.709135424774305,4.870981940125997,5.327024037859081,6.071740496475084,5.476081695176859,752400.6194690266,4,1,6,3,3,7,3,1.0,-1,0,0,-1,-1,0,0
4285,5.455744560231867,5.142849632145203,5.635227050977884,4.929066224811003,5.396652998997993,5.9185204180245545,5.449603306263993,592298.9793814434,3,E01004397,3,5,5,3,3,3,5.31890570972905,5.132274953524272,5.545292940284266,5.069474625587463,5.2258823748790855,5.726976928566441,5.319148682825493,753369.0727272728,2,3,3,7,1,1,1,1.0,-1,0,-2,2,-2,-2,-2
4286,5.404596317963428,5.493266147303294,5.362290403210973,5.049214866506048,5.29909695702863,5.8717869218573515,5.343387173600943,585875.4578313254,2,E01004398,8,1,7,1,2,2,5.363134714402917,5.33114918634664,5.455161788859552,5.108256340869324,5.237965846651434,5.81691587771628,5.443883184830629,730848.9823321555,2,7,2,7,1,2,2,1.0,0,-1,1,0,0,0,0
4287,5.3428398440492915,5.595933953498272,5.131111270569741,5.0530789335991475,5.178513256793327,5.660751196932285,5.060232264564393,610746.7234042553,1,E01004399,9,0,7,0,0,0,5.255660514780544,5.53007954008439,5.10536062781186,5.225273199259916,5.087101910841019,5.654916450939076,5.187752688632292,775100.5026737968,1,9,0,9,0,0,0,1.0,0,0,0,2,0,0,0
4288,5.477581108134726,5.2606663133787075,5.584969091415405,4.879961906308713,5.370169015552687,5.955970055124034,5.345262127337248,610893.2695652174,3,E01004400,4,4,4,2,4,2,5.353401351393315,5.21756189643291,5.62590369634461,4.929572614661434,5.2572381914707655,5.913406254952414,5.438329378763835,775310.5438596491,2,5,5,4,2,3,2,1.0,-1,1,1,0,0,-1,0
4289,5.306974865750568,5.3641170757572825,5.4051484049820315,5.083854161820761,5.217889378710491,5.757849749123178,5.187883053174833,558672.1853658537,1,E01004401,6,1,8,0,1,0,5.245066112872817,5.28663831044242,5.43654468546363,5.142365258401601,5.129762134626898,5.7539444905925174,5.2730435108015055,710455.8795811519,1,6,2,8,0,1,0,1.0,0,0,1,0,0,0,0
4290,5.536483542863713,5.291582691577053,5.602647731470507,4.902900559033534,5.35044527053833,5.953396653020104,5.320584525433621,610708.1317829457,4,E01004402,5,4,5,2,4,1,5.297627949307108,5.133493222742,5.589161363422361,4.99116302249778,5.20122509328728,5.779436345793243,5.233495101969466,775120.452991453,1,3,4,5,1,1,0,1.0,-3,-2,0,0,-1,-3,-1
4291,5.311016166358568,5.54428357899931,5.334121545320724,5.118130415307041,5.215761354355396,5.784259395975295,5.258043177889591,609674.377593361,1,E01004403,9,1,8,0,1,1,5.143089562222578,5.491570520660152,5.257936978253765,5.247667343288228,5.02864305048749,5.734804028186245,5.263206856406254,773952.6376811594,0,9,0,9,0,1,0,1.0,-1,0,-1,1,0,0,-1
4292,5.340038362195936,5.401849140555171,5.459737591824289,4.99726839489856,5.260166506646043,5.831672231019554,5.311926506333432,610923.1525423729,1,E01004404,7,2,7,0,2,1,5.259403568187743,5.298835966423268,5.465186266498711,5.135067127133143,5.271560161168338,5.832406711942367,5.445921716799263,775371.5572519084,1,6,2,8,2,2,2,1.0,0,-1,0,1,2,0,1
4293,5.726204353220322,5.125496435165405,5.837229361253626,4.855383877193226,5.533620772642248,6.1163509943906,5.58653582685134,589673.8705882353,6,E01004405,2,8,4,6,7,6,5.515611787385579,5.054167421558235,5.690149409861505,4.951681292509731,5.339305074909065,6.058001243615452,5.562733995763561,750540.6708860759,4,2,6,4,3,6,4,1.0,-2,0,-2,0,-3,-1,-2
4294,5.654868257932426,5.0886902434766785,5.770547849087675,4.864522446285594,5.4492589521014,6.022583204852648,5.5441363232194885,590176.7107438017,5,E01004406,2,7,4,4,5,5,5.485385481637853,5.0926627694195465,5.61329308629946,5.069434170504563,5.316761166084814,5.918182060008741,5.437363090405937,750731.4732824428,4,3,5,7,3,4,2,1.0,-1,1,-2,3,-1,-1,-3
4295,5.879136329001569,5.26711298557038,5.732131088033635,4.742324432159992,5.548737590617322,6.100853983392107,5.672246699637555,593676.5957446808,7,E01004407,5,6,2,6,6,7,5.638643476852151,5.278623698755752,5.49938838149226,5.061021093712297,5.320116761118867,5.922743647597557,5.563380546348039,754140.8604651163,6,6,3,7,3,4,4,1.0,-1,1,-3,5,-3,-2,-3
4296,5.711384795807503,5.0929921876202835,5.796190519590636,4.721673313561861,5.4566841576550456,6.069803804964633,5.507260564211252,591583.018018018,6,E01004408,2,7,1,4,6,4,5.513547810438637,5.022346127813107,5.756741878028228,4.922353473779197,5.360487282833207,5.917884057927354,5.353552920796047,752490.6261682243,4,2,7,4,4,3,1,1.0,-2,0,0,3,0,-3,-3
4297,5.859304213708685,5.035680857739707,5.928849763648454,4.749120412870895,5.578898757003074,6.172539165777754,5.657747475675834,591877.496124031,7,E01004409,1,9,2,7,7,7,5.706359211769369,4.99818257904715,5.7477185593711,4.838870781991217,5.420875204934014,6.002675736943881,5.616098007394208,752819.1805555555,7,1,7,2,6,5,5,1.0,0,0,-2,0,-1,-2,-2
4298,5.91147137416228,5.199344472120736,5.7411337899797745,4.660791062216722,5.602344214461232,6.156950845973182,5.601822186062354,591634.0839694657,8,E01004410,3,7,1,7,7,6,5.666313471553995,5.246835234353868,5.59188586516346,5.019272254525329,5.392141011121462,5.988552316487264,5.543354081592971,752590.381294964,6,5,4,6,5,5,4,1.0,-2,2,-3,5,-2,-2,-2
4299,5.911041842057155,4.841966570569919,5.989599000949126,4.698614368071923,5.522265399877842,6.22824256007488,5.722280132082792,592883.7692307692,8,E01004411,0,9,1,6,8,8,5.657379117342505,4.833505510103585,5.9258725950033355,4.890628007378909,5.387188027400781,6.114258709520397,5.756587341280267,754000.4653465346,6,0,9,3,5,7,8,1.0,-2,0,0,2,-1,-1,0
4300,5.787182669429218,5.070063931100509,5.81679706363117,4.721664234119303,5.574083438690971,6.116394016672583,5.570194035768509,593228.5441176471,6,E01004412,2,7,1,7,7,5,5.634433030199122,5.016457736933673,5.662145420357033,4.894952217737834,5.431531268578989,5.929508442348904,5.527173404340391,754377.4740740741,6,2,6,3,6,4,4,1.0,0,0,-1,2,-1,-3,-1
4301,5.567867347263397,5.477792534598692,5.434623166201586,4.944243376905268,5.406894168751762,5.949788695350688,5.381383567570365,599486.8716577541,4,E01004413,8,2,6,3,4,2,5.539157055145086,5.408098299373952,5.382288386655408,4.992696433104286,5.2797900382862535,5.950684357059094,5.519326527913411,762034.5736434108,4,8,1,5,2,4,4,1.0,0,0,-1,-1,-1,0,2
4302,5.735049258107725,5.177200454732646,5.709917017947072,4.856928886926693,5.553098151217336,6.094393835119579,5.494071176518565,606305.8532608695,6,E01004414,3,6,4,6,6,4,5.359055963873166,5.170024799324616,5.660732440781175,4.967516749922992,5.315099846549899,6.032057271366231,5.532805957989386,769357.052631579,2,4,6,5,3,6,4,1.0,-4,1,0,1,-3,0,0
4303,5.706773707585305,5.285206119466272,5.6107019008316605,4.830260338990585,5.607893369953085,6.043297957929766,5.567402430943081,599723.850931677,5,E01004415,5,5,3,7,5,5,5.357036786225006,5.278602853076149,5.626127965577686,4.986820388386268,5.308189010802116,6.04450924887912,5.678827733483933,761839.0534351146,2,6,5,5,3,6,7,1.0,-3,1,0,2,-4,1,2
4304,5.82009102336385,5.224985732273622,5.681999200447039,4.789348955858838,5.59205826846036,6.117370030419393,5.65948029675267,602409.2272727273,7,E01004416,4,6,3,7,7,7,5.719601638733395,5.239636240812836,5.640175625760719,4.973108161063421,5.3623584370133734,6.163276855277006,5.775209753601639,765191.9365079365,7,5,5,5,4,8,8,1.0,0,1,-1,2,-3,1,1
4305,5.631161436802003,5.2264295519852055,5.724555587768554,4.8678803246195725,5.514023037654598,6.050159984681664,5.5791417569648925,605202.7268292683,5,E01004417,4,6,4,5,5,5,5.459345143181937,5.108601516201382,5.690555766650609,5.075707729657491,5.394135939507257,6.042804817926316,5.5571861108144125,768509.2523809524,3,3,6,7,5,6,4,1.0,-2,-1,0,3,0,1,-1
4306,5.6210281813216065,5.221313669296082,5.712255990433836,4.963399554441075,5.48345676796165,6.13129618924535,5.490500690694341,604848.3473053892,5,E01004418,4,6,6,5,7,4,5.364185369239663,5.2037712500530215,5.592448766876316,5.130793687682481,5.3093185222373815,5.989000965214376,5.5339525735603186,767904.3522012578,2,4,4,8,3,5,4,1.0,-3,0,-2,2,-2,-2,0
4307,5.749511219930987,5.059103141439722,5.76851113299106,4.808261768192264,5.590771056236105,6.193883853601226,5.643587289972508,604397.8368794327,6,E01004419,2,7,3,7,8,6,5.448211207213225,5.092092020423324,5.649227567072268,4.9581300691322046,5.272483868069119,6.168315940433079,5.612767006732799,767459.0074074074,3,3,5,4,2,8,5,1.0,-3,1,-2,1,-5,0,-1
4308,5.383312579335236,5.038905800842658,5.7373527695493,4.954449162977498,5.359874638115487,5.8847849994170955,5.307357491516486,588670.8719512195,2,E01004420,1,7,6,2,3,1,5.225147679007265,5.03819181086749,5.684243798961301,5.034688373994545,5.157056425450116,5.806245902586266,5.345165824749061,749117.3017751479,1,2,6,6,0,2,1,1.0,-1,1,-1,0,-2,-1,0
4309,5.44524018051698,5.2030430393120675,5.7264138005443455,5.034367895617928,5.360936569184372,6.007593966021981,5.343364955223713,589230.8247422681,3,E01004421,4,6,7,2,5,2,5.325011829535167,5.036806105463593,5.803814263255508,5.005609514536681,5.212221252697486,6.033033713146493,5.429955847837307,749773.5185185185,2,2,8,5,1,6,2,1.0,-1,-2,2,-2,-1,1,0
4310,5.175852022502357,5.490606067764075,5.213052509054316,5.207275723042445,5.158079677117915,5.574202802966369,5.102003986381692,567141.6223564955,0,E01004422,8,0,9,0,0,0,5.152948373314962,5.438681522201251,5.204336634261071,5.268997319860954,5.108220558290537,5.610626005368426,5.166093334986296,709201.3843930636,0,8,0,9,0,0,0,1.0,0,0,0,0,0,0,0
4311,5.608342707157135,5.091949628932135,5.733498292309897,4.845186605339959,5.379808485507965,6.015544109401249,5.532305382546925,588828.7380952381,4,E01004423,2,6,4,2,5,5,5.590432600277226,4.953304443417526,5.743831399010449,4.917838997957183,5.395308532365939,6.070574176020738,5.75695817499626,749286.9634146341,5,1,7,4,5,7,8,1.0,1,-1,1,0,3,2,3
4312,5.411670355833778,5.169448853463166,5.662964911423912,4.981526715810909,5.374588612438172,5.95388015296108,5.449986273928206,589467.6899224806,2,E01004424,3,5,6,2,4,3,5.347098366937775,5.024999830169954,5.705717264742091,5.027082846648451,5.304634305877962,5.873292109240657,5.474166994509489,750029.0144927537,2,2,6,6,3,3,3,1.0,0,-1,1,0,1,-1,0
4313,5.929443267156493,4.986443158590569,5.899007178702444,4.758956144440849,5.507521192982511,6.258159495749563,5.770294909207326,589863.037735849,8,E01004425,1,8,2,5,8,8,5.599491369049504,4.947957552828878,5.692192747907819,4.838813503958145,5.325935398632625,6.167139851822044,5.830514663795255,750511.537735849,5,1,6,2,3,8,8,1.0,-3,0,-2,0,-2,0,0
4314,5.964543578694168,4.949384849048355,5.9520262653387865,4.714323793800132,5.563307745942792,6.353346005226802,5.729452137808198,589469.5922330098,8,E01004426,1,9,1,7,9,8,5.731411647314977,4.975572987036272,5.858357203127158,4.902939771160935,5.372960382037693,6.225789561416164,5.838713766348483,750032.0,7,1,8,3,4,9,9,1.0,-1,0,-1,2,-3,0,1
4315,5.571405252441764,5.128408802673221,5.639135481789708,4.8664360493421555,5.340327967889607,6.066435221582651,5.36988821439445,589856.0703125,4,E01004427,2,5,4,2,6,2,5.465097382990983,5.133624116869738,5.551076410460646,4.987958426023051,5.2006857873749555,5.959926479054193,5.550077606291667,750542.0,4,3,4,5,1,4,4,1.0,0,1,-1,1,-1,-2,2
4316,5.247077746128817,5.395439987882562,5.4127257329608325,5.223725178919801,5.258829016204274,5.768545325742949,5.308290700300025,522676.56880733947,1,E01004428,7,2,9,0,1,1,5.108707499270346,5.267747991225299,5.396459507007225,5.236677876874512,5.096864972628799,5.757191728143131,5.415887361648036,666578.8823529412,0,6,1,9,0,1,2,1.0,-1,-1,-1,0,0,0,1
4317,5.257311525015996,5.551948348876878,5.182896164250491,5.155058022790355,5.102123500091102,5.62179978492812,5.207997926350298,519571.18226600986,1,E01004429,9,0,9,0,0,0,5.155408779076771,5.459835463393051,5.1413638412424945,5.254813451682572,5.010847983634577,5.689183399213099,5.299032415436432,664653.8893805309,0,8,0,9,0,0,0,1.0,-1,-1,0,0,0,0,0
4318,5.323865975475641,5.53365815263306,5.246029667788311,5.131800130989312,5.146579810492308,5.678137816772329,5.198092691626103,517797.4532871972,1,E01004430,9,0,8,0,0,0,5.2860030345856,5.449150304505779,5.2344737360431886,5.256284927106966,5.087543986405537,5.70364494536333,5.249318241693412,661215.1305732484,1,8,0,9,0,0,0,1.0,0,-1,0,1,0,0,0
4319,5.720920290902396,5.175601819965327,5.662284638280067,4.78526929382966,5.535546764035091,6.108229632689574,5.590007885594234,588456.4112149533,6,E01004432,3,5,3,6,6,6,5.710307049997074,5.056152509659836,5.715441413761414,4.86175260838774,5.463331678478988,6.015550483133375,5.670368268317783,748884.7422680412,7,2,7,2,7,5,6,1.0,1,-1,2,-1,1,-1,0
4320,5.389948375476814,5.437410584147672,5.358748030218279,5.053143051100073,5.265867607934134,5.844244802960698,5.261370593716639,575295.6397515528,2,E01004434,7,1,7,1,2,1,5.295354056981654,5.294797556852203,5.391761442415075,5.126373633839726,5.258901424657285,5.830809236351961,5.305797495873146,732649.0980392157,1,6,1,8,2,2,1,1.0,-1,-1,0,1,1,0,0
4321,5.671727661903088,5.181872149614187,5.72408595268543,4.802108008127946,5.51916847045605,6.111030266835139,5.5259988335462715,537900.6692307693,5,E01004435,3,6,3,6,7,5,5.511549169703048,4.9867492137953295,5.629074046778125,4.971338771110357,5.377746538598408,5.928287201149519,5.524232640746952,688200.3643410853,4,1,5,5,4,4,4,1.0,-1,-2,-1,2,-2,-3,-1
4322,5.5518413655301355,5.513126062585952,5.32271704838631,5.056290109740927,5.228210468875601,5.839322623420269,5.412801861128909,581685.4202127659,4,E01004436,8,1,7,0,2,3,5.564968786542377,5.434969461153424,5.304665173803057,5.131336970934792,5.22261808915113,5.891215972799473,5.423522990216654,740655.6878306878,5,8,0,8,1,3,2,1.0,1,0,-1,1,1,1,-1
4323,5.941603880736135,5.1637461714206205,5.7665629617629515,4.781561202579929,5.576981060927914,6.122682856936609,5.723280375042269,587400.7258064516,8,E01004437,3,7,2,7,7,8,5.77680272658666,5.074385550618172,5.793960376580556,4.98387439151605,5.499151859680811,6.133082125584284,5.6605257550875345,747672.7083333334,7,2,8,5,7,8,6,1.0,-1,-1,1,3,0,1,-2
4324,5.569271356098412,5.283987639024276,5.556285188179608,4.922744197900905,5.3670611432356425,5.841039797132329,5.331938190977703,586023.9573643411,4,E01004438,5,4,5,2,2,1,5.511232380901937,5.199425334895487,5.491343818741404,4.9658840121803705,5.317856098706033,5.862472104938912,5.4260047643612594,746482.2161172162,4,4,2,5,3,2,2,1.0,0,-1,-2,0,1,0,1
4325,5.785928829856541,5.134633919467097,5.840476507725923,4.81125343364218,5.5407673673353335,6.134026280347852,5.6132185510967085,587434.2463768116,6,E01004439,3,8,3,6,7,6,5.59630525021842,5.107830155979503,5.737722033804113,4.898024568955104,5.4703388132832265,6.051136662562688,5.569085091352463,747763.9393939395,5,3,7,3,7,6,4,1.0,-1,0,-1,0,1,-1,-2
4326,5.438189691894657,5.274974545279702,5.492400119592856,5.022864522514762,5.2657789922022555,5.809082255913661,5.38467538356781,558605.598901099,2,E01004440,5,3,7,1,2,2,5.356585855741758,5.268867358645878,5.460137468415337,5.129261809426385,5.149033672745164,5.7724769888697445,5.303656755911337,711275.5783783784,2,6,2,8,0,1,1,1.0,0,1,-1,1,-1,-1,-1
4327,5.953451225974343,5.073007452487945,5.8264376055110585,4.652393954450434,5.639392217722806,6.198902864889665,5.71255243583159,586403.4545454546,8,E01004441,2,8,0,8,8,7,5.923255270177668,4.942535803534768,5.813526476513256,4.826273748007687,5.474929057468067,6.0900864319367845,5.694031424955888,746626.6909090909,9,1,8,2,7,7,7,1.0,1,-1,0,2,-1,-1,0
4328,5.921395483383765,5.111550849217635,5.828681155351492,4.7989847247417154,5.570696940788856,6.115118562258207,5.623743293835567,585765.1230769231,8,E01004442,2,8,3,7,7,6,5.6728257611945825,5.09056385534781,5.68717190336298,4.917897016913803,5.4589052606512,6.029237150262904,5.61276899267126,745769.4444444445,6,3,6,4,7,6,5,1.0,-2,1,-2,1,0,-1,-1
4329,5.660858987637286,5.090625331086932,5.787136300554815,4.839497831632507,5.475184926446879,6.122689105429739,5.608892983985397,593084.2547169811,5,E01004443,2,7,4,4,7,6,5.416198005801753,5.144970873991649,5.655454840576439,4.951724817878322,5.262589431645577,5.979923200189021,5.552954001384869,754232.3421052631,3,4,5,4,2,5,4,1.0,-2,2,-2,0,-2,-2,-2
4330,5.476900686983202,5.2793153602568825,5.590792521752946,5.006742949042815,5.33721596165433,5.874650490088541,5.415030742603573,592378.0765027322,3,E01004444,5,4,7,2,2,3,5.282046452753962,5.249638473246731,5.433880764212312,5.096406658490499,5.188626519704269,5.796299446774068,5.368472074384743,753329.0677966102,1,5,2,7,1,1,1,1.0,-2,0,-2,0,-1,-1,-2
4331,5.671677517512488,5.228440438944196,5.631481293648008,4.821498530251639,5.49682419924509,5.993545558717516,5.451954288142068,592768.1349206349,5,E01004445,4,5,3,5,4,3,5.401478009564536,5.161414373133864,5.547523358038494,4.998619473406246,5.187479916427817,5.879684227917876,5.434467508324555,753679.4375,3,4,3,5,1,3,2,1.0,-2,0,-2,2,-4,-1,-1
4332,5.655702112049892,5.158060808633936,5.683768530344141,4.925307242007091,5.374442215623526,6.003912479713045,5.421548034610419,593912.5344827586,5,E01004446,3,6,5,2,5,3,5.475762839200066,5.142496918068558,5.648868642869543,4.953855141264493,5.213789834350836,5.883505522227678,5.536367302058173,755010.5081967213,4,3,5,4,1,3,4,1.0,-1,0,-1,-1,-1,-2,1
4333,5.970501191837272,5.002742102465679,5.854810255089986,4.660773908969054,5.541716504342777,6.296757884861267,5.666330838940807,592227.9381443299,8,E01004447,1,8,1,6,9,7,5.886703231900008,4.908914031441679,5.843466517851525,4.789013213718061,5.375173186518483,6.2447472626400975,5.79578145754706,753258.8350515463,8,1,8,1,4,9,8,1.0,0,0,0,0,-2,0,1
4334,5.652009064679618,5.345755525997707,5.431554235599854,4.921283881742876,5.478018934255118,5.8683834829173245,5.477098301216796,591179.3681318681,5,E01004448,6,2,5,4,2,4,5.52326472976504,5.271083311921746,5.427180518765422,5.02781540613908,5.27822506498303,5.874642844736224,5.456309966787079,752000.8165680474,4,6,2,6,2,3,2,1.0,-1,0,0,1,-2,1,-2
4335,5.264741265645591,5.511340227178348,5.3227854198025115,5.209730320079352,5.251076200956939,5.680913681625038,5.068507559837833,589780.7741935484,1,E01004449,8,1,9,0,0,0,5.032908593765413,5.3021046007522425,5.2686421461779664,5.299577963472617,5.040721243078059,5.60846569803026,5.058828034786263,750631.4747474748,0,6,0,9,0,0,0,1.0,-1,-2,-1,0,0,0,0
4336,5.645822264821396,5.34322888778551,5.785040008840222,4.81099171384337,5.540517559511407,6.167722778271902,5.61452630147111,608527.7817258884,5,E01004450,6,7,3,6,7,6,5.5840644997855025,5.215724530940254,5.738996099680662,4.908107713485758,5.482188368837039,6.166420715550582,5.785441808402538,772375.09375,5,5,7,3,7,8,8,1.0,0,-1,0,0,1,1,2
4337,5.770491395080299,5.2307232654931255,5.803393344084422,4.7523771174121325,5.650386096092692,6.170489720085211,5.58263027720284,607909.3859649122,6,E01004451,4,7,2,8,7,5,5.673998138154617,5.115251792428639,5.77264687824697,4.9161845624726705,5.516129490355371,6.163763864499303,5.7498100923260616,771593.8075117371,6,3,7,4,8,8,8,1.0,0,-1,0,2,0,1,3
4338,5.498267708334533,5.300728782167974,5.6081312325015755,5.010070949230554,5.411376554261214,5.902019145353785,5.350345342414184,608586.3710691824,3,E01004452,5,5,7,3,3,2,5.272411180265022,5.201114529551882,5.56950784741026,5.177329790953434,5.241224059191617,5.881641302686749,5.474642298438332,772406.296969697,1,4,4,8,1,3,3,1.0,-2,-1,-1,1,-2,0,1
4339,5.3927608364900665,5.432726083315007,5.392953436470887,5.073001571834889,5.284782211876771,5.785026693557945,5.308641398968718,610021.6143497758,2,E01004453,7,1,8,1,1,1,5.213709636093819,5.349835119835318,5.431022186801858,5.197626450290419,5.233921217591795,5.871633794209728,5.4696173512772335,773910.9246575342,1,7,2,9,1,3,3,1.0,-1,0,1,1,0,2,2
4340,5.579883717108464,5.304142624571703,5.635853160982546,4.947196722894475,5.479588939659838,6.07932848688485,5.344340338223223,609538.7101449275,4,E01004454,5,5,6,5,6,2,5.379313253341837,5.219263485982909,5.528776965242751,5.118883451671465,5.245150733501353,6.000888570826104,5.43331601687357,773575.0921985816,2,5,3,7,2,5,2,1.0,-2,0,-2,1,-3,-1,0
4341,5.379381528922489,5.528187679109119,5.312535531180245,5.118812054679507,5.179619248140426,5.75177553438005,5.216299222764515,609482.4857142858,2,E01004455,8,1,8,0,1,0,5.226643704720752,5.375609993395223,5.382397458564102,5.215408686059632,5.0733289324859685,5.765562573169691,5.231475896964785,773581.7511312218,1,7,1,9,0,1,0,1.0,-1,-1,0,1,0,0,0
4342,5.189722255605166,5.441563238863085,5.286321174902994,5.077481532683138,5.2158187383511025,5.638554170483449,5.095223540165385,610344.131147541,0,E01004456,7,0,8,0,0,0,5.17660959251225,5.353100376203656,5.263127027079463,5.192986207082868,5.164075226522982,5.675289599224925,5.184861269779503,774670.109375,0,7,0,8,0,0,0,1.0,0,0,0,0,0,0,0
4343,5.895294279963882,4.980833970838123,5.978217893176609,4.717279177021097,5.539099676741494,6.313174053474709,5.738340825946243,590673.8333333334,7,E01004457,1,9,1,6,9,8,5.65185199986707,5.087564043096594,5.81679756362159,4.769760516312745,5.320785354923558,6.140441636781435,5.647036809105057,751560.7747747748,6,3,8,1,3,8,6,1.0,-1,2,-1,0,-3,-1,-2
4344,5.54959646982091,5.150343057763486,5.761742366179255,4.885497969525461,5.450628013101243,6.061988748666894,5.578874235844794,597814.2671755726,4,E01004458,3,7,5,4,6,5,5.403268368805156,5.2120077206807975,5.616904051864848,5.083547337966807,5.264216546626652,5.907051698249929,5.453732437070678,760257.4191176471,3,5,5,7,2,3,2,1.0,-1,2,-2,2,-2,-3,-3
4345,5.491334180037181,5.380067027750469,5.4778597340697335,4.934583627042317,5.4165320964086625,6.020785093307495,5.470133774337315,609789.7261904762,3,E01004459,7,2,5,3,5,4,5.4303436731470045,5.44686569564644,5.360257028163164,5.072741877073529,5.298962957557591,5.896176710896109,5.336239491385975,774028.7931034482,3,8,1,7,3,3,1,1.0,0,1,-1,2,0,-2,-3
4346,5.774662358738552,5.021964967807877,5.865257441440475,4.651564469961363,5.544744157345495,6.18300544658554,5.6636282406120655,600613.2897196262,6,E01004460,1,8,0,6,8,7,5.581842888956484,5.054014878687651,5.743214306624039,4.821602289573006,5.255912776615308,6.073733908197154,5.630331304798956,762749.2869565217,5,2,7,2,2,7,6,1.0,-1,1,-1,2,-4,-1,-1
4347,5.499078781289213,5.209650704089333,5.641565563047633,5.01802810412996,5.414681604679893,5.973577452933087,5.401048421859741,589325.5808823529,3,E01004461,4,5,7,3,4,2,5.3516055818990615,5.148699565982143,5.648866312723634,5.066147506659758,5.238840005921979,5.872360138182945,5.513429311150355,748684.1702127659,2,4,5,7,1,3,3,1.0,-1,0,0,0,-2,-1,1
4348,5.80311983052422,4.9815550972433655,5.900850873834947,4.750600518899805,5.561611411150764,6.286774189331952,5.74522200051476,591438.9882352941,7,E01004462,1,8,2,6,9,8,5.586377068644478,4.969226323422932,5.79931162084852,4.841229931229637,5.408158591815403,6.050897596847443,5.535175093582699,752308.630952381,5,1,8,2,5,6,4,1.0,-2,0,0,0,-1,-3,-4
4349,6.030750136626394,4.932716248328226,6.053526886722498,4.60293228688993,5.550713338349995,6.503145318282278,5.9560640036014085,605331.8333333334,8,E01004463,0,9,0,6,9,9,5.805506973731808,4.893997806843704,5.832065878844842,4.719001476357623,5.37600809578004,6.388668397577797,5.866533715550492,768933.4715447155,8,0,8,0,4,9,9,1.0,0,0,-1,0,-2,0,0
4350,5.3646484094090985,5.202203629040482,5.617673549321618,4.942923857433962,5.358703837536349,5.8155407693126415,5.354583938523095,591568.5643564357,2,E01004464,3,5,6,2,2,2,5.278384464923467,5.1860922352175844,5.535140296009099,5.141679366058279,5.308439734940217,5.732608634734822,5.342653889522374,752444.3644859813,1,4,3,8,3,1,1,1.0,-1,1,-2,2,1,-1,-1
4351,5.836233415951331,5.030622420211633,5.893532924354076,4.697540320456028,5.490197269866864,6.291458224256833,5.588671273241441,592539.4375,7,E01004465,1,8,1,5,9,6,5.708980009430333,5.020088956230565,5.783065479680111,4.806302694270485,5.340363610418219,6.211689266405608,5.712107382322612,753599.6210526315,7,2,7,1,3,8,7,1.0,0,1,-1,0,-2,-1,1
4352,5.81284132572489,5.163624110571835,5.795603743386925,4.640421832373383,5.538002795035686,6.147046957540949,5.51179335861031,593163.2018348624,7,E01004466,3,7,0,6,7,4,5.678215729106556,5.156314861774445,5.678543329238892,4.849969646063718,5.384296550533988,6.0620921113274315,5.549356184222481,754383.4636363636,6,4,6,2,5,6,4,1.0,-1,1,-1,2,-1,-1,0
4353,5.4684325745151305,5.290366908547226,5.568138620656008,4.9725865801428535,5.395519371245317,5.9165917247723625,5.353406735286591,592766.2675159236,3,E01004467,5,4,6,3,3,2,5.320690365656754,5.2358865796422664,5.498513559622268,5.131089006464905,5.252240040550934,5.844956879235484,5.371169774078884,753882.1165644171,2,5,3,8,2,2,1,1.0,-1,0,-1,2,-1,-1,-1
4354,5.925908787467263,5.399009892723777,5.3383752957257355,4.7848262795535,5.502925270253962,5.925237127650868,5.385313831242648,592204.6509090909,8,E01004468,7,1,3,5,3,2,5.877833755811055,5.24157344053189,5.493903843065103,4.85377048154672,5.4070973753929135,6.117128660281499,5.601635884245237,753487.7916666666,8,5,3,2,5,7,5,1.0,0,-2,2,-1,0,4,3
4355,5.659733342730309,5.291409850120544,5.554342323098301,4.866183616898277,5.383982526369332,5.951004605647946,5.421286251919328,600166.7603305785,5,E01004469,5,4,4,2,4,3,5.516892371321083,5.2473106626281165,5.517445395763655,5.074502471694372,5.332759299672636,5.8979420159992415,5.502152148942302,762698.2481203007,4,5,3,7,3,3,3,1.0,-1,0,-1,3,1,-1,0
4356,5.465795396623157,5.062094967705863,5.732108531679426,4.974771853855678,5.399534596715655,5.929933325449626,5.324735740252904,595664.4380952381,3,E01004470,2,6,6,3,3,1,5.325219166728686,5.105884288841823,5.627319628337644,5.009026441933973,5.240502564412243,5.89441091609451,5.453669259008372,757563.5094339623,2,3,5,6,1,3,2,1.0,-1,1,-1,0,-2,0,1
4357,5.7209947231141,5.216361276128075,5.783531386743892,4.714059366421266,5.559140657836741,6.116829484701157,5.573242738842964,591508.4772727273,6,E01004471,4,7,1,6,7,5,5.619935425286441,5.145605111859508,5.698563349615667,4.854750117075812,5.403917875486551,6.093013026050685,5.589072223791142,752625.7525773196,6,4,6,2,5,7,5,1.0,0,0,-1,1,-1,0,0
4358,5.806205024038042,5.0397320806980135,5.85096891437258,4.798912473235812,5.550927380153111,6.240199601650238,5.648180960757392,70054.60714285714,7,E01004472,1,8,3,6,8,7,5.632132016619047,4.993853475650152,5.783212357759476,4.830604230364163,5.4527870913346606,6.147525689999262,5.644914269447327,90649.49166666667,6,1,7,2,6,8,6,1.0,-1,0,-1,-1,0,0,-1
4359,5.896509015843982,5.038571418750854,5.833250125249227,4.783235955806005,5.569824634563355,6.298331374213809,5.697844755081904,68079.5,7,E01004473,1,8,2,7,9,7,5.664624958596331,4.992544109516955,5.725282851685869,4.85912534023853,5.435748843436546,6.17263762494351,5.723692171117093,88370.86170212766,6,1,7,2,6,8,7,1.0,-1,0,-1,0,-1,-1,0
4360,5.355039763760257,5.004244925139786,5.809574812263637,4.928459769719607,5.442786146293987,5.872000732979217,5.336271443924346,68212.33116883117,2,E01004474,1,7,5,4,2,2,5.382084434415087,4.975944744951931,5.767877876022716,4.935459914766712,5.412380311960056,5.870116986610271,5.445042075198374,88538.58641975309,3,1,7,4,5,3,2,1.0,1,0,0,-1,1,1,0
4361,5.860026507764249,4.947671627676165,5.9165007874772355,4.765912811498384,5.663976131258784,6.28142084302129,5.745992721738042,67940.08108108108,7,E01004475,1,8,2,8,9,8,5.712544846229064,4.974124324627412,5.7741151711879635,4.86161546370922,5.488611597281236,6.217634956041972,5.884741205435533,88212.19230769231,7,1,7,2,7,8,9,1.0,0,0,-1,0,-1,-1,1
4362,6.117719928059009,5.167715181998156,5.693690002511401,4.723770758427611,5.69798611063476,6.125195417929133,5.636676104790574,68324.4495412844,9,E01004476,3,6,1,9,7,6,5.92630799484253,5.124843684196472,5.8186019439697265,4.726743768692017,5.623642086029053,6.110632781982422,5.739742248535157,88660.96,9,3,8,0,9,7,7,1.0,0,0,2,-1,0,0,1
4363,6.185810329038886,4.928333898888359,5.989389504058452,4.550161932088152,5.699931660784951,6.381868351863909,5.824510744855374,69756.77215189874,9,E01004477,0,9,0,9,9,9,6.096813687464086,4.903403747372511,5.927382922754055,4.592270910739899,5.54899009117266,6.29419635563362,5.851331930334975,90324.53658536586,9,1,9,0,8,9,9,1.0,0,1,0,0,-1,0,0
4364,6.21256170178404,4.725980609950453,6.168428822319107,4.534154642926584,5.600372352222405,6.5613914810784975,5.920042831118744,72081.75247524753,9,E01004478,0,9,0,7,9,9,6.178560964415007,4.679473915946818,6.167878476258751,4.498535598549887,5.443430532918912,6.490781737265186,5.888336430086154,93176.26168224298,9,0,9,0,6,9,9,1.0,0,0,0,0,-1,0,0
4365,6.1641318735869035,4.9649909755458,6.077563532539036,4.480516192187434,5.718906848326974,6.450007983912593,5.907241320610046,77892.71304347826,9,E01004479,1,9,0,9,9,9,6.099970507964813,4.825789141998016,6.008807036516478,4.650525082787164,5.627255648160152,6.420911106274282,6.007623048137418,100246.44604316547,9,0,9,0,9,9,9,1.0,0,-1,0,0,0,0,0
4366,6.196395173905388,4.735988056848919,6.229038090932937,4.480266533200703,5.649668905470106,6.664168577345591,5.9204767772129605,67505.09523809524,9,E01004480,0,9,0,8,9,9,5.949148681855971,4.693195537213357,6.112515172650737,4.538295170953197,5.616327466503266,6.440654612356616,5.861426216940726,87715.03225806452,9,0,9,0,9,9,9,1.0,0,0,0,0,1,0,0
4367,5.766915798187256,4.881352365016937,6.022118030450283,4.652513763843438,5.54369931648939,6.306374531525832,5.786041776339213,76678.41025641025,6,E01004481,0,9,1,6,9,8,5.5763466168533675,4.8399124199693855,5.911633399399844,4.763759118589488,5.490487036379901,6.199729862538251,5.608961410143158,99156.13636363637,5,0,9,1,7,8,5,1.0,-1,0,0,0,1,-1,-3
4368,5.825323036347313,5.055756760739732,5.850052882885111,4.580916059428248,5.605754846814035,6.377648027463891,5.853626059389662,72164.31034482758,7,E01004482,2,8,0,7,9,9,5.809340597480856,4.992234620996701,5.746719347533359,4.803567997870907,5.478066057287236,6.2736683045664146,5.646424153799652,92994.02150537634,8,1,7,1,7,9,6,1.0,1,-1,-1,1,0,0,-3
4369,6.109994081350473,5.219647978360836,5.7094513315420885,4.631791212237799,5.711415075338804,6.339641786538637,5.680786268069194,69652.04807692308,9,E01004483,4,6,0,9,9,7,6.209202704826991,5.203293657302856,5.66194887359937,4.62496979534626,5.6767290453116095,6.314387450615565,5.873625228802363,89865.825,9,4,6,0,9,9,9,1.0,0,0,0,0,0,0,2
4370,5.93796049207449,4.99367014169693,5.9053516536951065,4.718922300636768,5.674941033124924,6.355185946822166,5.939364629983902,67819.9125,8,E01004484,1,8,1,9,9,9,5.691635634325728,5.077772190299215,5.667187299909471,4.934220197834546,5.447848679144172,6.137161153781263,5.900739322734784,88076.0506329114,6,2,6,4,6,8,9,1.0,-2,1,-2,3,-3,-1,0
4371,5.6739329780851095,5.0205636365073065,5.883174844015212,4.750393912905738,5.4721649260748,6.165676498413086,5.78752882594154,68909.34285714285,5,E01004485,1,8,2,4,7,8,5.810703683924931,4.970496891647257,5.9281814944359565,4.777864957368502,5.464982364767341,6.27336194181955,5.867443019343961,89404.05376344085,8,1,9,1,7,9,9,1.0,3,0,1,-1,3,2,1
4372,6.232515901759051,5.117591498554617,5.6903791773146475,4.619748350502788,5.860091276790785,6.2266432202380635,5.803431506606116,67415.73913043478,9,E01004486,2,6,0,9,8,8,6.071742580932321,4.980415287527066,5.778532028198242,4.6995785768749645,5.638891530268401,6.19019395865283,5.849142953030114,87637.92233009709,9,1,7,0,9,8,9,1.0,0,-1,1,0,0,0,1
4373,5.946613742084038,4.845240504276462,6.029675725029736,4.602779078774336,5.723240404594235,6.509198956373261,5.9399998885829275,67772.10975609756,8,E01004487,0,9,0,9,9,9,6.050540300302727,4.731984611167464,5.983754731887995,4.594155627627705,5.623133043910181,6.445149324661077,6.103720357251722,88006.09302325582,9,0,9,0,9,9,9,1.0,1,0,0,0,0,0,0
4374,6.210591603350895,4.7852036670971945,6.1769451531030795,4.54534573196083,5.693766745187903,6.588912097356653,6.086299075875231,69493.63440860216,9,E01004488,0,9,0,9,9,9,6.033769845962524,4.745455898490607,6.15320242619982,4.558210077239018,5.569283592934702,6.450567970088884,6.05361283526701,90013.8137254902,9,0,9,0,9,9,9,1.0,0,0,0,0,0,0,0
4375,6.121265006065369,4.916704948743185,6.014530213673909,4.526154871781667,5.691829419136047,6.494734499189589,5.965803229808808,68890.36666666667,9,E01004489,0,9,0,9,9,9,6.24870149842624,4.767157244956357,6.104414252029068,4.449109896846201,5.684479261266774,6.624806472624855,6.066490632364119,89398.83908045977,9,0,9,0,9,9,9,1.0,0,0,0,0,0,0,0
4376,5.824390166479608,4.937572426122168,5.954560171002927,4.696619646704716,5.571732887755269,6.373400099899458,5.810778340567714,81181.65217391304,7,E01004490,0,9,1,7,9,8,5.7096695394227,5.07052215783283,5.80593236046608,4.76837488376733,5.357150547432177,6.232888857523601,5.689278600191829,104102.79797979798,7,2,8,1,4,9,7,1.0,0,2,-1,0,-3,0,-1
4377,5.741214844787005,5.34828137425543,5.5656841055860795,4.8054732790271055,5.467962422417205,5.9639172947522505,5.541007795380157,80572.84466019417,6,E01004491,6,4,3,4,4,5,5.736272042872859,5.332432029294033,5.546395245720358,4.829219449968899,5.497392038504283,5.979417747142268,5.507766977244732,103405.07843137255,7,7,3,2,7,5,3,1.0,1,1,-1,-1,3,1,-2
4378,5.255557817082073,5.2823117423889245,5.4579140959784045,5.078134074460628,5.29147948151411,5.7566186979759575,5.165121909490852,83493.36046511628,1,E01004492,5,2,8,1,1,0,5.212275095239899,5.255344271659851,5.401738786133083,5.1028074999532755,5.098612329663609,5.740138514507452,5.279563854431965,107542.26627218934,1,5,1,7,0,1,0,1.0,0,0,-1,-1,-1,0,0
4379,5.426000674262301,5.195668065820941,5.600040697869454,4.964532815773069,5.320028970259746,5.9705433590721535,5.31840835909807,94586.39694656488,2,E01004493,3,4,6,1,4,1,5.320576801896095,5.14122870961825,5.555110003550848,4.986068398753802,5.194248097141584,5.8930065602064134,5.38892420331637,122264.375,2,3,4,5,1,3,1,1.0,0,0,0,-1,0,-1,0
4380,5.679801989856519,4.935933740515458,5.8054649779671115,4.66243001787286,5.49237627355676,6.1681029721310265,5.528746971331144,96052.92631578947,5,E01004494,0,7,1,5,7,5,5.595034942030907,4.933755600681672,5.7503185868263245,4.7731888099358635,5.370311157061503,6.140117461864765,5.611266750555772,122998.89423076923,5,1,7,1,4,8,5,1.0,0,1,0,0,-1,1,0
4381,5.660641206277384,5.186317669378744,5.683682915326711,4.815264162179586,5.479603991315171,5.973292843715565,5.598138731879157,96435.56756756757,5,E01004495,3,6,3,5,4,6,5.649897679105981,5.057003682309931,5.7152476558437595,4.839105113760217,5.358179755025096,6.08196548362831,5.6780697339540955,123478.05194805194,6,2,7,2,4,7,6,1.0,1,-1,1,-1,-1,3,0
4382,5.422542713521942,4.893655102427413,5.81053820276648,4.888798719499169,5.3840648740287715,5.96823166734804,5.476548059199883,94428.46341463414,2,E01004496,0,7,5,2,4,4,5.440499614978182,4.951835526936296,5.764599771603294,4.919027358725451,5.302884887094083,5.996224538139675,5.585308467996294,121165.66666666667,3,1,7,4,3,5,5,1.0,1,1,0,-1,1,1,1
4383,5.591859829944113,5.256048603679822,5.6569536913996155,4.745300789501356,5.568754813982093,6.170193531202234,5.576975149693697,82920.18260869566,4,E01004497,4,5,2,7,7,5,5.384316890716553,5.1940960760116575,5.531380907058716,4.916082337379455,5.2725251770019534,6.027382606506348,5.566459643363952,107476.608,3,4,3,4,2,6,4,1.0,-1,0,-2,2,-5,-1,-1
4384,5.884711439609528,4.924118459224701,5.949996159076691,4.656372140645981,5.548018541336059,6.382094678878784,5.729294041395187,87879.73,7,E01004498,0,9,1,6,9,8,5.71255271457066,4.876577184579083,5.831947952787453,4.725554702437926,5.334996187798331,6.238239910000953,5.7076148474327875,112594.71962616823,7,0,8,0,3,9,7,1.0,0,0,-1,-1,-3,0,-1
4385,5.946350785402151,5.067958599099746,5.887217159454639,4.687495933129237,5.632386970978517,6.124710193047156,5.707614935361422,93688.63461538461,8,E01004499,2,8,1,8,7,7,5.981459539586847,4.917544359510595,5.965635059096597,4.620271768353202,5.607774397459897,6.20958957455375,5.831172490119934,120155.3,9,1,9,0,9,8,8,1.0,1,-1,1,-1,1,1,1
4386,5.8379917341815535,5.349775586246459,5.691742026116237,4.861939362257965,5.637362336324266,6.056553734235527,5.662953677256246,91714.73553719008,7,E01004500,6,6,4,8,6,7,5.771971813419409,5.232528373860476,5.636825728834721,4.8865428462363125,5.492790956246226,6.0011104700858136,5.648626734290207,116940.99122807017,7,5,5,3,7,5,6,1.0,0,-1,-1,-1,-1,-1,-1
4387,6.213946398566751,5.032602678827879,5.921238025697339,4.521612505952851,5.821720163361365,6.343230227462384,5.889461079565417,91380.3025210084,9,E01004501,1,8,0,9,9,9,5.927505117304185,5.152597120930166,5.718863569988924,4.740421464863945,5.668726075396818,6.157043016658109,5.785202933059019,116600.35294117648,9,4,7,1,9,8,8,1.0,0,3,-1,1,0,-1,-1
4388,5.966477329914387,4.951525324812303,5.986808134959294,4.649584438938361,5.605437226020372,6.308067534978573,5.812423560481805,97352.05769230769,8,E01004502,1,9,0,7,9,9,5.915391535372348,4.901548277150403,5.94683213276906,4.745805170084979,5.515668684297854,6.211713438635474,5.818680630073891,124556.71171171172,8,0,9,1,8,8,8,1.0,0,-1,0,1,1,-1,-1
4389,6.136920677698575,5.11349237882174,5.747669702309828,4.630889366223262,5.6501935390325695,6.208097045238201,5.85629723072052,96323.06153846154,9,E01004503,2,7,0,8,8,9,6.02834989130497,5.045299938496421,5.7917000931852005,4.705488958779504,5.59644931028871,6.265484962393256,5.897466466707342,122852.27205882352,9,2,8,0,9,9,9,1.0,0,0,1,0,1,1,0
4390,5.9276121182994945,5.173939178003132,5.656180871784358,4.671890847590747,5.591805160374931,6.147440308365374,5.593234222238235,98128.9226519337,8,E01004504,3,5,1,7,7,6,5.904987266806305,5.101654192789005,5.692990524521291,4.868776858830061,5.543426421822095,6.146398072685701,5.756530262733418,125445.73224043715,8,3,6,3,8,8,8,1.0,0,0,1,2,1,1,2
4391,5.902321330657819,5.364353901002465,5.545740009807959,4.908703315548781,5.518309956643639,6.014005296114014,5.677158055509009,93934.23780487805,8,E01004505,6,4,5,6,5,7,5.873450075426409,5.313659819479912,5.535886052346998,4.847372894133291,5.408933125003692,6.073113247656053,5.751050374584813,119434.83225806452,8,6,3,2,5,7,8,1.0,0,0,-1,-3,-1,2,1
4392,5.813238906860351,4.944268016254201,5.93066021975349,4.7395600047765996,5.613839012968774,6.2010926078347595,5.801592850217633,90683.30980392157,7,E01004506,1,9,2,8,8,8,5.7090329969529625,5.012785528203566,5.852929696762304,4.823956430387154,5.506219682933615,6.097822414027701,5.723438274946144,115677.73381294963,7,2,8,2,8,7,7,1.0,0,1,-1,0,0,-1,-1
4393,5.852195653829488,5.173127593220891,5.807749799779944,4.758130750140628,5.641308621243313,6.153460689493127,5.560449562631212,91593.63963963964,7,E01004507,3,7,2,8,7,5,5.70328949491183,5.110846408208212,5.7375575542449955,4.849209649364154,5.519077181816101,6.086834841966629,5.686035740375519,116900.89166666666,7,3,7,2,8,7,7,1.0,0,0,0,0,0,0,2
4394,5.787977225147188,4.871271676383913,5.999137738719583,4.666650229133666,5.594443649984896,6.126396954059601,5.746831411495805,74177.515625,6,E01004508,0,9,1,7,7,8,5.740764206602373,4.868546995497842,6.0108525534622546,4.768088873106104,5.515633088031798,6.068410043498032,5.7530097925026,95694.58778625954,7,0,9,1,8,7,8,1.0,1,0,0,0,1,0,0
4395,5.211748194780281,5.258134521597581,5.48032625544843,5.123875944734477,5.318386999823207,5.645292661601691,5.257539309614854,90915.00719424461,0,E01004509,4,2,8,1,0,1,5.216397555315331,5.186874856279321,5.453902175165203,5.128584439215595,5.194000779357675,5.666224722176382,5.325719481461669,115961.10616438356,1,4,2,8,1,0,1,1.0,1,0,0,0,0,0,0
4396,5.578426672473098,5.271692389430422,5.597552839192477,4.8569764122818455,5.372172474861145,5.955579159476541,5.533660638693608,80026.28484848485,4,E01004510,5,4,4,2,4,5,5.578272173064096,5.219797933442252,5.51630163192749,4.993537658282689,5.285189108848572,5.935022371155875,5.532077501841954,102847.21142857143,5,5,3,5,2,4,4,1.0,1,0,-1,1,0,0,-1
4397,5.754875247872721,5.020818377104331,5.829643927221223,4.773456979924299,5.51722226086564,6.197956591140567,5.609636603377935,91342.90551181103,6,E01004511,1,8,2,5,8,6,5.623344170368783,4.985725795350423,5.841216961542766,4.845026669463491,5.39112951018946,6.023967364939248,5.703928735198044,116257.25203252032,6,1,8,2,5,6,7,1.0,0,0,0,0,0,-2,1
4398,6.112398902993453,4.875948828145077,6.074048112568103,4.574318395162884,5.639150900589792,6.376856823971397,5.800153409807305,92537.0,9,E01004512,0,9,0,8,9,8,6.046046576549098,4.81324965437663,6.050676323703883,4.682120009795907,5.591791853462298,6.3232907536103555,5.904560325071984,118023.05154639175,9,0,9,0,9,9,9,1.0,0,0,0,0,1,0,1
4399,5.6267265031735105,5.241943672299385,5.668328116337459,4.859048481782278,5.465868483980497,5.944902104139328,5.545653908451398,93960.05833333333,5,E01004513,4,5,4,4,4,5,5.543809889800965,5.18450155996141,5.673107258857242,4.841388110130552,5.3683999464625405,5.951230802233257,5.615738564067417,120092.61111111111,5,4,6,2,4,4,5,1.0,0,0,1,-2,0,0,0
4400,5.423676754068012,5.174908779150138,5.682922821103429,4.926193113707326,5.406544201213158,5.9192246410744325,5.409781459650379,90826.42944785276,2,E01004514,3,6,5,3,3,3,5.4472963618380685,5.130188350166593,5.60880493124326,4.980483025312424,5.266746208781288,5.881554713561421,5.504840473333995,115957.625,3,3,5,5,2,3,3,1.0,1,0,-1,0,-1,0,0
4401,5.619600417522284,5.200997915405494,5.715450717852666,4.852695795205923,5.524743960453914,5.960372078877229,5.462089611933782,74197.68269230769,5,E01004515,3,6,4,6,4,3,5.590323353300289,5.12654720885413,5.633228019792206,4.916551801623131,5.3981238323815015,5.856563344293711,5.42140272077249,95734.9693877551,5,3,5,4,5,2,2,1.0,0,0,-1,0,-1,-2,-1
4402,6.038504973511023,5.058171973638008,5.853876659475222,4.628097542955832,5.660502263373393,6.425663991939802,5.671499620186039,74900.6073619632,9,E01004516,2,8,0,8,9,7,5.891823631066543,5.102984604599712,5.76552330661606,4.6576340322966105,5.471601320492042,6.310222494733202,5.776686209243732,97082.67032967033,8,3,7,0,7,9,8,1.0,-1,1,-1,0,-1,0,1
4403,5.825794541630252,4.959160542693631,5.907369665030775,4.712824742341864,5.574858250289128,6.299446438920909,5.766267446608379,92707.99137931035,7,E01004517,1,8,1,7,9,8,5.744623408084962,4.890926193415634,5.87154661543001,4.83969474517233,5.482277481536555,6.249503963361911,5.698211677675324,118019.28455284552,7,0,8,2,7,9,7,1.0,0,-1,0,1,0,0,-1
4404,6.243925367240553,4.946398949181592,6.138790819380018,4.535855560391037,5.734959187331023,6.677766201672731,5.897432555754979,93948.16666666667,9,E01004518,1,9,0,9,9,9,5.988767302036285,4.867639795541764,6.034926199913025,4.557489718198776,5.535206233263016,6.5699973702430725,5.945138969421387,118882.59,9,0,9,0,8,9,9,1.0,0,-1,0,0,-1,0,0
4405,5.786500749238041,5.068175032598163,5.879454776781414,4.679193957136311,5.598643401347169,6.361581784869553,5.673532415967469,91110.28440366972,6,E01004519,2,8,1,7,9,7,5.64106297877527,5.059898442799045,5.751634782360446,4.778874216541167,5.317345488455988,6.267422393445046,5.791878916563526,117538.01612903226,6,2,7,1,3,9,8,1.0,0,0,-1,0,-4,0,1
4406,5.690552106409362,5.1049751440684,5.923469044945457,4.7494303836967005,5.541815363999569,6.3595479004310835,5.571078818855864,100059.92424242424,5,E01004520,2,8,2,6,9,5,5.691729562383302,5.075966678874593,5.882388423865949,4.856735278183306,5.29567752925443,6.268789345109966,5.745459062952391,128395.0,6,2,8,2,2,9,8,1.0,1,0,0,0,-4,0,3
4407,5.670244337252851,5.065198536189097,5.93634584040012,4.786869437064764,5.563390167254322,6.176575617970161,5.445836199904388,100189.01886792453,5,E01004521,2,9,3,7,7,3,5.5809458739617295,4.999747065936818,5.898280412543054,4.789731682515612,5.388961658758276,6.105408021048004,5.623950158848482,128000.03921568628,5,1,9,1,5,7,6,1.0,0,-1,0,-2,-2,0,3
4408,5.845996508034327,5.004162675590925,5.909655160801385,4.797547267329309,5.5410947645864175,6.324486345373174,5.7303220584828365,100271.08602150538,7,E01004522,1,8,3,6,9,8,5.670169622368283,5.029808331860436,5.922588562965393,4.763733042611016,5.346548820866479,6.226200850804647,5.83994318511751,128080.32222222222,6,2,9,1,4,9,9,1.0,-1,1,1,-2,-2,0,1
4409,6.243033226240765,5.190955114635554,5.73794612288475,4.580364840274507,5.840988197109916,6.260462167588147,5.779028824107214,69223.84090909091,9,E01004523,3,7,0,9,8,8,6.217275803361959,5.172089589768975,5.704123706959966,4.585928193965361,5.725730327824455,6.290937861399864,5.838513303158888,89583.6616915423,9,4,6,0,9,9,9,1.0,0,1,-1,0,0,1,1
4410,5.981933203312235,5.224330046854981,5.620349785603515,4.7653585278659785,5.670633508524763,6.1049735721098175,5.604516918506097,79866.12844036697,8,E01004524,4,5,2,8,6,6,6.077374158082185,5.119876711456864,5.760633463329739,4.641408650080363,5.73217582349424,6.178491841422187,5.67298100259569,105888.88888888889,9,3,7,0,9,8,6,1.0,1,-1,2,-2,1,2,0
4411,5.585057891688301,4.8419004215777495,5.957989245942495,4.78427479568037,5.434678959615022,6.198673413795175,5.547539682064242,90743.61165048544,4,E01004525,0,9,3,3,8,5,5.507751669054446,4.756568910764611,5.939488352899966,4.8155092508896535,5.331791837319084,6.083250027117522,5.627264779546986,117474.79130434783,4,0,9,2,3,7,6,1.0,0,0,0,-1,0,-1,1
4412,5.684796905517578,4.910885723431905,5.851952070660062,4.822802200582292,5.513330896695455,6.155712568759919,5.627083598242866,100988.84444444445,5,E01004526,0,8,3,5,7,6,5.682534663182385,4.946982805459005,5.8555759888774945,4.798919469680426,5.550827914813779,6.1111613489546865,5.6382270927699105,128976.16981132075,6,1,8,1,8,7,6,1.0,1,1,0,-2,3,0,0
4413,6.097041428089142,4.963766075670719,6.014097601175308,4.591636684536934,5.701986706256866,6.552520346641541,5.8110803872346874,85904.975,9,E01004527,1,9,0,9,9,8,5.918946912342852,4.808334392580119,5.957100987434387,4.658469675616785,5.51864402402531,6.436040274121544,5.804495543241501,110218.06818181818,8,0,9,0,8,9,8,1.0,-1,-1,0,0,-1,0,0
4414,5.570227340720166,5.2295102415413695,5.702812230449983,4.868532746687703,5.435190863992976,6.023375212461099,5.604496177585646,81637.06896551725,4,E01004528,4,6,4,3,5,6,5.643318962632564,5.024527448311186,5.725694380308452,4.872610014781618,5.482927680015564,6.062739813536928,5.748727736765878,106241.50877192983,6,2,7,3,7,6,8,1.0,2,-2,1,-1,4,1,2
4415,5.62853973172605,5.059173641726375,5.893297962844372,4.81938093341887,5.446487117558718,6.149617206305265,5.590256001800299,101037.5234375,5,E01004529,2,8,3,4,7,6,5.695793331993951,4.896582307638945,5.965439437936854,4.757504067597566,5.415550764401754,6.215331049318666,5.76477201073258,128994.88148148148,6,0,9,1,5,8,8,1.0,1,-2,1,-2,1,1,2
4416,5.8945245236158375,4.939630018174649,6.009026896953583,4.68135457187891,5.615874087810516,6.392071065306664,5.806709323823452,101290.4125,7,E01004530,0,9,1,8,9,8,5.850340464909872,4.911376891136169,5.955370200475057,4.72386118888855,5.574720579783122,6.3888113307952885,5.957646245956421,129277.29333333333,8,1,9,0,9,9,9,1.0,1,1,0,-1,1,0,1
4417,6.079178109581088,4.960028867662689,5.956192487551842,4.544794132680069,5.706000133796975,6.544924485830613,5.843341706711569,78259.02469135802,9,E01004531,1,9,0,9,9,9,5.880661907075327,4.941264451304568,5.918711653238611,4.685077825679055,5.612378705905963,6.496268444423434,5.77816670604899,100584.22784810126,8,1,9,0,9,9,8,1.0,-1,0,0,0,0,0,-1
4418,6.01970577575791,4.939957677478522,5.980664763652103,4.560547672526937,5.588837072882853,6.538347422237128,5.8022486894903045,69367.45070422535,8,E01004532,0,9,0,7,9,8,5.937452887787538,4.8180458861238815,5.862267823780284,4.614418916842517,5.540716556941762,6.484310083529529,5.83182842240614,90351.2794117647,9,0,8,0,8,9,8,1.0,1,0,-1,0,1,0,0
4419,5.925313918730792,4.9691584685269525,5.9406835640178,4.529833148507511,5.619982674542595,6.514067781672758,5.819819419524249,75108.58823529411,8,E01004533,1,9,0,8,9,9,5.721233201787827,4.902384125171824,5.7272522094401905,4.814385879547038,5.522919961746703,6.388846001726516,5.705928077089026,97055.77659574468,7,0,7,2,8,9,7,1.0,-1,-1,-2,2,0,0,-2
4420,5.581968683116841,5.100622546747795,5.667281410229281,4.828669784204015,5.481846954087791,5.897536717120956,5.405278999850435,75631.9182389937,4,E01004534,2,5,3,5,3,2,5.584526231601124,5.024852251722699,5.6555813664481756,4.8574612367720835,5.353111980216844,5.873009115457535,5.491697713732719,97414.20833333333,5,2,5,2,4,3,3,1.0,1,0,0,-1,-1,0,1
4421,5.457821451700651,5.236190872925978,5.556631161616399,4.8942074995774485,5.491908895052396,5.91275585614718,5.51216757114117,74648.04615384615,3,E01004535,4,4,5,5,3,4,5.517740771625981,5.236778131037047,5.66664735476176,4.948040127754211,5.347669117378466,5.930712640285492,5.432457273656672,96225.95454545454,4,5,6,4,4,4,2,1.0,1,1,2,-1,-1,1,-2
4422,5.578199146949139,5.149108341059734,5.619725962275083,4.915811607518147,5.57060810708508,5.956792074380462,5.503711693065682,74372.98969072165,4,E01004536,3,5,5,7,4,4,5.639529959721998,5.146381772377274,5.6534006216309285,4.989350977269086,5.437578520991585,5.948449763384732,5.47038594159213,96097.59090909091,6,4,5,5,6,4,3,1.0,2,1,0,0,-1,0,-1
4423,5.327413242796193,5.286178955824479,5.550735034113345,5.005144427133643,5.43488583046457,5.6920956155528195,5.3364819350449935,72847.60869565218,1,E01004537,5,4,7,3,0,2,5.216081858683033,5.222293830719314,5.508190879300863,5.1678292120204254,5.241731739845596,5.617296064601225,5.303632026960869,94092.64705882352,1,5,3,8,1,0,1,1.0,0,0,-1,1,-2,0,-1
4424,5.269240818771661,5.283527340374741,5.483273803019056,4.996089666497474,5.329164367096097,5.680495837155511,5.228811808660919,77241.72549019608,1,E01004538,5,3,6,1,0,0,5.358681595441207,5.1891281419587365,5.590908829448293,4.9664383362797855,5.2953373297904305,5.809566338085434,5.3940095392245695,100149.16504854368,2,4,4,5,2,2,2,1.0,1,-1,1,-1,1,2,2
4425,5.378554288297892,5.298665966838598,5.6087857236464815,5.001664689431588,5.337033075590928,5.792848624289036,5.249192745735248,71544.04166666667,2,E01004539,5,5,7,2,1,1,5.327838069200515,5.242523634433747,5.554912693500519,5.086595346927643,5.297702203989029,5.71043035030365,5.366919456720352,92541.81,2,5,4,7,3,0,1,1.0,0,0,-1,0,1,-1,0
4426,5.662354243298371,4.99246411356661,5.9163231154282885,4.803740777075291,5.570466188920869,5.994936702979936,5.503540853659312,73737.81944444444,5,E01004540,1,8,3,7,4,4,5.595498821161089,5.0691512762195,5.73091935937422,4.938227726595245,5.544796600829076,5.9303778557881826,5.4611622617192515,94987.65693430656,5,2,7,4,8,4,3,1.0,0,1,-1,1,1,0,-1
4427,5.384505331516266,5.187413189722144,5.694970815078072,4.924302001362261,5.369720995426178,5.851799317028211,5.338018429020177,76788.36956521739,2,E01004541,3,6,5,2,2,2,5.2484003264328525,5.14117433970002,5.60861193722692,5.105372576877989,5.3032610937096605,5.795277622924454,5.357225052241621,98788.9540229885,1,3,5,7,3,1,1,1.0,-1,0,-1,2,1,-1,-1
4428,5.9611277666091915,5.018671841621399,5.968971877098084,4.631065896987915,5.556551497459411,6.3082188053131105,5.768432003974914,78166.64,8,E01004542,1,9,0,6,9,8,5.836472079638512,4.930985266162503,5.9223095409331785,4.746758095679745,5.461814574656948,6.240222080099967,5.81575999721404,100479.90322580645,8,1,9,1,7,9,8,1.0,0,0,0,1,1,0,0
4429,6.134370272304849,4.949061844083998,5.965076755879173,4.609464313821554,5.737487625477562,6.372074549343424,5.907324879827465,78604.23655913978,9,E01004543,1,9,0,9,9,9,6.133080242216125,4.839274171710938,5.997168851453204,4.652854455533878,5.6923087863034985,6.392332052999689,5.927684266437856,101019.22480620156,9,0,9,0,9,9,9,1.0,0,-1,0,0,0,0,0
4430,6.116260018068202,4.837113576776841,6.095387029647827,4.571649702857522,5.643072031526005,6.582170694014605,5.881775637233958,73744.18823529412,9,E01004544,0,9,0,8,9,9,6.0187951935098525,4.759717621701829,6.091453311291147,4.65479816908532,5.448946227418616,6.3855177290896155,5.934699350215019,94853.74468085106,9,0,9,0,6,9,9,1.0,0,0,0,0,-2,0,0
4431,5.551430045930963,4.974618417338321,5.7937340836775935,4.807331159240321,5.40904473756489,6.084161823674252,5.571012143084878,69765.24210526315,4,E01004545,1,7,3,3,6,5,5.572797951698303,4.931765817403793,5.832915568351746,4.86032280921936,5.47294219493866,6.097317793369293,5.680324105024337,90244.24,5,1,8,2,7,7,7,1.0,1,0,1,-1,4,1,2
4432,6.0640141649560615,4.895662821256197,6.072024201298808,4.604274918744852,5.723666560518873,6.5298100644415555,5.879485330738864,76796.59340659341,9,E01004546,0,9,0,9,9,9,6.128209057607148,4.8020124780504325,6.136895719327424,4.607018514683372,5.533552050590515,6.568017827837091,6.089027417333503,98958.19736842105,9,0,9,0,8,9,9,1.0,0,0,0,0,-1,0,0
4433,6.215501140145695,4.836669599308687,6.0758622043273025,4.546936419080286,5.710780350600972,6.495471242596121,5.956236923442168,77951.36764705883,9,E01004547,0,9,0,9,9,9,6.036335107646411,4.8404211847088,5.973616551749314,4.602299593671968,5.631572922573814,6.386878230903722,5.965746524967725,99656.78481012658,9,0,9,0,9,9,9,1.0,0,0,0,0,0,0,0
4434,5.601740377758621,5.066072825991779,5.751604756084057,4.7978683841337855,5.55315960219147,6.008666535036279,5.540492062174946,74470.87155963303,4,E01004548,2,7,3,6,5,5,5.745319358327172,4.869311358892556,5.809962332248688,4.834708845073527,5.472674435738361,6.161463820573055,5.669603420026375,95815.0303030303,7,0,8,2,7,8,6,1.0,3,-2,1,-1,1,3,1
4435,6.010477267079434,4.824519000821194,6.002581854998055,4.596220748909449,5.6255222074056075,6.395536345950628,5.93903851104995,79099.84745762713,8,E01004549,0,9,0,8,9,9,5.97223326050002,4.761100495683736,6.0626387698897,4.640749151336736,5.673940541415379,6.390262979885628,5.976700282302396,101560.53448275862,9,0,9,0,9,9,9,1.0,1,0,0,0,1,0,0
4436,6.028729592378323,4.921669287177233,5.8932705624745445,4.582720755384519,5.6348102918038006,6.2887419416354255,5.819464935706212,76729.29807692308,8,E01004550,0,8,0,8,9,9,5.874647169063489,4.9901701758305235,5.825643661121528,4.791120340426763,5.49427751203378,6.186916843056679,5.793118740121524,98350.35416666667,8,1,8,1,7,8,8,1.0,0,1,0,1,-1,-1,-1
4437,5.405047272858412,4.993196662353433,5.768349834110426,4.987636128197545,5.411288699378138,5.816721579302913,5.529373527868934,73675.94565217392,2,E01004551,1,7,6,3,2,5,5.40449114598726,4.801245374428598,5.839542489302786,5.013475556122629,5.376244366796393,5.842640590667725,5.522276710209094,95140.81052631579,3,0,8,6,4,2,4,1.0,1,-1,1,0,1,0,-1
4438,5.539439762595796,4.7715801496575345,6.083996720557665,4.8772739476531095,5.519874482259263,6.019426436319838,5.558092380962233,73984.51824817518,4,E01004552,0,9,4,6,5,5,5.503177836224749,4.744218275263593,6.020301870532803,4.8873711390928785,5.4156068338380825,5.955839487222525,5.745159932783434,95523.68531468531,4,0,9,3,5,4,8,1.0,0,0,0,-1,-1,-1,3
4439,5.856178951590029,5.064069485827668,5.834193061475885,4.693760559166948,5.6267574225386525,6.185410422821567,5.672024552136252,74598.04794520549,7,E01004553,2,8,1,8,8,7,5.829030255613656,4.980589126718455,5.7435780352559584,4.751913786756582,5.487999204109455,6.065316917156351,5.74906415117198,96226.75862068965,8,1,7,1,7,6,8,1.0,1,-1,-1,0,-1,-2,1
4440,6.268972266382641,5.08507679634624,5.909527497821384,4.543470710515976,5.843553966283798,6.417212392224206,5.890139375792609,74051.8111111111,9,E01004554,2,8,0,9,9,9,6.252062089959083,4.914827961670725,5.932074168969316,4.594816548782482,5.671263177492465,6.338307620489109,5.947920372611598,95505.1812865497,9,1,9,0,9,9,9,1.0,0,-1,1,0,0,0,0
4441,6.286003613274945,4.844344584409856,6.05447325824706,4.4226227456873115,5.7198225663713185,6.591020142736514,5.885923923539721,73458.09917355372,9,E01004555,0,9,0,9,9,9,6.2216035768167295,4.804563266127857,6.001655802797916,4.425787425752896,5.488581890490518,6.492464878665867,5.907694763212062,95117.70149253731,9,0,9,0,7,9,9,1.0,0,0,0,0,-2,0,0
4442,5.807824511940662,4.980334181051988,6.0300715153033915,4.723176397956335,5.479167195466848,6.307961420370982,5.716952305573684,75244.85576923077,7,E01004556,1,9,1,5,9,7,5.855052476180227,4.801544372658981,5.96338018367165,4.710372488122237,5.410901754780819,6.272461728045815,5.7853789204045345,96808.98947368421,8,0,9,0,5,9,8,1.0,1,-1,0,-1,0,0,1
4443,5.945675948653558,4.875355433936071,5.9958248692329486,4.7029772129925815,5.687495773488825,6.413203485084303,5.770883356681978,75464.78787878787,8,E01004557,0,9,1,9,9,8,5.860884880800859,4.8337663762066345,5.973586200574123,4.649277602860687,5.5276817313028035,6.236330452315304,5.788849583459557,97162.10091743119,8,0,9,0,8,9,8,1.0,0,0,0,-1,-1,0,0
4444,5.9267309160314054,4.987350766475384,5.8319720386439915,4.665167345959916,5.602915128072103,6.305976533482218,5.67020255785722,77837.51282051283,8,E01004558,1,8,1,7,9,7,5.830611625739507,4.957776684420449,5.839250584159578,4.7669670794691354,5.4379954176289695,6.16445780311312,5.711506098508835,100024.85714285714,8,1,8,1,6,8,7,1.0,0,0,0,0,-1,-1,0
4445,6.3599049370698255,4.902868294956709,6.060054275724623,4.528577452958232,5.865981058640913,6.505343020564378,6.0434796256248395,79111.74747474748,9,E01004559,0,9,0,9,9,9,6.260708347119783,4.846307447082118,6.121052646636963,4.5943511147248115,5.63704255505612,6.435813692996376,5.984630870819092,101611.08421052631,9,0,9,0,9,9,9,1.0,0,0,0,0,0,0,0
4446,5.970534381209587,4.9679455197587306,5.864135461802385,4.771263962497517,5.639481937398716,6.144843386144054,5.708208590745926,72927.72959183673,8,E01004560,1,8,2,8,7,7,5.942527274472998,4.973521401575946,5.798265492150543,4.663969569249985,5.5317897725542755,6.128284285921569,5.7744428285764995,94244.55963302753,9,1,8,0,8,7,8,1.0,1,0,0,-2,0,0,1
4447,4.9809270564890475,5.4940901972442004,5.270231309689973,5.30895179196408,5.135796237275232,5.512692906860584,5.024218237055988,68453.93039049236,0,E01004562,8,0,9,0,0,0,4.927317605149455,5.348985850811005,5.3421235909549205,5.347004494289073,5.089095223967622,5.478494641620938,5.279752318088601,88779.18902439025,0,7,1,9,0,0,0,1.0,0,-1,1,0,0,0,0
4448,5.601191203336458,5.172618337579675,5.729152867922911,4.739646447671427,5.4476988557222725,5.854774096527615,5.429150718289453,71598.08108108108,4,E01004563,3,6,2,4,2,3,5.537782121349025,5.0295410124031275,5.702839867488758,4.92031634015006,5.362889415508992,5.821718053237812,5.407107939591279,92631.14864864865,4,2,6,4,4,2,2,1.0,0,-1,0,2,0,0,-1
4449,5.388857614027487,5.1798222722233955,5.531102086402274,5.073865719099302,5.361745857548069,5.753778117411845,5.3150809043162575,70742.85945945946,2,E01004564,3,3,8,2,1,1,5.304744065386577,5.219904169874284,5.451517483563099,5.149283060749758,5.249556744561612,5.682867216832429,5.33384107848973,91617.5,2,5,2,8,2,0,1,1.0,0,2,-1,0,0,-1,0
4450,5.710266126970355,4.8959748676519075,5.9022027157140124,4.705163194802389,5.530144645836935,6.160488037401409,5.6073510817933885,70996.23923444976,6,E01004565,0,8,1,6,7,6,5.680661643451115,4.8816144511384785,5.760720183264534,4.784418411974637,5.4828333011213335,6.10121954387089,5.563325206063828,91907.68867924529,6,0,7,1,7,7,4,1.0,0,0,-1,0,1,0,-2
4451,5.992062964996734,4.937842288574615,5.919711286371404,4.62369247845241,5.604908549940431,6.262400989408617,5.787133817548876,71796.38961038961,8,E01004566,0,8,0,7,8,8,5.822041032449254,5.02529968855516,5.79810516339428,4.659644722938538,5.6398414182213115,6.064706460484919,5.748347366755864,92850.01886792453,8,2,8,0,9,6,8,1.0,0,2,0,0,2,-2,0
4452,5.001845334515427,5.560067612113374,5.329546202312816,5.22729529395248,5.183349556995161,5.544824872956132,5.065011150909193,70609.0,0,E01004567,9,1,9,0,0,0,5.071286556426059,5.356914273808512,5.339785932155138,5.261473223064723,5.1298196476497,5.558646480688888,5.0513616612788,91326.44943820225,0,7,1,9,0,0,0,1.0,0,-2,0,0,0,0,0
4453,5.67234736945894,5.36657626496421,5.412460724512736,4.944044269455803,5.468299580944909,5.822377308209737,5.412105003992717,94647.6888888889,5,E01004568,6,2,6,4,2,3,5.743396995244203,5.357858380785695,5.417245282067193,4.918691135115093,5.435146968673776,5.8736482969036805,5.472109565028438,121542.85185185185,7,7,1,4,6,3,3,1.0,2,1,-1,-2,2,1,0
4454,5.73866677347989,5.295711697741626,5.538157446499177,4.907699176334442,5.509659914409413,5.914262683633814,5.420745840684615,93434.88770053476,6,E01004569,5,3,5,5,3,3,5.679337889360626,5.253491662746102,5.506168734973373,4.88720735111927,5.512214284676772,5.959424079273621,5.540531776070055,119456.21719457014,6,5,3,3,8,4,4,1.0,0,0,0,-2,3,1,1
4455,5.601058142525809,5.458000731158566,5.487953278925512,4.865232472295885,5.519047684483714,5.849076478512256,5.3760737583234715,93489.1038961039,4,E01004570,8,3,4,6,2,2,5.45451087716185,5.287241139529664,5.435760205174669,5.044405124805592,5.383066913227976,5.867129576059035,5.269735509966627,119465.13580246913,3,6,2,6,5,3,0,1.0,-1,-2,-1,2,-1,1,-2
4456,5.697531748603988,5.239966021789299,5.680278817375938,4.867959829477163,5.572506345235384,5.883683353989989,5.478386936606942,93457.76923076923,5,E01004571,4,6,4,7,3,4,5.498638363445506,5.374771572962529,5.503539930872557,4.968357452825338,5.327184959619987,5.868043572962785,5.406193645060563,119438.6218487395,4,7,3,5,3,3,2,1.0,-1,3,-3,1,-4,0,-2
4457,6.01954634376268,5.426184042492795,5.21266880790534,4.795259468496058,5.507438311373212,5.852650784937088,5.484003283375099,93180.48754448399,8,E01004572,7,0,3,5,2,4,6.045777131129314,5.432657434059693,5.429108227337445,4.705761951369208,5.520471953772926,5.9974665913853915,5.551431195871966,119020.0,9,8,2,0,8,5,4,1.0,1,1,2,-3,3,3,0
4458,5.659341023056595,5.471548605318422,5.241385435528225,4.989887922781485,5.340763417349922,5.746188440676089,5.347352982980234,86596.81925925925,5,E01004573,8,0,6,2,1,2,5.67156416304568,5.4952783061468855,5.306779142706953,4.921340654188014,5.332196161785024,5.8296197424543665,5.416413786880513,110021.07978723405,6,9,0,4,3,2,2,1.0,1,1,0,-2,1,1,0
4459,5.9071644809510975,5.3503962606191635,5.590405560202068,4.871271123488744,5.686883823739158,6.057574056916767,5.4180488387743635,95134.55555555556,8,E01004574,6,4,4,9,6,3,5.695100714763005,5.353299302714212,5.477383278665089,4.834785146372659,5.550919163794744,5.92239879426502,5.388751840307599,121909.55952380953,6,7,2,2,8,4,1,1.0,-2,1,-2,-2,-1,-2,-2
4460,5.671627661684057,5.333205853189741,5.348721385002136,4.8587420504171766,5.511609468486283,5.7842838279493565,5.333688401913905,91284.97252747252,5,E01004575,6,1,4,5,1,1,5.497559412105663,5.408768465067889,5.344233840220683,5.0312303736403186,5.32080643112595,5.76036330815908,5.398195039259421,116541.49189189188,4,8,1,6,3,1,2,1.0,-1,2,0,2,-2,0,1
4461,5.8117133703361565,5.352174768642503,5.513155692288665,4.818168885853826,5.535546532293567,5.927682537610839,5.4288475099875,94755.38775510204,7,E01004576,6,3,3,6,3,3,5.777545222265278,5.303042404665918,5.479752259340115,4.840014816758162,5.553684754999812,5.856457645307758,5.526938187861871,121306.41317365269,7,6,2,2,8,2,4,1.0,0,0,-1,-1,2,-1,1
4462,5.963047540076425,4.911228040668452,5.99442451468138,4.706251142180968,5.679506782059358,6.176207003192367,5.743434703238656,75727.3738317757,8,E01004577,0,9,1,9,7,8,5.810296055849861,4.94277111081516,5.927294958339018,4.723487048990586,5.530465019450468,6.078742254481596,5.741942519300125,97546.18823529412,8,1,9,0,8,7,7,1.0,0,1,0,-1,-1,0,-1
4463,5.723358048333062,5.0128072864479485,5.880465476601212,4.763212340849417,5.626497295167711,6.1803355503965305,5.58954033697093,76048.75,6,E01004579,1,8,2,8,7,6,5.6264762604822876,4.90851592822153,5.8809525790761725,4.822663516294761,5.450090349697676,6.028490859954084,5.6319198452058385,97871.69672131147,6,1,8,2,6,6,6,1.0,0,0,0,0,-2,-1,0
4464,5.378137774245683,5.073112363039061,5.769086413605269,4.8544949334721235,5.457463405853094,5.875505017679791,5.320752487626186,76464.97674418605,2,E01004580,2,7,4,4,2,1,5.382895449797313,5.075896802047889,5.731798914571603,4.918223541229963,5.2848051860928535,5.818423360586166,5.399420275042455,98399.08333333333,3,2,7,4,2,2,2,1.0,1,0,0,0,-2,0,1
4465,5.477683758390123,5.187743577404299,5.684039554734161,4.785599271456401,5.4295843753261845,5.875162908996361,5.464651515518409,76854.26086956522,3,E01004581,3,6,3,3,2,3,5.524476172129313,5.039508876800537,5.724480622609456,4.955444893836975,5.354576681454977,5.9274880997339885,5.499199867248535,98883.37333333334,4,2,7,4,4,4,3,1.0,1,-1,1,1,1,2,0
4466,5.748050630445311,4.9525683448159485,5.83978796005249,4.7011499701167,5.522918334374061,6.091975065378042,5.613294131657075,75874.89349112425,6,E01004582,1,8,1,6,6,6,5.719675758149889,4.965365649594201,5.930673782030741,4.751876400576697,5.507748765415616,6.129493130577935,5.655770622359382,97710.4,7,1,9,1,8,7,6,1.0,1,0,1,0,2,1,0
4467,5.413126377043901,5.266680869791243,5.703826737624627,4.910691425756172,5.45966261404532,5.904555676160036,5.446537418497933,76627.66666666667,2,E01004583,5,6,5,4,3,3,5.520363035502735,5.074194373311223,5.72764270370071,4.917232872129561,5.373096064404324,5.8900504026327045,5.51117386796453,98553.41441441441,4,2,7,4,4,3,3,1.0,2,-3,1,-1,0,0,0
4468,5.730404799325125,5.255765237127032,5.6173342500414165,4.8228114094053,5.645377288545881,5.884202752794538,5.579247781208584,76264.68571428572,6,E01004584,4,5,3,8,3,5,5.569959289149234,5.1442907483954174,5.6641765644675806,4.909289363183473,5.479342077907763,5.867231588614614,5.27462815610986,98155.52631578948,5,3,6,3,7,3,0,1.0,-1,-1,1,0,-1,0,-5
4469,5.697470121696347,4.916889535599068,5.932282979371117,4.759826507724699,5.530472566846941,6.083385257447352,5.577506498235171,72834.81147540984,5,E01004585,0,9,2,6,6,5,5.669026440223761,4.867941776208118,5.8921135083764,4.870052409383048,5.428980622671347,6.100887752212254,5.716197006470334,94145.53097345133,6,0,8,3,6,7,7,1.0,1,0,-1,1,0,1,2
4470,6.174139474232992,4.746296920776367,6.150983556111654,4.638714121182759,5.764528020222982,6.505843343734742,5.973074131011963,73467.01333333334,9,E01004586,0,9,0,9,9,9,6.094110790263401,4.792432081833314,6.047049487574717,4.645759617344717,5.610618713196744,6.42034070947197,6.070005415530687,94900.89887640449,9,0,9,0,9,9,9,1.0,0,0,0,0,0,0,0
4471,6.009907279876953,4.834292045299043,5.937523926826233,4.621302339624851,5.512999225170054,6.333126377552114,5.79562180980723,73284.77659574468,8,E01004587,0,9,0,5,9,8,5.9121789030668115,4.848938674485984,5.971689598900931,4.6982939283387,5.519741307787535,6.316733119868431,5.762889182868124,94698.7731092437,8,0,9,0,8,9,8,1.0,0,0,0,0,3,0,0
4472,5.757748978607582,4.8952632826386075,5.904211141846397,4.77752835913138,5.475638384168798,6.175899236491232,5.640666145266908,73629.20454545454,6,E01004588,0,8,2,4,7,6,5.8612484432318634,4.651962173335693,5.964596881585963,4.744159975472619,5.468706011772156,6.259665873120813,5.796544536948204,95110.0955882353,8,0,9,1,7,9,8,1.0,2,0,1,-1,3,2,2
4473,6.06241754895633,4.795308226162625,6.098194171472923,4.699131003360159,5.63394954278297,6.4413541248164226,5.844094780302539,73240.75257731958,9,E01004589,0,9,1,8,9,9,6.083000280857086,4.782848809957504,6.218245270252228,4.688358461856842,5.558191168308258,6.475776739120484,6.006315040588379,94625.53,9,0,9,0,8,9,9,1.0,0,0,0,-1,0,0,0
4474,5.51579925373419,5.135811326219074,5.697099991698764,4.87381419761857,5.436729110888581,5.901305168422301,5.31651822310775,71564.73880597015,3,E01004590,3,6,4,3,3,1,5.448341123203733,5.081112440842301,5.595859634342478,4.934082854149946,5.261690168238398,5.8965213601268935,5.482995515439048,92613.9104477612,3,2,4,4,2,3,3,1.0,0,-1,-2,0,-1,0,2
4475,5.417378037878611,4.977838553271248,5.85084163100974,4.865714258360631,5.480928220795196,5.914807532597514,5.405472595714828,72442.03883495145,2,E01004591,1,8,4,5,3,2,5.461030429915378,4.961805251606724,5.801098083194933,4.87262480405339,5.367746493272614,5.881341689511349,5.550795219446483,93694.58771929824,4,1,8,3,4,3,4,1.0,2,0,0,-1,-1,0,2
4476,5.96634672852013,4.779028533950565,6.034248059190165,4.609437006665027,5.718144506920041,6.1870000287303775,5.662362283609045,71763.5748031496,8,E01004592,0,9,0,9,8,7,5.822997492902419,4.816311638144886,5.87839813618099,4.734158345005092,5.512377990519299,6.149447697050431,5.715569439179757,92853.71323529411,8,0,8,0,8,8,7,1.0,0,0,-1,0,-1,0,0
4477,5.489706042097576,5.169461760947954,5.665917489066053,4.91891790948697,5.400338274329456,6.024583504271152,5.366492987568699,97718.9328358209,3,E01004593,3,5,5,3,5,2,5.502118292862807,5.005764998071562,5.746071918223931,4.889261061583108,5.330013210211343,6.057094252206446,5.577858345295356,124990.59349593495,4,2,7,3,3,6,5,1.0,1,-1,2,-2,0,1,3
4478,6.138374219621931,4.869879730542501,6.011978871481759,4.521679022198632,5.651832623708816,6.4925779796782,5.903498725664048,98040.65714285715,9,E01004594,0,9,0,8,9,9,5.982614274336913,4.79591147364857,6.004154512815386,4.603261136563025,5.533876414610961,6.524448827048328,6.089429276011814,125375.44859813084,9,0,9,0,8,9,9,1.0,0,0,0,0,0,0,0
4479,5.651614386459877,5.202916489592914,5.762563945918248,4.822473049163818,5.471227703423335,6.0936024147888705,5.428367027948642,97396.68965517242,5,E01004595,4,7,3,4,6,3,5.480236802219359,5.106736807783773,5.611358043576075,4.927047750181403,5.250133556767929,6.03413510519611,5.637601059330397,124662.74380165289,4,3,5,4,2,6,6,1.0,-1,-1,-2,1,-2,0,3
4480,6.037337229720184,4.7923888723765105,6.157864628093583,4.504039398261479,5.704327417271478,6.612685269543102,5.855496064892837,97459.90178571429,8,E01004596,0,9,0,9,9,9,5.988856348217043,4.7484354290187865,6.084771337672176,4.562657392941988,5.490376967650193,6.570565264449161,5.977776458120753,124727.57264957266,9,0,9,0,7,9,9,1.0,1,0,0,0,-2,0,0
4481,6.05886507618661,4.874537377965217,6.053792895055285,4.5759131639611486,5.6795601260428334,6.541358709335327,5.961114800443836,97166.61764705883,9,E01004597,0,9,0,9,9,9,5.9632400356897035,4.9187721521547525,5.924550495525398,4.587012986145397,5.47187323381405,6.458346484911324,5.938647421279756,124372.34653465346,9,1,9,0,7,9,9,1.0,0,1,0,0,-2,0,0
4482,5.988945307402775,5.0406712776628035,5.898663580417633,4.627201633206729,5.596262875302084,6.413026114989972,5.7956084865948245,96418.70689655172,8,E01004598,1,8,0,7,9,8,5.937424910479579,4.949632804969261,5.968504293211575,4.645902100308188,5.49527024195112,6.413803455130807,5.9361262783922,123494.31896551725,9,1,9,0,7,9,9,1.0,1,0,1,0,0,0,1
4483,6.4715935460158756,4.7163226036798385,6.237381253923688,4.249879594360079,5.8726990308080405,6.818934227739062,6.111253451733362,97180.59523809524,9,E01004599,0,9,0,9,9,9,6.301889599823371,4.629386627092594,6.102644152757598,4.426384107368748,5.7149414172986654,6.765333588530377,6.183892785049066,124407.12195121951,9,0,9,0,9,9,9,1.0,0,0,0,0,0,0,0
4484,5.160758927945168,5.298175034984466,5.412859416777088,5.116069601428125,5.175508253036007,5.659654451954749,5.268248763776595,96370.12903225806,0,E01004600,5,2,8,0,0,1,5.228052763377919,5.1158632671131805,5.546393979998196,5.234492459717919,5.141572764691184,5.664496597121744,5.5238328874111176,123126.08823529411,1,3,3,9,0,0,4,1.0,1,-2,1,1,0,0,3
4485,5.532851100328106,5.249168187109725,5.584226858219711,4.899017756078899,5.467092209352107,5.98188281779563,5.484480407662982,97022.2416918429,3,E01004601,4,4,5,4,4,4,5.38520313231718,5.150420660773913,5.628869390203839,4.966921513279279,5.304604438798768,5.930790772040685,5.598722003045536,124240.68452380953,3,4,5,5,3,4,5,1.0,0,0,1,0,-1,0,1
4486,5.786849162795327,5.037303768504749,5.944883871078491,4.69184145602313,5.54942705522884,6.182530387965116,5.746470122987573,90258.52727272727,6,E01004602,1,9,1,6,7,8,5.766273410380387,4.87564582584285,5.900279503910482,4.773365405427308,5.513870950506515,6.121777852042382,5.763692280825446,115228.9075630252,7,0,9,1,8,7,8,1.0,1,-1,0,0,2,0,0
4487,6.25120359541166,5.047111016688961,5.740560125596453,4.600666658713086,5.702338994139492,6.339596440296362,5.804470030978175,88904.01485148515,9,E01004604,1,7,0,9,9,8,6.16949730945958,5.062438265592964,5.757293865636543,4.585629350057355,5.61111779069459,6.257408521793507,5.847042450198421,113488.99074074074,9,2,7,0,9,9,9,1.0,0,1,0,0,0,0,1
4488,5.7315303875849795,5.136126993252681,5.594319041875693,4.838912873084729,5.494535193993495,6.011111092567444,5.490327178514921,88073.13846153846,6,E01004605,3,4,4,5,5,4,5.702912947710822,5.138894960284233,5.671573675730649,4.834573417025454,5.395081094082664,6.000858047429253,5.591731378260781,112400.94117647059,7,3,6,2,5,5,5,1.0,1,0,2,-2,0,0,1
4489,5.620584311564107,5.043433372639427,5.8102000636502735,4.805289991630995,5.457977170786582,6.102353340338085,5.482377422742607,88206.69421487603,5,E01004606,1,7,3,4,6,4,5.610613734703365,4.883380665553837,5.835349458409107,4.843062581978445,5.345268647501788,6.1314458659314734,5.598946092635628,112605.43307086614,5,0,8,2,4,8,5,1.0,0,-1,1,-1,0,2,1
4490,5.937855428173428,4.9903070198165045,5.863661361119104,4.739320657556019,5.55438318517473,6.180959075216263,5.673123824217963,89127.3253968254,8,E01004607,1,8,2,6,7,7,5.868886536925379,4.918679819489918,5.768784643089684,4.740247213927499,5.510653579322091,6.197485252018392,5.719171891247269,113772.95620437956,8,1,7,1,8,8,7,1.0,0,0,-1,-1,2,1,0
4491,5.534476159648462,5.061852566220543,5.7852158790284935,4.893659720366651,5.487633457238024,5.992998450994492,5.503687511790883,88734.875,4,E01004608,2,7,5,5,4,4,5.490821808883824,5.05693753970038,5.7224680025552965,4.914167299713056,5.371895997794633,5.895872600299796,5.5179356742151,113300.45360824742,4,2,7,3,4,3,4,1.0,0,0,0,-2,-1,-1,0
4492,5.537076389634764,4.724647057520879,6.006958416530064,4.85713805858191,5.5219955506262846,6.1120374156283095,5.565838893512627,89729.57142857143,4,E01004609,0,9,4,6,7,5,5.48659737083499,4.824970340595565,5.930491116459809,4.880726480617204,5.461082923345725,5.9854702430064455,5.6324383706353895,114434.92737430168,4,0,9,3,7,5,6,1.0,0,0,0,-1,1,-2,1
4493,5.398586750030518,5.146503131166637,5.657260057737502,4.859388037551221,5.4543890249814915,6.092587627095284,5.410719639963383,79540.30935251799,2,E01004610,3,5,4,4,6,3,5.473748342807476,4.986506965527168,5.731509674512423,4.88194488286972,5.391892510194045,6.079998416167039,5.491315893943494,102081.67692307693,4,1,7,3,5,7,3,1.0,2,-2,2,-1,1,1,0
4494,5.737480806893315,4.935097717005631,5.905035540975374,4.689565220783496,5.6030526654473665,6.3413876480069655,5.656133555132767,77968.66379310345,6,E01004611,0,8,1,7,9,7,5.709628959672641,4.843292982177397,5.876464904937069,4.799492542722584,5.491532104205241,6.2971352813518156,5.6236935706265205,100213.50442477876,7,0,8,1,7,9,6,1.0,1,0,0,0,0,0,-1
4495,5.352513250850496,5.037191898482186,5.855516127177647,4.895018141610282,5.41836135273888,6.071940889812651,5.497034701846895,79008.37142857142,2,E01004612,1,8,5,3,6,4,5.321514791091986,4.9648766918519955,5.771450423561366,4.995775666912045,5.361530825100114,5.958665822459533,5.54468102687228,101432.89380530974,2,1,7,5,4,4,4,1.0,0,0,-1,0,1,-2,0
4496,5.394770798429978,4.993122025928666,5.819178594952136,4.87535721854826,5.460185072063345,6.099717893431672,5.517647274827535,78840.1592920354,2,E01004613,1,7,4,4,6,4,5.45182667760288,4.948270608397091,5.879320627501031,4.898872920445034,5.431408816025037,6.055126484702615,5.510184849009795,101236.02521008403,3,1,8,3,6,6,3,1.0,1,0,1,-1,2,0,-1
4497,5.478596378977482,5.181882604956627,5.777004358860163,4.946406116852393,5.408871758442658,6.036841534651243,5.426504875604923,80514.28846153847,3,E01004614,3,7,6,3,5,3,5.355212178495195,5.1908387447160385,5.6598118051650035,4.990333670661563,5.1994899823552085,5.937721787937104,5.440234925065722,106155.8253968254,2,4,6,5,1,4,2,1.0,-1,1,-1,-1,-2,-1,-1
4498,5.6133960815576405,5.098548916669992,5.6342859653326185,4.851190078258514,5.532652543141292,6.031245026221642,5.508691540131202,80502.58461538462,4,E01004615,2,5,4,6,5,4,5.498631997074154,5.097665923104869,5.583810686207504,4.97249169744176,5.357045698508942,5.980337798166618,5.60933000406773,103301.0,4,3,4,5,4,5,5,1.0,0,1,-1,1,-2,0,1
4499,5.416718312849601,5.092769522219896,5.761645572880904,4.904292141397794,5.327800497412682,6.0300794293483095,5.322381604462862,86813.98958333333,2,E01004616,2,7,5,1,5,1,5.4290906444508975,5.075648302727557,5.78665748048336,4.861034742061128,5.2000549778025205,5.998074341327586,5.4490267000299815,112243.53191489361,3,2,7,2,1,5,2,1.0,1,0,0,-3,0,0,1
4500,5.528339111464364,5.097021953719003,5.664673557281494,4.870603003501892,5.488582335880825,5.987902545928955,5.464965049198695,95773.6,3,E01004617,2,5,4,5,4,4,5.384467568851653,5.087061479545775,5.591906409036546,4.996102432409923,5.262102567581904,5.8726106995628,5.471856697400411,123486.88095238095,3,3,4,5,2,3,3,1.0,0,1,-1,1,-3,-1,-1
4501,5.9108269595709,5.098194600128736,5.865678867355722,4.67409300217863,5.570847698899566,6.397911097182602,5.768309002039863,79061.9262295082,8,E01004618,2,8,1,7,9,8,5.6870938862784435,4.93462194426585,5.869489372786829,4.731215904324742,5.512754707013146,6.2433028584819725,5.671654566869897,101539.7627118644,6,1,8,0,8,9,6,1.0,-2,-1,0,-1,1,0,-2
4502,6.335442593652908,4.945976226297144,5.896414505292292,4.431322210455594,5.832922143478916,6.403831540721736,5.917234815963327,79075.3698630137,9,E01004619,1,8,0,9,9,9,6.146621751498027,5.015205486711249,5.777045906308186,4.574515997645366,5.74807503855372,6.328391187162285,5.945819918649742,101363.90361445783,9,2,7,0,9,9,9,1.0,0,1,-1,0,0,0,0
4503,5.9981112632996,4.813852727922619,5.992991583979028,4.5575720591422835,5.623827983171512,6.4016490084493265,5.813524046514789,91760.96581196581,8,E01004620,0,9,0,8,9,9,5.896012796174496,4.8819530732041105,5.8464567945637835,4.67369895790695,5.471726783918678,6.282411546882139,5.809790416595039,116983.3119266055,8,0,8,0,7,9,8,1.0,0,0,-1,0,-1,0,-1
4504,6.216931892022854,5.178336772686098,5.747247429591853,4.630631592215561,5.717321083603836,6.27330000923901,5.839332778860883,78228.29756097561,9,E01004621,3,7,0,9,8,9,6.188145573363711,5.16046429375362,5.71856709339159,4.695604142586746,5.642090158612204,6.253916923240696,5.93812600058825,100801.13452914798,9,4,7,0,9,9,9,1.0,0,1,0,0,0,1,0
4505,5.990144271799859,5.200152402228498,5.659514394212277,4.681646618437259,5.681113839149475,6.180299010682614,5.6568428569651665,80336.1914893617,8,E01004622,3,5,1,9,7,7,6.02674320129433,5.157591964259292,5.663952304859354,4.692513449023468,5.687205813147805,6.136847770575321,5.72374869717492,103006.19191919192,9,4,6,0,9,8,7,1.0,1,1,1,-1,0,1,0
4506,5.986307785196124,4.895593008905087,5.9950154929790855,4.613694339428308,5.609535669380763,6.347831730572683,5.749361336231232,86071.6603773585,8,E01004623,0,9,0,7,9,8,5.882576476959955,4.917025755700611,5.869944088799613,4.685081137929644,5.426252527464004,6.268406086876279,5.887122510728382,109877.60952380953,8,1,8,0,6,9,9,1.0,0,1,-1,0,-1,0,1
4507,5.95466848668151,5.111909551413979,5.761939452389094,4.705510521028924,5.625987807596762,6.2496155228201795,5.745906518200251,82162.03937007874,8,E01004624,2,7,1,8,8,8,5.735889364289873,5.081522339627943,5.601382788811021,4.814137298642224,5.456500507038058,6.158292309928487,5.686375544271396,105138.53816793892,7,2,4,2,7,8,7,1.0,-1,0,-3,1,-1,0,-1
4508,6.292321973011411,5.097209160903405,5.865701478103111,4.5274385550926475,5.790671695511916,6.50279385632482,6.01339290059846,80077.55862068966,9,E01004625,2,8,0,9,9,9,5.947925037807888,5.028501005733714,5.727370305778154,4.7060133226556715,5.6501084371329915,6.32982391625448,5.857864880094342,102721.84967320261,9,2,7,0,9,9,9,1.0,0,0,-1,0,0,0,0
4509,5.975869314792829,5.312630228507213,5.5685251288943824,4.7480416960186425,5.589809571066473,6.101680730143164,5.626004875725151,79911.38034188034,8,E01004626,5,4,2,7,6,6,5.740753251547907,5.244558873714185,5.568099082684984,4.899576778505363,5.505357590376162,6.041498067332249,5.571495484487683,102464.99019607843,7,5,4,3,8,6,5,1.0,-1,0,0,1,1,0,-1
4510,6.0273920377095545,4.879512995481491,6.0316415707270306,4.600475174188614,5.5515377422173815,6.404105313618978,5.855212795734405,85152.56666666667,8,E01004627,0,9,0,6,9,9,5.992206107569105,4.986210718409706,5.958374531214474,4.742620378050185,5.4676511460588175,6.273747615231812,5.847153264147635,108389.22900763359,9,1,9,1,7,9,9,1.0,1,1,0,1,1,0,0
4511,5.452088866525024,5.397251100030564,5.4354253625141755,5.010197603975543,5.428002010774977,5.723740000761192,5.406516092424174,97354.87786259541,3,E01004628,7,2,7,3,1,3,5.6050961738751255,5.361056817902459,5.475645857092775,5.0159691071804655,5.437455942601334,5.872625926394521,5.488051254808167,124494.48765432098,5,7,2,6,6,3,3,1.0,2,0,0,-1,3,2,0
4512,5.966754803786406,5.0799828405315814,5.855235014412854,4.634731713984464,5.723336464649922,6.311647787287429,5.895194987187514,98772.66216216216,8,E01004629,2,8,0,9,9,9,5.79499991656908,5.06896104454215,5.807747178607517,4.7539659535962775,5.62520222726211,6.220856445287567,5.92611483966603,126199.5294117647,7,2,8,1,9,9,9,1.0,-1,0,0,1,0,0,0
4513,5.755170789737146,5.222508267291541,5.657559283728738,4.7895284995292,5.6365498246498476,6.022466002158748,5.563320365924279,94882.73786407767,6,E01004630,4,5,3,8,5,5,5.693444254306646,5.231571759168919,5.612125378388625,4.917600996219194,5.442614725002875,6.000510360185917,5.541478826449468,121329.05769230769,6,5,5,4,6,5,4,1.0,0,1,0,1,-2,0,-1
4514,5.804109034867122,5.350778040187112,5.50814092775871,4.713079615913588,5.575738144331965,5.979176007468125,5.4780028791263184,93385.8275862069,7,E01004631,6,3,1,7,4,4,5.6548658311367035,5.254214814214995,5.5736440673018945,4.902131201642932,5.337212383747101,5.980308736815597,5.429547553712672,119294.68181818182,6,5,4,3,3,5,2,1.0,-1,-1,1,2,-4,1,-2
4515,5.996282031040381,5.002611956974067,5.785651258902974,4.608059575061987,5.722789448086578,6.17280923021902,5.7620949060610025,98738.54455445544,8,E01004632,1,7,0,9,7,8,5.925387256550339,5.058760946651675,5.738382051575859,4.660095679310133,5.462814145493057,6.237300380220953,5.816856623820539,126177.00943396226,9,2,7,0,7,9,8,1.0,1,1,0,0,-2,2,0
4516,5.897852061500012,5.19222746432667,5.614020458409484,4.748582289252482,5.636455126211676,5.990884351058745,5.650794281086451,95784.1690140845,7,E01004633,3,5,2,8,4,7,5.822728076577187,5.284362280368805,5.6538762003183365,4.857305726408958,5.575026905536651,6.007669001817703,5.570854291319847,122203.9875,8,6,5,2,9,5,5,1.0,1,3,0,0,1,1,-2
4517,5.792862373429376,5.322198244365486,5.528376830590738,4.695099492330809,5.583858654305741,5.91886492677637,5.504602019851272,93895.52702702703,7,E01004634,6,3,1,7,3,4,5.838978259703692,5.288275548991035,5.613206568886252,4.7734240363625915,5.549044129427742,5.972810007544124,5.514231189559488,120003.37647058823,8,6,5,1,8,5,3,1.0,1,0,2,0,1,2,-1
4518,5.92376895384355,5.2682056466409986,5.680358577365718,4.723304475634551,5.656284322423383,6.064102811261642,5.680610652797478,94848.52066115703,8,E01004635,5,6,1,8,6,7,5.852084915454571,5.292197776757754,5.585228329438429,4.812736927545988,5.547019771429208,6.040805809314435,5.6018137592535755,121519.71538461538,8,6,4,2,8,6,5,1.0,0,1,-2,1,0,0,-2
4519,5.958414720029247,5.25924015896661,5.604118016301369,4.693585932254791,5.6984333919019114,6.0237992199099795,5.673312041224266,94077.16326530612,8,E01004636,4,4,1,9,5,7,5.892113807201386,5.286505682468414,5.654595923423767,4.826713919639587,5.566923094987869,6.0021569800376895,5.61540192604065,120321.44,8,6,5,2,9,5,5,1.0,0,2,1,1,0,0,-2
4520,5.887782520101976,5.349702126295992,5.455845368924991,4.744184218635855,5.642188234846722,5.879167480986248,5.457964605139208,97129.03100775194,7,E01004637,6,2,2,8,2,3,5.721121111116209,5.344815570157724,5.442822189597817,4.916823735603919,5.417246566785799,5.83293726727679,5.401679390793913,124319.17482517482,7,7,2,4,5,2,2,1.0,0,1,0,2,-3,0,-1
4521,6.2888184332329296,5.015844486329867,6.001584439173989,4.516694509464761,5.756097250658533,6.466260824514472,5.989841630925303,91339.47826086957,9,E01004638,1,9,0,9,9,9,6.0872639457574875,5.040146212258407,5.898144376334962,4.664641055764194,5.675564013029399,6.372511918464916,5.986287726169568,116585.1052631579,9,2,9,0,9,9,9,1.0,0,1,0,0,0,0,0
4522,5.998130847943709,5.162233293456519,5.747100446048199,4.6397577436178326,5.673192465865372,6.179693945302259,5.712655890708001,90411.12080536912,8,E01004639,3,7,0,9,7,7,5.749806800349192,5.229875385761261,5.606563126499003,4.840539100495252,5.415318083356727,6.08422381634062,5.6445571278983895,115398.22727272728,7,5,5,2,5,7,6,1.0,-1,2,-2,2,-4,0,-1
4523,6.048950487420759,5.006771805632205,6.061982063846734,4.62640721652344,5.741554105554828,6.353699500324162,5.860913999208057,90453.69465648854,9,E01004640,1,9,0,9,9,9,5.974022225728111,5.036212050725544,5.847254425760299,4.771672167475262,5.523639840739114,6.267168266432626,5.868654343816969,115414.57936507936,9,2,8,1,8,9,9,1.0,0,1,-1,1,-1,0,0
4524,6.063386562596197,5.0934433543163795,5.818923585311226,4.655236316763836,5.684399013933928,6.342656400929327,5.860144717796989,90775.90434782609,9,E01004641,2,7,1,9,9,9,5.640070331948144,5.258527987343925,5.541217164482389,4.944227973903929,5.426057842799596,6.014481738635472,5.604697932515825,116168.14285714286,6,5,3,4,6,5,5,1.0,-3,3,-4,3,-3,-4,-4
4525,5.852346693447658,5.300041081564767,5.647456177302769,4.825057440485273,5.591020581381661,6.0853922189985,5.606858876773289,92345.18285714286,7,E01004642,5,5,3,7,6,6,5.765624188885246,5.230566969237377,5.584546032640123,4.854366019829032,5.464922989766622,6.093989019541397,5.745533802460149,118162.47422680413,7,5,4,2,7,7,8,1.0,0,0,-1,-1,0,1,2
4526,5.8344069071438005,5.4188810884952545,5.490261194498642,4.825455284636954,5.510240751764049,5.9346775179323945,5.4988748910634415,92335.94565217392,7,E01004643,7,3,3,5,3,4,5.7016139773355015,5.357565768387007,5.51649122134499,4.8678290118341865,5.433646969173266,6.010263180387193,5.541637620200282,117882.49275362318,7,7,3,3,6,5,4,1.0,0,0,0,0,1,2,0
4527,6.033416758120899,5.229197103652596,5.696308290454703,4.6559119717056205,5.6322591371939215,6.158827021648067,5.683288341956519,92456.79812206572,8,E01004644,4,6,1,8,7,7,5.880347127610064,5.256932666961183,5.58591723357532,4.775970106006514,5.582808591795306,6.122649381346736,5.663968470925135,118078.6134751773,8,5,4,1,9,7,6,1.0,0,1,-2,0,1,0,-1
4528,5.9019777245924505,5.334042205776967,5.584168266242658,4.758068512023335,5.582283053599613,6.0958937121109225,5.547917878124076,92355.54225352113,8,E01004645,6,4,2,7,6,5,5.735693934523029,5.31267511991807,5.665547919862064,4.86383205505065,5.583914414600089,6.075322444056288,5.612186113257467,117904.48765432098,7,6,6,2,9,7,5,1.0,-1,0,2,0,2,1,0
4529,6.0783470068659105,5.074604627915791,5.93639914563724,4.680270036629268,5.648877264772143,6.255966803005763,5.832840977396284,527685.6357142857,9,E01004646,2,9,1,8,8,9,5.942319575994293,5.0608039114372865,5.837813781082996,4.818703102919222,5.497425351406168,6.124351428330311,5.766225086399382,673485.1104294478,9,2,8,2,7,7,8,1.0,0,0,-1,1,-1,-1,-1
4530,5.892863725793773,5.035150472049056,5.831588232106176,4.76582456210564,5.572847476498834,6.122916642550765,5.661472383038751,526833.7655172413,7,E01004647,1,8,2,7,7,7,5.762831624990665,5.043190828761699,5.758551415449344,4.894764250109655,5.421756626656337,6.018291919127755,5.718253168260088,672573.5776397516,7,2,7,3,6,6,7,1.0,0,1,-1,1,-1,-1,0
4531,5.9917030601027585,5.031734120771752,5.916285360822026,4.705661008817069,5.655479831725174,6.193536460769843,5.790373919913487,486669.900621118,8,E01004648,1,8,1,8,8,8,5.787642908973928,5.042896852171494,5.8744565899386725,4.800466456296253,5.486506000618262,6.055123977865909,5.714056953330712,632981.7914110429,7,2,8,1,7,6,7,1.0,-1,1,0,0,-1,-2,-1
4532,5.862379764857358,5.030197805737796,5.848378812613553,4.732978682811946,5.640903564348613,6.029142616546317,5.732088756071378,527077.0616438356,7,E01004649,1,8,2,8,5,8,5.7411434426903725,5.083637045323849,5.7784328132867815,4.983447531610727,5.43644804507494,5.956731732189655,5.6828938238322735,672771.7,7,3,7,5,6,4,7,1.0,0,2,-1,3,-2,-1,-1
4533,5.942924439907074,4.949800010650389,6.024799735315384,4.701957677641222,5.628091848665668,6.185500283395091,5.7867650014738885,309707.3629032258,8,E01004650,1,9,1,8,8,8,5.801486705478869,4.896771978913692,5.927420020103455,4.808246126300411,5.479071662091372,6.063499044953731,5.795559556860673,359771.84210526315,8,0,9,2,7,6,8,1.0,0,-1,0,1,-1,-2,0
4534,5.8176039005148,4.955955694461691,5.898602826841946,4.710130323623789,5.670877020934532,6.167750120162964,5.7295821720156175,430265.3620689655,7,E01004651,1,8,1,8,7,8,5.897880546117233,5.005760209035065,5.947022462295274,4.798740502131188,5.530224998118514,6.164666297072071,5.844717437938108,516705.5423728814,8,2,9,1,8,8,9,1.0,1,1,1,0,0,1,1
4535,5.711653522082737,4.776061165900457,6.012456326257615,4.839459129742214,5.5361659441675455,6.023782622246515,5.699956136090415,136263.7857142857,6,E01004652,0,9,4,6,5,7,5.517855243249373,4.797191668640483,5.91789136691527,4.801678175275976,5.46239438382062,5.912106763232838,5.928558268330314,172191.56818181818,4,0,9,1,7,3,9,1.0,-2,0,0,-3,1,-2,2
4536,5.776271091567145,4.861282544665866,6.0799745162328085,4.707849560843574,5.547666594717238,6.19143467479282,5.830566379759047,137180.17777777778,6,E01004653,0,9,1,6,8,9,5.670078632566664,4.801034376356337,5.9806272798114355,4.750961252053579,5.47586289246877,6.061722758081224,5.754715980423821,173274.95555555556,6,0,9,1,7,6,8,1.0,0,0,0,0,1,-2,-1
4537,5.722692001748968,4.778151179905291,5.964221757871133,4.760408726003435,5.662660936514537,5.983013872747068,5.754451067359359,137672.0648148148,6,E01004654,0,9,2,8,4,8,5.672771581217774,4.81522716416253,5.948269427332104,4.706462798974453,5.54857819304507,5.967393924028445,5.779946854990771,173770.99145299144,6,0,9,0,8,4,8,1.0,0,0,0,-2,0,0,0
4538,5.443508280046059,5.195317193414226,5.525368786219395,5.092397039586848,5.342561597173864,5.720799996997371,5.529279950893287,136424.80303030304,2,E01004656,3,3,8,2,1,5,5.4738982664484555,5.084007032063543,5.607078081085568,5.051887997964612,5.273732498389523,5.747440291910755,5.597594532836863,172433.02721088435,4,3,5,6,2,1,5,1.0,2,0,2,-2,0,0,0
4539,5.547490268263198,4.805183483444098,5.944591056299574,4.770261138450098,5.593391427556977,5.800173140664137,5.691417841510918,133749.4961832061,4,E01004657,0,9,2,7,1,7,5.551238120407672,4.7451383028481455,5.797263151890522,4.788362256578497,5.481074594162606,5.765442759604068,5.747526910659429,168750.1418918919,5,0,8,1,7,1,8,1.0,1,0,-1,-1,0,0,1
4540,5.354154551140616,4.77268701736058,5.912096963864621,4.957766128477649,5.515834094207977,5.736369438260515,5.612189486762073,133738.83177570094,2,E01004658,0,8,6,5,1,6,5.334644379578237,4.818680399046169,5.8729028082269386,4.92008884685246,5.464206596059124,5.7700388938423215,5.686897800663325,168797.6377952756,2,0,8,4,7,1,7,1.0,0,0,0,-2,2,0,1
4541,5.282406100034714,4.99137864947319,5.795831825733185,5.035437458753586,5.4514488911628725,5.709153804779053,5.566333305835724,132056.19,1,E01004659,1,7,7,4,0,5,5.344227820129718,5.0028919335139,5.699796074527805,4.979378037533517,5.41156679391861,5.672975910922228,5.526684075088824,166664.48305084746,2,1,6,5,5,0,4,1.0,1,0,-1,-2,1,0,-1
4542,5.465543863508437,4.573514041635725,6.090405734380086,4.770788828531901,5.507562839984894,5.845728958977594,5.7432660712136165,132220.1888888889,3,E01004660,0,9,2,5,2,8,5.534442151370256,4.7299166127391485,5.970565114332282,4.868495363256206,5.562625465185746,5.782489494137142,5.842042762300243,166836.66304347827,4,0,9,3,8,1,9,1.0,1,0,0,1,3,-1,1
4543,5.4906085669565545,4.868910117972669,5.8854997278117445,5.0122886458746825,5.572315221210178,5.7850672461146075,5.6278215689624815,132856.8633093525,3,E01004661,0,8,7,7,1,6,5.376878646319498,4.838702521638242,5.875599326487786,4.927487286265025,5.392662071182342,5.7548267284553205,5.730261482878359,167591.20958083833,2,0,8,4,5,1,7,1.0,-1,0,0,-3,-2,0,1
4544,5.377555202793431,4.8331435628839445,5.881665780737594,4.88290346420563,5.4756604551195025,5.719020834914199,5.697149762162217,132586.7837837838,2,E01004662,0,8,4,4,1,7,5.393828315456418,4.837906413704809,5.802161855419187,4.842292245287094,5.437872119193529,5.810543718129179,5.776576041305153,167375.04379562044,3,0,8,2,6,2,8,1.0,1,0,0,-2,2,1,1
4545,5.575707872051838,4.741396862613268,5.949620434075348,4.757761698123837,5.556323564742223,5.847888111082976,5.72210790500168,133302.20661157026,4,E01004663,0,9,2,6,2,8,5.485211097675821,4.82959297688111,5.895592793174412,4.815534709156424,5.498478428177211,5.834592706915261,5.72587005297343,168192.8188405797,4,0,8,2,7,2,7,1.0,0,0,-1,0,1,0,-1
4546,5.372495035330455,5.1247943123181665,5.612592792510986,5.1226291020711265,5.408313822746277,5.8544702132542925,5.543407193819681,206595.96666666667,2,E01004665,2,5,8,3,2,5,5.133070286582498,5.1319726880858925,5.598502088995541,5.2478865525301766,5.2568544359768135,5.760965529610129,5.424009021590738,278236.5588235294,0,3,4,9,2,1,2,1.0,-2,1,-1,1,-1,-1,-3
4547,5.401395099503653,4.868219028200422,5.890578705923898,4.859977783475603,5.509944655781701,5.753264154706683,5.590322749955313,175743.4,2,E01004666,0,8,4,5,1,6,5.534817523426479,4.788760111789511,5.902007049984402,4.865056164336927,5.417974416655723,5.84355585021202,5.608942838630291,231753.50505050505,4,0,9,3,6,2,5,1.0,2,0,1,-1,1,1,-1
4548,5.316564936386912,5.090384700423793,5.636004289827849,5.008012188108344,5.413695074382582,5.726024913787842,5.373672406296981,151765.5052631579,1,E01004667,2,5,7,3,1,2,5.269247906548636,4.955997634720016,5.70811111848433,4.982263980331002,5.371851313245165,5.6641959593846245,5.421420085561144,204672.76923076922,1,1,6,5,4,0,2,1.0,0,-1,1,-2,1,-1,0
4549,5.356654497939096,5.0362288783973375,5.644262574088406,5.015578733363622,5.482155282732466,5.744170709395073,5.532395487100306,390274.9718309859,2,E01004668,1,5,7,5,1,5,5.401044928232829,4.984172358512878,5.82518845876058,5.009975449244181,5.384750812848409,5.768993905385336,5.743568228085835,530821.9866666667,3,1,8,6,5,1,7,1.0,1,0,3,-1,0,0,2
4550,5.276373327695406,5.228038914387042,5.500101687357976,5.074625750688406,5.4398908248314495,5.806409230599036,5.341479752613948,258986.35384615386,1,E01004669,4,3,8,4,2,2,5.458207554127797,5.071426663054041,5.541265315320119,5.086382887449609,5.374337857028088,5.839065612080586,5.558168500302786,334962.0722891566,3,2,3,7,4,2,4,1.0,2,-2,0,-1,0,0,2
4551,5.258857792218526,5.283481559753418,5.535690714518229,5.154410683314006,5.371820915540059,5.852828448613485,5.344902489980062,131582.6,1,E01004670,5,3,9,2,2,2,5.21268339422014,5.275932457711962,5.473909375402663,5.103933011160956,5.230054941442278,5.752442905637953,5.41104460424847,166024.27777777778,1,6,2,7,1,1,2,1.0,0,1,-1,-2,-1,-1,0
4552,5.705790049689156,4.929941422598702,5.958512459482465,4.735235759190151,5.470140906742641,6.148345385278974,5.722020060675485,137144.2142857143,5,E01004674,0,9,2,4,7,7,5.511636652142169,4.945788772709398,5.800473362566477,4.9533025169947065,5.2712356340454285,5.942708934646055,5.584937695997307,173452.7951807229,4,1,8,4,2,4,5,1.0,-1,1,-1,2,-2,-3,-2
4553,5.501723883946736,4.928141396840413,6.00069567044576,4.866575474739075,5.426280280749003,6.000096235275269,5.643058915138244,137170.70666666667,3,E01004675,0,9,4,3,5,6,5.503493454567222,4.877091368963552,5.844562192295873,4.9925257979437365,5.378043130386708,5.89670193195343,5.701224997986195,173349.73255813954,4,0,8,5,4,3,7,1.0,1,0,-1,1,1,-2,1
4554,5.716750975515022,4.828540764871191,5.9181791837098165,4.834205396839829,5.515717565036211,5.933357520181625,5.421250431264033,136926.52459016393,6,E01004676,0,8,4,5,3,3,5.637860488560465,4.9326997134420605,6.00083949830797,4.794901632600361,5.486879183186425,5.93773536880811,5.694856795999739,173044.95833333334,6,1,9,1,7,4,7,1.0,0,1,1,-3,2,1,4
4555,6.218891976484612,4.812098198862218,6.382487884208338,4.613797652187632,5.649092033727845,6.557944557560024,6.0311142081644995,211872.79104477612,9,E01004677,0,9,0,8,9,9,6.014663929740588,4.796639199058215,6.313361075189379,4.681492353479068,5.48392712076505,6.202865911854638,5.870298074351417,285395.68055555556,9,0,9,0,7,8,9,1.0,0,0,0,0,-1,-1,0
4556,5.6759360066869045,4.9476060420274734,5.993178969079798,4.7410304410891095,5.589964490045201,6.065149440006777,5.572995842857794,136283.4090909091,5,E01004678,1,9,2,7,6,5,5.549799937073902,4.887668303264085,5.874386002940517,4.855859105305005,5.3397127659090105,5.944918089015509,5.589311495904,172329.82795698923,5,0,8,2,3,4,5,1.0,0,-1,-1,0,-4,-2,0
4557,5.405642603337765,4.825679551064968,6.095111981034279,4.817459401488304,5.478868249058723,5.937012323737145,5.451318618655205,137694.2,2,E01004679,0,9,3,5,3,3,5.385061692655756,4.789987440859334,6.095898148718844,4.910915915885668,5.4126058482052235,5.879591063167272,5.564576807986485,173762.42696629214,3,0,9,3,5,3,4,1.0,1,0,0,0,0,0,1
4558,5.581368966060772,4.851096484744758,5.903566105323925,4.786442599798503,5.484471657819915,5.845518143553483,5.773548762003581,133611.56140350876,4,E01004680,0,8,3,5,2,8,5.760772917630537,4.781389380401036,5.938032258231685,4.684819174262713,5.574540751160316,5.926832968333982,5.894645969822721,167939.79245283018,7,0,9,0,9,4,9,1.0,3,0,1,-3,4,2,1
4559,5.404148934077631,5.088657477882011,5.563834955355873,5.096113283941351,5.377054428030377,5.76555553096935,5.608980632267115,134933.9079754601,2,E01004681,2,4,8,2,1,6,5.4675936567022445,5.115817339369591,5.6942376030252335,5.010729670524597,5.29924479697613,5.806628384488694,5.686501384795981,170511.25531914894,4,3,6,6,3,2,7,1.0,2,1,2,-2,1,1,1
4560,5.5678192704916,4.906419011950493,5.8796007116635645,4.917224076390267,5.458703780174256,5.8698976039886475,5.735282826423645,132668.54166666666,4,E01004682,0,8,5,4,2,8,5.596576003801255,4.901825051459055,5.936220865401011,4.840043697092268,5.462343424085587,5.89180040170276,5.710168899997832,167434.17460317462,5,0,9,2,7,3,7,1.0,1,0,1,-3,3,1,-1
4561,5.580822586365368,5.07844977275185,5.752366603068683,4.94137270424677,5.464104507280433,5.842712232600087,5.612009369808694,133241.64130434784,4,E01004683,2,7,6,4,2,6,5.7142098548907585,4.954120809905195,5.912783811633713,4.756218796766898,5.496647372337931,5.946361698390205,5.7040790647700215,168086.01449275363,7,1,9,1,7,4,7,1.0,3,-1,2,-5,3,2,1
4562,5.707022291490401,4.862616881556894,5.963756739408121,4.861769085642935,5.573514508104872,6.0150098965085785,5.662763018717711,133475.44827586206,6,E01004684,0,9,4,7,5,7,5.565197795884222,4.916858059728248,5.872176082725199,4.8971249099470615,5.488658158188192,5.896608000127678,5.796708923119765,168405.49572649572,5,1,8,3,7,3,8,1.0,-1,1,-1,-1,0,-2,1
4563,5.28178999448816,4.881060985227426,6.024135271708171,4.985882235070069,5.432090582946937,5.910980058213075,5.714671328663826,134043.26041666666,1,E01004686,0,9,6,3,3,7,5.348175264894962,4.871899190048377,5.88937829186519,5.041332306961219,5.39688150708874,5.807976931333542,5.739855160315831,169123.70833333334,2,0,8,6,5,2,7,1.0,1,0,-1,0,2,-1,0
4564,5.705386918072307,4.872097331449526,5.883358109981642,4.727510235178361,5.595453653313698,5.84635559790725,5.729704693916741,130411.2247706422,5,E01004687,0,8,2,7,2,8,5.701268747381495,4.84478442809161,5.894847946469061,4.694925176072444,5.572081830167123,5.885157069469469,5.797327485019805,160073.60633484164,7,0,8,0,9,3,8,1.0,2,0,0,-2,2,1,0
4565,5.81452570178292,4.93557785730311,5.835670109101158,4.784439607100054,5.600739143748972,5.96532900575648,5.78257572332168,130616.4705882353,7,E01004688,0,8,3,7,4,8,5.625414075674834,4.856087427921396,5.811832402749037,4.78073745682126,5.483989060871185,5.914285056805484,5.781499599653577,163946.53968253967,6,0,8,1,7,3,8,1.0,-1,0,0,-2,0,-1,0
4566,5.912979762938063,5.202200548628629,5.519416770692599,4.77816917482069,5.617872750355025,5.877932473764581,5.626062842748933,128440.27118644067,8,E01004689,3,3,2,8,2,6,5.9280069499636,5.134686585936719,5.578402613271782,4.821589003493791,5.541213046258955,5.931242835801293,5.696926398063773,162007.64818763325,9,3,4,2,8,4,7,1.0,1,0,1,0,0,2,1
4567,5.635163380219056,4.862338175107767,5.849187900354196,4.783504952181567,5.547181278735668,5.85196794045938,5.770448918278153,233708.16666666666,5,E01004690,0,8,3,6,2,8,5.625925481555019,4.927695964636068,5.826165915477889,4.78511945909191,5.438899718254452,5.893146829642797,5.757980721270143,292292.05138339923,6,1,8,1,6,3,8,1.0,1,1,0,-2,0,1,0
4568,5.657304295191639,4.972585227536528,5.7875055341344135,4.89708428673054,5.5154971154896835,5.849874145890537,5.641398023617895,127312.53289473684,5,E01004691,1,7,5,5,2,6,5.6052399907793315,5.05442866725581,5.713428799595151,4.882484876258033,5.457765062366213,5.900340688228607,5.672406451616968,160678.7,5,2,6,3,7,3,6,1.0,0,1,-1,-2,2,1,0
4569,5.773446591837065,5.050393743174417,5.830233665449279,4.85544132654156,5.4849027906145364,5.924247205257416,5.810087764901774,128838.66071428571,6,E01004692,1,8,4,5,3,8,5.7312204705344305,5.034124764689693,5.698864108544809,4.932213835363035,5.426794327629937,5.863513665729099,5.7629675114596335,162584.22222222222,7,2,6,4,6,2,8,1.0,1,1,-2,0,1,-1,0
4570,5.666069736384382,4.921379413267578,5.841270169826469,4.836548896751019,5.56595220710292,5.850062745990175,5.574636251035363,141307.65656565657,5,E01004693,0,8,4,7,2,5,5.603537699886572,4.883646257569857,5.908170200953974,4.839079611769346,5.5764164278440385,5.904753785267054,5.716858181997995,178760.17757009345,5,0,9,2,9,3,7,1.0,0,0,1,-2,2,1,2
4571,5.672266246654369,4.919265295841075,5.8782826812179,4.8180017974641585,5.548030671366939,5.949457255116215,5.736793177216141,134601.05925925926,5,E01004694,0,8,3,6,4,8,5.6999885049359555,4.86623928957972,5.904083605470328,4.676093388425893,5.528046562753874,5.953881653423967,5.755943239146266,170282.39310344827,7,0,9,0,8,4,8,1.0,2,0,1,-3,2,0,0
4572,5.643960792510236,4.781506061553955,5.9085802132966085,4.910425752889915,5.525304536350438,5.852768143669504,5.59955304177081,141405.7213114754,5,E01004695,0,8,5,6,2,6,5.688937120270311,4.710842182761745,5.833044106500191,4.775544929922673,5.514414103407609,5.8889798867075065,5.664501282206753,178835.7894736842,6,0,8,1,8,3,6,1.0,1,0,0,-4,2,1,0
4573,5.853993339325065,4.881081860456893,5.88647553102294,4.793888040442965,5.576398785434552,6.001811728548648,5.85808783502721,134544.223880597,7,E01004696,0,8,3,7,5,9,5.909278439052069,4.901984476331455,5.873355111079429,4.7777992486953735,5.512306419771109,6.032996138529991,5.903879537511227,170200.91044776118,8,0,8,1,8,6,9,1.0,1,0,0,-2,1,1,0
4574,5.601601353058448,4.917578914990792,5.868120624468877,4.896419905699217,5.5015120185338535,5.800151930405543,5.439247145102574,135028.1923076923,4,E01004697,0,8,5,5,1,3,5.516671573122342,4.86210519572099,5.921954403320949,4.802373203138511,5.516377493739128,5.812119513750076,5.724445328116417,170414.64583333334,4,0,9,1,8,2,7,1.0,0,0,1,-4,3,1,4
4575,5.717072958037967,4.916808029015859,5.936701695124309,4.786898360365913,5.590608863603501,5.966919345515115,5.724032485768909,139766.36904761905,6,E01004698,0,9,3,7,4,8,5.8421454028079385,4.867454630450198,5.942451876088192,4.710955476760864,5.591819231133712,6.025954060805471,5.749832735563579,177129.08421052631,8,0,9,0,9,6,8,1.0,2,0,0,-3,2,2,0
4576,5.554804410128033,4.726279001902132,5.993149002685266,4.776296692736008,5.595347668318188,5.839198699768851,5.549096650937024,138107.67647058822,4,E01004699,0,9,2,7,2,5,5.342589265959603,4.879704469442368,5.862734651565551,4.922165726763861,5.488761520385742,5.775992838825498,5.513258132764271,174500.10714285713,2,0,8,4,7,1,3,1.0,-2,0,-1,2,0,-1,-2
4577,6.044388852220901,4.768153669986319,6.070386176413678,4.591345967130458,5.79863932284903,6.0501133330324866,5.920859534689721,138079.40425531915,9,E01004700,0,9,0,9,5,9,6.064192029665101,4.6505658401633205,6.109486629378121,4.560207902260546,5.698346871250081,5.980682431526904,6.023905772083211,174423.30188679244,9,0,9,0,9,5,9,1.0,0,0,0,0,0,0,0
4578,5.8345116693146375,4.860586791622396,6.113501529304349,4.694995593051521,5.578262582117198,6.020506951273704,5.741851261683872,133292.24489795917,7,E01004701,0,9,1,7,5,8,5.636372515133449,4.906376785465649,5.975690407412393,4.855749649660928,5.4823309906891415,5.992707469633648,6.012549559984889,168397.5892857143,6,1,9,2,7,5,9,1.0,-1,1,0,1,0,0,1
4579,5.310975635652062,5.2664007866125315,5.514869472963347,5.187133150992634,5.356007274963873,5.723820648605018,5.490732632095008,132750.0215827338,1,E01004702,5,3,9,2,1,4,5.411474625817661,5.059535022439627,5.568268020399685,5.117202486663029,5.230700889127008,5.710459958273789,5.616281735485997,167476.85517241378,3,2,4,7,1,0,5,1.0,2,-3,1,-2,-1,-1,1
4580,5.96167933875026,4.992853221313729,5.955023960513963,4.687424715711267,5.5807078457669,6.175049183777024,5.77856471196064,133370.5856353591,8,E01004703,1,9,1,7,7,8,5.871718854971335,4.9655008366410165,5.8760488850409995,4.768202335062162,5.447453837999156,6.100448085668501,5.813700679882031,168237.92018779344,8,1,8,1,6,7,8,1.0,0,0,-1,0,-1,0,0
4581,5.653490662574768,4.725450727343559,6.095198279619217,4.824768659472466,5.507105648517609,6.011611264944077,5.814799720048905,132321.325,5,E01004705,0,9,3,5,5,9,5.813523557451036,4.696906895107693,6.03088002204895,4.699043016963535,5.527822017669678,6.037142070134481,6.034338283538818,166488.0,8,0,9,0,8,6,9,1.0,3,0,0,-3,3,1,0
4582,6.390197192705594,4.724254523790799,6.209706882330088,4.539212920115545,5.720936037943914,6.362101866648747,5.958376326927772,137613.47692307693,9,E01004706,0,9,0,9,9,9,6.230178534145087,4.788506751329127,6.1343510990411465,4.718193280864769,5.5981347795943135,6.200805002534893,5.954536814085195,171407.98591549296,9,0,9,0,9,8,9,1.0,0,0,0,0,0,-1,0
4583,6.2294220447540285,4.740731482505798,6.167844721476237,4.538730551401774,5.730052728652954,6.397594353357951,6.069099973042806,135808.29333333333,9,E01004707,0,9,0,9,9,9,6.101267324911581,4.741151568051931,6.12932288646698,4.638275939065057,5.544214409750861,6.263153391915399,6.055873806412156,171584.4189189189,9,0,9,0,8,9,9,1.0,0,0,0,0,-1,0,0
4584,5.918534576892853,4.696707720106298,6.206620633602142,4.784423557194796,5.566857738928362,6.267257782545957,5.76354470578107,136635.8409090909,8,E01004708,0,9,3,7,8,8,5.808337061301522,4.769038490627123,6.021381974220276,4.707879429278166,5.349270535551983,6.175329394962477,6.021318238714467,179195.15217391305,8,0,9,0,4,8,9,1.0,0,0,0,-3,-3,0,1
4585,5.771190159099618,4.977490171943743,5.923649397092996,4.759390560622068,5.481403360661772,6.049075593653414,5.728904917068088,172329.59793814432,6,E01004709,1,8,2,5,5,8,5.7876198848088585,4.9837239040268795,5.889069265789455,4.81842943959766,5.4794569545322,6.037511685159472,5.782802225483788,213388.25555555554,7,1,8,2,7,6,8,1.0,1,0,0,0,2,1,0
4586,5.827161921395196,5.028346959087584,5.821577204598321,4.85527244872517,5.460708886384964,6.0637455052799645,5.669521825181113,489217.4861111111,7,E01004710,1,8,4,4,6,7,5.6599542371342695,4.942250242394008,5.820556592405512,4.928116050998816,5.345892245849867,6.07198837901769,5.657962619588616,620539.797752809,6,1,8,4,4,7,6,1.0,-1,0,0,0,0,1,-1
4587,5.813955729657954,4.959808005528017,5.9279754107648674,4.710665767843073,5.610000209374861,6.1865720477971164,5.762388028881767,352364.4318181818,7,E01004711,1,9,1,7,8,8,5.823147199921689,5.023870866177446,5.840124995021497,4.847176531613884,5.50944055541087,6.002726344738976,5.7852894370838746,419178.83050847455,8,2,8,2,8,5,8,1.0,1,1,-1,1,1,-3,0
4588,5.514133022712158,4.734123089292028,6.030557084727931,4.895429060265824,5.637338236645535,5.823553055256337,5.6999412968352035,132757.53153153154,3,E01004712,0,9,5,8,2,7,5.463271851539612,4.736023970603943,5.981939615249634,4.727166801452637,5.547260090827942,5.879011845588684,5.749637391090393,167531.312,4,0,9,0,8,3,8,1.0,1,0,0,-5,0,1,1
4589,5.677328548838744,4.634880692515541,6.016451658315994,4.751676542675076,5.639373026301513,5.950968567450442,5.820620990278733,343205.2261306533,5,E01004713,0,9,2,8,4,9,5.535679439532346,4.717875433379207,6.0081974833176055,4.770671967288544,5.589897228212192,5.81983489363358,5.791170672609888,439971.8965517241,4,0,9,1,9,2,8,1.0,-1,0,0,-1,1,-2,-1
4590,5.343884081147903,4.671932124558774,6.028883823469364,4.8704146063527585,5.5390643623954094,5.827963660882172,5.65294992990334,149271.88268156425,1,E01004714,0,9,4,6,2,7,5.417666148178523,4.7086354743323335,5.926347301348631,4.872717413553963,5.497722442564496,5.76593544140871,5.710804636892804,182757.85138539042,3,0,9,3,7,1,7,1.0,2,0,0,-1,1,-1,0
4591,5.320040443302256,4.677020599356795,5.811220063572437,4.926298245919489,5.585124706800005,5.798703605094842,5.551278106934201,163649.46902654867,1,E01004715,0,7,5,7,1,5,5.356170845218003,4.755311916582286,5.867035932838917,4.870276931673288,5.51970041077584,5.795752536505461,5.657889191061258,201568.1953125,2,0,8,3,8,1,6,1.0,1,0,1,-2,1,0,1
4592,5.708825464989688,4.864244085711402,5.926983659331863,4.7514552345147,5.547382367623819,5.958656177327439,5.649675183199547,224244.16216216216,6,E01004716,0,9,2,6,4,7,5.693221550272859,4.952805716706359,5.820432471192402,4.8090490005586455,5.538918363011402,5.879491139365279,5.758175025815549,289098.652173913,6,1,8,2,8,3,8,1.0,0,1,-1,0,2,-1,1
4593,5.5025278307975976,4.68134727281168,5.985590418544384,4.9022684370705845,5.621818531543837,5.940260060336612,5.721518096573856,131579.0275229358,3,E01004717,0,9,5,8,4,7,5.496810049811999,4.7135736833016075,5.9338960409164425,4.823285340269407,5.538385367393493,5.768172568082809,5.68372476597627,165947.05833333332,4,0,9,2,8,1,7,1.0,1,0,0,-3,0,-3,0
4594,5.8340691122515445,4.926782310009003,6.033161849811159,4.764092607744809,5.633619035112447,6.250186562538147,5.5871500516759935,135362.0,7,E01004718,0,9,2,8,8,6,5.654875849684079,4.732069167825911,6.137718038426505,4.731229275465012,5.376485506693522,6.084917392995623,5.641676609714826,170697.54166666666,6,0,9,0,4,7,6,1.0,-1,0,0,-2,-4,-1,0
4595,5.8021329303957385,4.782224636032896,6.028795878842192,4.645410601822835,5.670068524918467,6.296291256850621,5.567916239207646,193417.74528301886,7,E01004719,0,9,0,8,9,5,5.645995168510927,4.806702473841676,5.949935998391668,4.739126868204239,5.37593757887499,6.0862114451347145,5.552948027575781,245139.50458715597,6,0,9,1,4,7,4,1.0,-1,0,0,1,-4,-2,-1
4596,5.671869356323172,4.946611791849136,5.7875474492708845,4.868552115228441,5.553129308753544,5.9727853028862565,5.3996543840125755,172938.33333333334,5,E01004720,1,7,4,6,4,2,5.465926871232107,4.967262623157907,5.699869150811053,4.885561028270857,5.337830410781482,5.879753587939215,5.478710255724319,213052.17730496454,4,1,6,3,3,3,3,1.0,-1,0,-1,-1,-3,-1,1
4597,5.722957308965785,4.945830607232247,5.896038175539206,4.798421503023337,5.614551155621768,6.054442409340662,5.535775711518208,135720.0534351145,6,E01004721,1,8,3,8,5,5,5.49215732398608,4.883694365514931,5.822858707279178,4.946789969789221,5.37889923271558,5.970629238913245,5.505557723079168,171202.56028368796,4,0,8,4,4,5,3,1.0,-2,-1,0,1,-4,0,-2
4598,5.5947093825409375,5.06458676552427,5.891395271688268,4.869350438532622,5.508765030598295,6.065327253894529,5.44799826801687,180752.28985507245,4,E01004722,2,8,4,5,6,3,5.431118297932753,4.971484821234176,5.841185231706989,4.9735658755942955,5.321309255130255,5.826739713327209,5.334505912083299,253071.223880597,3,1,8,5,3,2,1,1.0,-1,-1,0,1,-2,-4,-2
4599,5.943983633866471,4.930116413684374,6.206295016106595,4.739960651719168,5.675463952375262,6.2902512550354,5.814621972234062,252553.93258426967,8,E01004723,0,9,2,9,9,9,5.770541999075148,4.883833299983632,6.1131673509424385,4.807933654447998,5.442035583534626,6.070578153687294,5.759875886368029,328516.8686868687,7,0,9,2,6,7,8,1.0,-1,0,0,0,-3,-2,-1
4600,5.738538706556279,4.6945797674199365,6.049267525368548,4.676344723143476,5.567340581975085,6.006735583569141,5.654471888187084,527166.3723404255,6,E01004724,0,9,1,7,5,7,5.727215472257362,4.674793450337536,5.926929347919968,4.858177125453949,5.448124594283554,6.000506123281875,5.737247489533335,672953.4150943396,7,0,9,2,6,5,7,1.0,1,0,0,1,-1,0,0
4601,5.539771514503579,5.1441957503557205,5.6539746930724695,4.9643951599535185,5.441445891794405,5.871687784006721,5.556708864475551,282416.9539473684,4,E01004725,3,5,6,4,2,5,5.462195331400091,5.103665619907957,5.617405151598382,4.98608224102945,5.310197932792432,5.827790388916478,5.685631932634296,365577.2,4,3,5,5,3,2,7,1.0,0,0,0,-1,-1,0,2
4602,5.8929953190588185,5.063128230071837,5.844600829385942,4.768501486509077,5.535724046730226,6.060010275533123,5.70258842937408,336741.43548387097,7,E01004726,2,8,2,6,6,7,5.645414328374782,5.071824783036689,5.66850250508605,4.9451130388163715,5.368502312347669,5.915054416456142,5.647461992351949,410790.46218487393,6,2,6,4,4,3,6,1.0,-1,0,-2,2,-2,-3,-1
4603,6.004292547135126,5.172570090066819,5.610600052939521,4.751387200658283,5.628455078791058,5.998273334049043,5.725830673414563,210790.3142857143,8,E01004727,3,5,2,8,5,8,5.9445542188041545,5.189528414598928,5.513511927316234,4.806105877787931,5.484003869649175,5.9964252161394995,5.734178825360228,278064.94005449594,9,4,3,1,7,5,7,1.0,1,1,-2,-1,-1,0,-1
4604,5.776492486765355,4.976830713542891,5.90853883896345,4.780071420434081,5.551202242757067,6.053399495136591,5.7281797108826815,131626.16049382716,6,E01004728,1,8,2,6,5,8,5.6229288862510165,5.005482444708997,5.774198334325444,4.764501067725095,5.361435719511726,6.026362229477275,5.810937011783773,166108.38636363635,6,1,7,1,4,6,8,1.0,0,0,-1,-1,-2,1,0
4605,5.99224697626554,4.725132396587958,6.155576375814585,4.615530206606938,5.750986667779776,6.29331034880418,5.93991494178772,131418.07692307694,8,E01004729,0,9,0,9,9,9,5.578857741048259,4.974000992313508,5.811438537413074,4.980237849297062,5.339819531286916,5.968182948327834,5.681748567088958,165902.5806451613,5,1,8,5,3,4,7,1.0,-3,1,-1,5,-6,-5,-2
4606,5.825111722600633,5.1582262930662734,5.691201828528142,4.846188792283984,5.587880008462546,6.04211013386215,5.603552184243133,526881.0289855072,7,E01004730,3,6,4,7,5,6,5.739541726174697,5.151078424422569,5.606968230671352,4.9043109892240535,5.491086109790927,6.025910921346128,5.748548640145196,672594.8104575163,7,4,5,3,7,6,8,1.0,0,1,-1,-1,0,1,2
4607,5.617764591832053,4.8372202908450905,5.849711671471596,4.858842845328829,5.558273239569231,5.901017600162462,5.7907456393268975,503263.6789772727,4,E01004731,0,8,4,6,3,8,5.527186694813546,4.793575300360626,5.854999635418792,4.902735443128087,5.476158582296654,5.866834429717771,5.782917944890149,657305.6684636119,4,0,8,3,7,3,8,1.0,0,0,0,-1,1,0,0
4608,5.38933413369315,4.782093736103603,5.965653681755066,4.840133506911141,5.551305706160409,5.809426784515381,5.67555091721671,521455.21428571426,2,E01004732,0,9,4,6,2,7,5.39178054304008,4.723719509251146,5.852638195796185,5.055690890335175,5.4947173049651,5.762100472507707,5.763887873615127,665649.8795180722,3,0,8,6,7,1,8,1.0,1,0,-1,2,1,-1,1
4609,5.802415787027432,4.751629007168305,6.001072270747943,4.736906703466024,5.589088538518319,6.017300870174017,5.852189667331866,520707.5,7,E01004733,0,9,2,7,5,9,5.723769634690329,4.738211925993574,5.900001106291194,4.78514896301513,5.5092716463431035,5.94294955737685,5.778693619832442,664786.7689969605,7,0,9,1,8,4,8,1.0,0,0,0,-1,1,-1,-1
4610,5.4656045201921115,4.592523495211219,6.0555026461608215,4.8399641605189245,5.671186308791167,5.821600600750777,5.648216679583501,520670.24452554743,3,E01004734,0,9,4,8,2,7,5.465412964700986,4.590262984097337,6.02342187292749,4.839757134461536,5.575221482934898,5.798372688573166,5.6264341796576645,664718.1201117318,4,0,9,2,9,1,6,1.0,1,0,0,-2,1,-1,-1
4611,5.5680002230699825,4.68925791631365,5.9724276421316,4.812473070461119,5.640925058334933,5.946415863764126,5.764123515965158,414493.45067264576,4,E01004735,0,9,3,8,4,8,5.57289419615008,4.706123913732722,5.949875446247533,4.837389875595897,5.5117614006190365,5.862078327307882,5.787289839378645,528954.7992047714,5,0,9,2,8,2,8,1.0,1,0,0,-1,0,-2,0
4612,5.75614976557325,4.731246992380377,5.951227407354144,4.778223501532501,5.6243468740098574,5.93174374953749,5.826379950925685,509755.1305007587,6,E01004736,0,9,2,8,3,9,5.7421495590048535,4.752249976775299,5.891324245526145,4.7854142766445875,5.560345164965838,5.913749476273854,5.805430081207305,650891.6796875,7,0,8,1,8,3,8,1.0,1,0,-1,-1,0,0,-1
4613,5.4292237585869385,5.022481961526733,5.636763133864472,5.01020037782365,5.406650225321452,5.80327998727992,5.651721653730973,522858.2173913043,2,E01004737,1,5,7,3,1,7,5.598576169264944,4.96611730519094,5.730313934777913,4.939157959661986,5.38840694490232,5.824444930804403,5.8099419882423,644664.3157894737,5,1,7,4,5,2,8,1.0,3,0,2,-3,2,1,1
4614,5.667833086955978,4.984967541981892,5.715497378843376,4.937434997903296,5.505216489355248,5.885324472404388,5.448251587798796,272276.3975903614,5,E01004738,1,6,6,5,3,3,5.706602519956128,5.027213344628784,5.785492869629257,4.882096720837999,5.438463261757774,5.946063093755437,5.77712781127842,349793.2413793103,7,2,7,3,6,4,8,1.0,2,1,1,-3,1,1,5
4615,5.167922377586365,5.228629146303449,5.548833727836609,5.149688397135053,5.433888367244175,5.8150721447808404,5.186725854873657,102529.28571428571,0,E01004739,4,4,9,3,2,0,5.4045916253870185,5.177377635782415,5.631321343508634,4.928846445950595,5.305914943868464,5.658754998987371,5.864809469743208,90805.09090909091,3,4,5,4,3,0,9,1.0,3,0,1,-5,0,-2,9
4616,5.247561145912517,4.865751797502691,5.969161001118747,4.891879569400441,5.486104986884377,5.7429786053570835,5.394031763076782,523918.86363636365,1,E01004740,0,9,5,5,1,2,5.380537261962891,4.696964163780212,5.75200364112854,5.109256029129028,5.315014209747314,5.8729180908203125,5.5248797369003295,668890.72,2,0,7,7,3,3,4,1.0,1,0,-2,2,-2,2,2
4617,5.497935676574707,4.838588078022003,5.857393536567688,4.905062141418457,5.501035127639771,5.839779329299927,5.5621110987663265,505697.88,3,E01004741,0,8,5,5,2,5,5.466154162372861,4.902815754924502,5.808442401034491,4.858567167605672,5.3760146754128595,5.808419180767877,5.67965147963592,658403.1607142857,4,0,8,2,4,2,7,1.0,1,0,0,-3,-1,0,2
4618,5.54490031003952,4.840490361054738,5.928962576389313,4.838125995794932,5.4942491292953495,5.773025548458099,5.603426665067673,524000.1,4,E01004742,0,9,4,5,1,6,5.684602344858235,4.7634963495977996,6.005709039753881,4.716104073771115,5.493139053213185,5.885654992070691,5.8643456409717425,668898.9827586206,6,0,9,0,7,3,9,1.0,2,0,0,-4,2,2,3
4619,5.43412280579408,4.586551236609618,5.889982903997104,4.885466282566388,5.5682795743147535,5.820718626181285,5.614869753519694,521091.1875,2,E01004743,0,8,5,7,2,6,5.3938223375723915,4.596548357835183,5.945680503661816,4.880123436450958,5.464210386459644,5.809961254780109,5.723864349035116,665387.3653846154,3,0,9,3,7,2,7,1.0,1,0,1,-2,0,0,1
4620,5.572193833260701,4.707545985435617,5.906197251944707,4.837156043998126,5.6236403933886825,5.859538932298792,5.715489031939671,522265.9568965517,4,E01004744,0,8,4,8,2,7,5.5082557920751904,4.764799973060345,5.892400223633339,4.842365045999658,5.495099503418495,5.817176730468355,5.713170042325711,666679.8706896552,4,0,8,2,7,2,7,1.0,0,0,0,-2,-1,0,0
4621,5.576401492365363,4.904624527814437,5.79638537257707,4.78518275419871,5.544576972520271,5.887255715675095,5.66012781412423,521351.537414966,4,E01004745,0,7,3,6,3,7,5.537091918933538,4.913202972323806,5.750786419268008,4.917400078273114,5.409715099099242,5.868192634464782,5.706645450474303,665528.938271605,4,1,7,4,5,3,7,1.0,0,1,0,1,-1,0,0
4622,5.608303662892935,4.938283356460365,5.995146184354215,4.7015717706164795,5.566160330901274,5.9032857740247575,5.7760212356979785,523456.02702702704,4,E01004746,0,9,1,7,3,8,5.57826760652903,4.9042994202794254,5.906832707894815,4.864648222923279,5.47401702081835,5.92802247485599,5.637197178763312,668207.972972973,5,1,9,2,7,4,6,1.0,1,1,0,1,0,1,-2
4623,5.640520513527036,4.84171442065652,5.893084325189665,4.844467528223053,5.677181544266348,5.86000549887109,5.605672804389413,523766.74803149607,5,E01004747,0,8,4,9,2,6,5.546507305668709,4.737557170086337,5.8277385521652105,4.915440776294336,5.573984701830642,5.867119190388156,5.67671083059526,668591.7894736842,5,0,8,4,9,3,6,1.0,0,0,0,0,0,1,0
4624,5.688016592828851,4.722624802589417,6.131662037498073,4.78993769068467,5.627279735866346,5.924067575053165,5.88564581118132,522648.81052631576,5,E01004748,0,9,3,8,3,9,5.7234609285179445,4.5578543093739725,6.12654925122553,4.762970170196222,5.555006715716148,5.9826206212141075,5.930413372662603,667173.7857142857,7,0,9,1,8,5,9,1.0,2,0,0,-2,0,2,0
4625,5.384872438202442,4.807833639668747,5.836807717739696,4.842714512012374,5.469493175896121,5.782710872905355,5.528072010463392,523361.45070422534,2,E01004749,0,8,4,4,1,5,5.470101981855637,4.797756661915912,5.927972324733628,4.844460015856354,5.449931957202251,5.823159163224631,5.649757040279537,668091.8715083799,4,0,9,2,6,2,6,1.0,2,0,1,-2,2,1,1
4626,5.349794709086418,4.7941182285547255,5.919927545785904,4.956778302788734,5.428360418081284,5.787471151351928,5.62162369787693,507638.305,1,E01004750,0,8,6,3,1,6,5.364802227083561,4.820424221785722,5.855978717846153,4.923402787309833,5.387928177825118,5.80418332277146,5.693264990253786,643583.9380530973,2,0,8,4,5,1,7,1.0,1,0,0,-2,2,0,1
4627,5.6163934079727325,4.858929966936017,5.826583392549269,4.768294132582032,5.4996604046019,5.898554391199999,5.667461538078761,524275.55445544556,4,E01004751,0,8,2,5,3,7,5.805598153132144,4.80485890401858,5.903755827484844,4.840066611209762,5.493601640808248,5.923404504205579,5.815235112315026,669202.6074766355,8,0,9,2,7,4,8,1.0,4,0,1,0,2,1,1
4628,5.3423922508955,4.592785179615021,5.8904126187165575,5.01813559482495,5.490448077519734,5.8690416266520815,5.611391708254814,524166.6041666667,1,E01004752,0,8,7,5,2,6,5.801929788769416,4.621510222273053,6.044513180570783,4.768375178553024,5.600503543637833,5.906594181960484,5.934388232680987,669118.6037735849,8,0,9,1,9,3,9,1.0,7,0,1,-6,4,1,3
4629,5.631843274289912,4.84552598405968,5.866474549878728,4.9194576455788175,5.4806770573962815,5.824394683946263,5.4874482547694985,524255.2272727273,5,E01004753,0,8,5,5,2,4,5.66870023074903,4.812349630656995,5.967184177197908,4.847497155791835,5.43455201701114,5.852181379418624,5.720955095793071,669233.3263157895,6,0,9,2,6,2,7,1.0,1,0,1,-3,1,0,3
4630,5.619955496788025,5.006183021068573,5.8189722919464115,4.874105031490326,5.52150869846344,5.929792828559876,5.7154846239089965,136660.2,5,E01004754,1,7,4,6,3,7,5.501596614718437,5.096013146142165,5.647784461577733,5.141536960999171,5.368727959692478,5.868186106284459,5.509233243763447,172692.58333333334,4,3,5,8,4,3,3,1.0,-1,2,-2,4,-2,0,-4
4631,5.269186230911606,5.085917559163324,5.592320017430974,5.018430146677741,5.288031798669661,5.6700848765756895,5.313385903150186,137321.7816091954,1,E01004755,2,4,7,1,0,1,5.290736931435605,5.057462403114806,5.58185816064794,5.117429978035866,5.260975170642771,5.701598710202156,5.397815112103808,173554.43617021278,1,2,4,7,2,0,2,1.0,0,0,0,0,1,0,1
4632,5.699725850573126,4.880585809923568,6.09309742585668,4.8241672650823055,5.5869548275785625,6.058357922536023,5.795184751726547,136900.4150943396,5,E01004756,0,9,3,7,6,8,5.77250709821438,4.712714908451869,6.240166442147617,4.7174248243200365,5.523300828604863,6.103631401884145,5.852384748130009,172904.93103448275,7,0,9,0,8,7,9,1.0,2,0,0,-3,1,1,1
4633,5.316621398168897,5.366141710016462,5.420805158123137,5.081423079210614,5.342864567325229,5.688719534684742,5.347052109619928,135932.42063492062,1,E01004757,6,2,8,2,0,2,5.1760619335007245,5.455386879151328,5.363997382030153,5.313373490383751,5.081582748401932,5.566650973425971,5.248133324043096,171797.0994152047,0,8,1,9,0,0,0,1.0,-1,2,-1,1,-2,0,-2
4634,5.946698444230216,4.721887792859759,6.157093544395602,4.5999244719135515,5.644501544991318,6.160236733300345,5.840035788866938,137564.73469387754,8,E01004760,0,9,0,8,7,9,5.775942870548794,4.759182105259019,6.050567417728658,4.7338680174885965,5.3654312990149675,6.117266241385012,5.932527264770196,173809.51020408163,7,0,9,0,4,7,9,1.0,-1,0,0,0,-4,0,0
4635,5.630651149654041,4.707464658648428,5.967094142506593,4.7873986828936275,5.674100303954452,5.894365983287783,5.750122909780837,366769.06386861316,5,E01004761,0,9,3,9,3,8,5.515746539933009,4.757616321666149,5.858465373952569,4.8606278927370825,5.510057977586379,5.786292628023661,5.705720182353641,469349.56794141576,4,0,8,2,8,1,7,1.0,-1,0,-1,-1,-1,-2,-1
4636,5.730690245092267,4.651663951267152,6.0710720134204665,4.74608893472062,5.697615817453734,5.987096631315333,5.86006770860514,132815.25443786982,6,E01004762,0,9,2,9,4,9,5.674756038857966,4.665988999666,5.963571706900791,4.69695551784671,5.588522682384569,5.895028207679184,5.860282018476603,168324.01020408163,6,0,9,0,9,3,9,1.0,0,0,0,-2,0,-1,0
4637,5.325824717807162,4.6158671994118174,5.964030349330538,4.920842349908914,5.67852352075516,5.7872779483248475,5.58727408100845,477880.84713375795,1,E01004763,0,9,5,9,1,6,5.360283507849719,4.6251308605477615,6.0038875425184095,4.845213710617375,5.56070038595715,5.7561992748363595,5.590318776465751,614832.1594594595,2,0,9,2,8,1,5,1.0,1,0,0,-3,-1,0,-1
4638,5.519406280637215,4.5901553395828465,6.056156777139206,4.847315983533004,5.665760914057387,5.860576031455857,5.757320803980673,432485.96774193546,3,E01004765,0,9,4,8,2,8,5.505457581579686,4.608534274995327,6.028472296521068,4.78716710396111,5.569263640418649,5.838075336068869,5.830177113413811,567084.45,4,0,9,1,9,2,8,1.0,1,0,0,-3,1,0,0
4639,5.182648367934174,5.4972828063336046,5.343367926367036,5.289627048995468,5.145822187046428,5.579966724573911,5.380772062710354,137224.83516483515,0,E01032512,8,1,9,0,0,2,5.267466170283464,5.22260510806854,5.433684404079731,5.234746005672675,5.133711743813294,5.728071068341915,5.48529405777271,173340.85576923078,1,5,2,9,0,1,3,1.0,1,-3,1,0,0,1,1
4640,5.6023492001472635,5.076353276029546,5.864835419553391,4.825667305195585,5.464684800898775,6.0153024044442684,5.625619829969203,137685.10638297873,4,E01032513,2,8,3,4,5,6,5.4463244539040785,4.96882760983247,5.70295728628452,5.071543209827864,5.260709847395237,5.812028660224034,5.566484829554191,173960.40384615384,3,1,6,7,2,2,4,1.0,-1,-1,-2,4,-2,-3,-2
4641,5.63676755661731,5.391739183372551,5.568969663206514,4.8450218639173706,5.505507760114603,6.088885113909528,5.617871422034043,257792.41958041958,5,E01032562,7,4,4,5,6,6,5.446000490869794,5.393170034128522,5.553052317528498,5.026775605148739,5.390526722347926,5.971050285157704,5.5490418625256375,332287.34126984124,3,8,4,6,5,5,4,1.0,-2,1,0,2,0,-1,-2
4642,5.749066628760575,5.392975091374536,5.560540177452732,4.910162451121729,5.53911686111504,6.052768572955064,5.5535640453508766,257163.91079812206,6,E01032563,7,4,5,6,5,5,5.814587649371889,5.288562501470248,5.655039469401042,4.8658046457502575,5.53449510037899,6.14394763774342,5.801397598452038,331054.31018518517,8,6,5,3,8,8,8,1.0,2,-1,1,-2,2,3,3
4643,5.643447918121261,5.415537551195935,5.531870247137667,4.950549719309566,5.464922364311989,6.040716354293052,5.603633690362025,261869.18181818182,5,E01032564,7,3,6,4,5,6,5.577477140334046,5.20655128793809,5.5952454654915815,4.911650397245166,5.443446376948681,5.956506768476616,5.594666562034089,337033.47572815535,5,4,4,3,6,4,5,1.0,0,-3,1,-3,2,-1,-1
4644,5.549627457062403,5.517422386010488,5.416465317209561,4.99656414091587,5.398557525873184,5.98962627251943,5.521591271956762,256812.34166666667,4,E01032565,8,2,7,3,4,4,5.482997465878725,5.413886840455234,5.4326473996043205,5.007975837215781,5.404725127853453,5.980719245970249,5.4794019646942616,330648.5078125,4,8,2,5,5,5,3,1.0,0,0,0,-2,2,1,-1
4645,5.2549477569518555,5.524720145810035,5.321386473409591,5.134712321527543,5.238967849362281,5.749201865350046,5.254388866886016,380665.4064516129,1,E01032566,8,1,8,0,1,1,5.288400654699288,5.333216250332352,5.434981110049229,5.086447479678135,5.284286008940803,5.824313241671892,5.438688059258305,487229.5620915033,1,7,2,7,2,2,2,1.0,0,-1,1,-1,2,1,1
4646,5.503655290494771,5.252468717697004,5.640115545220571,4.888832122767897,5.468156868464326,6.039841477729414,5.510031962503581,372499.87671232875,3,E01032567,4,5,5,4,5,4,5.622054207113992,5.135586529706432,5.66231756611208,4.839115424493773,5.4883842563207175,6.103369924874432,5.698013780918797,477012.1371681416,6,3,6,2,7,7,7,1.0,3,-1,1,-3,3,2,3
4647,5.343241798757303,5.444849651269238,5.442803013204324,5.039790538826374,5.27822951114539,5.888079198923978,5.367408514624894,327214.2121212121,1,E01032568,7,2,7,1,3,2,5.286444398112919,5.359387383771979,5.412301087379456,5.0749738029811695,5.21354914178019,5.887928837278615,5.411403998602991,420334.7043478261,1,7,1,7,1,3,2,1.0,0,0,-1,0,0,0,0
4648,5.6572116700942905,5.39360110840555,5.370016640862502,4.921086512042978,5.587453326262997,6.094824027206938,5.528834933615,328052.0338983051,5,E01032569,7,1,5,7,6,5,5.614978245419005,5.4018819967041845,5.404896302067715,4.989251770403074,5.427859410643578,5.956045034139053,5.417311840083288,421338.9293478261,5,8,1,5,6,4,2,1.0,0,1,0,0,-1,-2,-3
4649,5.814357768590143,5.394776365762789,5.4885268872671755,4.770656962754373,5.596404170757952,5.9172854707768945,5.350304169666448,732761.4111922141,7,E01032570,7,3,2,7,3,2,5.714831188573676,5.31596054330384,5.427447956834135,4.880779476489051,5.470146370472881,5.917609305031555,5.5259111372091,930613.6666666666,7,6,2,3,7,3,4,1.0,0,-1,-1,1,0,0,2
4650,5.964089773225446,5.090277438468122,5.766929092136681,4.771397101963665,5.746493555975299,6.089783734463631,5.6716693107118,188395.97163120567,8,E01032572,2,7,2,9,6,7,5.979830773619862,5.0213883031498305,5.685788680980732,4.8292369068443,5.55231307621126,6.102746842743515,5.571819005074439,238999.62987012987,9,2,6,2,8,7,5,1.0,1,0,-1,0,-1,1,-2
4651,5.801893234922645,5.058707381902116,5.7442242737566485,4.793478184201744,5.5782780232054465,5.965673845805479,5.542883618494098,190096.43258426967,7,E01032573,2,7,3,7,4,5,5.784873323440552,5.031007068157196,5.785569926500321,4.827325230240822,5.538255045413971,6.017787854671479,5.61410349369049,241086.565,7,2,7,2,8,5,5,1.0,0,0,0,-1,1,1,0
4652,5.133224634124952,5.498134413624511,5.243988163330975,5.198135268600548,5.198040492394391,5.648165120797999,5.079575182760463,623351.3786764706,0,E01032574,8,0,9,0,0,0,5.144259853833387,5.2996098901949775,5.422323014460454,5.181136145883677,5.152807064607841,5.638529734546635,5.216366904122489,793326.0884353742,0,6,1,8,0,0,0,1.0,0,-2,1,-1,0,0,0
4653,5.411972962743867,5.384256030485882,5.481272678065106,5.063054522847741,5.381007082094022,5.787936028426255,5.226440052676007,402707.9105691057,2,E01032575,7,2,8,2,1,0,5.2909881066875295,5.1671179703303745,5.486124280120144,5.07632032262177,5.30611229043047,5.781725250372366,5.253207892930808,514393.9495798319,1,4,2,7,3,1,0,1.0,-1,-3,0,-1,1,0,0
4654,5.721129106965295,5.1613100646013885,5.7182556703128915,4.715291574677044,5.487584578162209,6.097179104300106,5.795961777156687,60056.064171123,6,E01032576,3,6,1,5,6,8,5.618684482689087,5.149528573911923,5.771388182273278,4.898258551955223,5.44214904652192,6.166999139464819,5.975289155084353,77933.85576923077,5,4,7,3,6,8,9,1.0,-1,1,1,2,1,2,1
4655,5.462399531336664,5.452393477402844,5.423159331951327,4.963689982312397,5.4295863121458625,5.960584128944619,5.582051633052456,60651.43203883495,3,E01032577,8,2,6,3,4,5,5.558166707926128,5.471978210691196,5.537415122511375,5.021961146919288,5.441111242593224,5.9948939672156945,5.65161993491709,78726.18905472636,5,9,3,6,6,5,6,1.0,2,1,1,0,3,1,1
4656,5.207232097957445,5.247083702294723,5.457664444135583,5.063530094727226,5.330803020104118,5.626127297981926,5.1494052005850754,282990.14782608696,0,E01032579,4,2,8,1,0,0,5.215544132085947,5.162976679435143,5.630451788352086,5.119728596393879,5.234635290732751,5.733619857751406,5.397332717822148,364245.8384615385,1,4,5,7,1,1,2,1.0,1,0,3,-1,0,1,2
4657,5.238466320719038,5.1985299042293,5.6257986659095405,5.048345220656622,5.316050479525612,5.886852001008533,5.346047210693359,156543.81904761904,0,E01032580,3,5,7,1,3,2,5.171566277742386,5.066996933094093,5.659166551062039,5.132611649377005,5.272788697055408,5.87332728930882,5.305890371756894,197505.07142857142,0,2,6,8,2,3,1,1.0,0,-1,1,1,1,0,-1
4658,5.427975672322351,5.427146500026858,5.5185202344043836,4.958348980626544,5.375220035378997,5.938542699491656,5.357194919038463,155886.54054054053,2,E01032581,7,3,6,2,4,2,5.2380393676876285,5.394718569998416,5.36513182243205,5.193751150036451,5.120433661508264,5.822695262683845,5.477545045917819,196690.3354037267,1,8,1,8,0,2,3,1.0,-1,1,-2,2,-2,-2,1
4659,5.139664136518643,5.1499998790072645,5.581512615436644,5.171080363547708,5.291584674298294,5.592620886216952,5.330843565970894,558725.7204724409,0,E01032582,3,4,9,1,0,1,5.13159709977934,5.0227497273068415,5.582476525968504,5.199035322538898,5.233984955689237,5.618294954724159,5.40111370782411,711598.0142348754,0,2,4,9,1,0,2,1.0,0,-1,0,0,0,0,1
4660,5.208723076979319,5.135359482765198,5.547556615670522,5.088238867123922,5.35899534145991,5.647593766848246,5.321603558063507,625869.42,0,E01032583,3,4,8,2,0,1,5.21835869923234,5.100201838463545,5.590133017301559,5.095171096175909,5.366001425683498,5.609499677270651,5.464634358137846,793739.775,1,3,4,7,4,0,3,1.0,1,0,0,-1,2,0,2
4661,5.4988201794524985,4.9857973257700605,5.687387354671955,4.938284541169803,5.497340387354295,5.774978180726369,5.516249775886536,630338.1666666666,3,E01032584,1,6,6,5,1,4,5.467268839478493,4.926520057022572,5.762239209243229,5.015469172171184,5.405394309333393,5.85507416512285,5.641335021172251,799308.3660714285,4,1,7,6,5,2,6,1.0,1,0,1,0,0,1,2
4662,6.2998100038784655,5.3131510182399655,5.601756543069336,4.568259567763675,5.859332812959282,6.236994975241855,5.797179855220946,573995.5497512438,9,E01032623,5,4,0,9,8,8,6.0112919589123095,5.378644561767578,5.506465810465525,4.764983262785946,5.64862645591598,6.104503560927977,5.677234364417662,730946.7325301205,9,7,3,1,9,7,6,1.0,0,2,-1,1,0,-1,-2
4663,5.404597994827089,4.758241525718144,5.891328879765102,4.91036411694118,5.6044606027149015,5.691448858806065,5.56800544545764,616952.880952381,2,E01032637,0,8,5,7,0,5,5.182618798279181,4.772054913567334,5.876454318441996,4.891854826996966,5.578465246572727,5.6610713761027265,5.600176747252301,782675.731707317,0,0,8,3,9,0,5,1.0,-2,0,0,-2,2,0,0
4664,5.08427992971932,5.108281664732026,5.58928579237403,5.125232042335883,5.3279277754992975,5.521061658859253,5.350195611395487,616518.2926829269,0,E01032638,2,4,8,1,0,2,5.075731088948804,5.081272197324176,5.683422959128092,5.1375462398972624,5.38786200312681,5.599772375683452,5.371146653973779,782116.4883720931,0,2,6,8,5,0,1,1.0,0,0,2,0,4,0,-1
4665,5.049789244128812,5.180156598168034,5.674412642755816,5.158848795198625,5.212821089452313,5.548613736706395,5.18619143578314,624830.7580645161,0,E01032639,3,6,9,0,0,0,4.994146845557473,5.005820924585516,5.457943851297552,5.2975052486766465,5.0557101206346,5.519137685949152,5.263798323544589,794774.6363636364,0,2,2,9,0,0,0,1.0,0,-1,-4,0,0,0,0
4666,5.244899464208026,4.926884634550228,5.8368914182796034,4.8843505853830385,5.454831461573756,5.82056754688884,5.550537655519885,617039.4418604651,1,E01032640,0,8,5,4,2,5,5.372658809026082,4.921163790755802,5.682985345522563,5.0741994976997375,5.669399374061161,5.761007613605923,5.484437829918331,782730.9444444445,2,1,6,7,9,1,3,1.0,1,1,-2,2,5,-1,-2
4667,5.310720488289807,4.9430459158442845,5.714209527612846,4.966649711689103,5.558596639989693,5.673405789883337,5.493372089394899,618559.2242990654,1,E01032646,1,6,6,6,0,4,5.305751506141994,4.929310809011045,5.654955375712851,4.997484637343365,5.46852581086366,5.7234076137128085,5.399178409576416,785035.0260869565,2,1,5,5,7,1,2,1.0,1,0,-1,-1,1,1,-2
4668,5.2334182317866835,5.221613504165827,5.597728551820267,4.993420631386513,5.281493716461714,5.727377561635749,5.378036496251128,624847.6279069767,0,E01032719,4,4,6,1,1,2,5.334848845005036,4.957438671588898,5.587859702110291,4.876532781124115,5.357528877258301,5.778286814689636,5.363600468635559,795090.0,2,1,4,3,4,1,1,1.0,2,-3,0,-3,3,0,-1
4669,5.335245272919939,5.201112356701413,5.521899343181301,5.140830983342351,5.3666888314324455,5.6661076700365225,5.299365809157088,624139.8324324324,1,E01032720,3,3,9,2,0,1,5.093839248021443,5.403950611750285,4.774006446202596,5.484858433405559,5.581565856933594,5.263279755910237,4.985072493553162,791454.3333333334,0,8,0,9,9,0,0,1.0,-1,5,-3,0,7,0,-1
4670,5.64260837614862,5.081162295706285,5.621684578598523,4.855312627521369,5.514892530571568,5.848486179862517,5.471502084549659,624558.1038251367,5,E01032722,2,5,4,5,2,4,4.550368706385295,4.896021366119385,5.0560078620910645,5.6093348662058515,5.306751489639282,5.401166041692098,4.782900452613831,794416.0,0,0,0,9,3,0,0,1.0,-5,-2,-5,5,-2,-2,-4
4671,5.300265562497765,4.826498435867345,5.839666829335909,5.0180406052093565,5.479405735442244,5.737487348859296,5.627882981775729,1509.7507668711658,1,E01032739,0,8,7,5,1,6,5.314923427499894,4.802587650144579,5.7939943059934045,5.025622061922257,5.390248807716602,5.7298585069745815,5.729598138857991,2114.5548112058464,2,0,8,6,5,1,7,1.0,1,0,0,-1,0,0,1
4672,5.301975480760589,4.818359146967079,5.80689299332373,5.049653489481319,5.476791327649897,5.740255117416382,5.660473373351675,3053.941287878788,1,E01032740,0,7,7,4,1,7,5.3243163074930955,4.835794034027321,5.7779239583670225,5.006460147065762,5.426115888578634,5.742679144723735,5.653925381107361,4069.9854604200323,2,0,7,5,6,1,6,1.0,1,0,0,-2,2,0,-1
4673,5.263481806414996,5.373305380806443,5.395756725192994,5.085142513578252,5.3649128084034885,5.778623660405477,5.375180030978004,164995.97674418605,1,E01032741,6,1,8,2,1,2,5.176233964761098,5.321457215150198,5.375581448078155,5.233276032606761,5.153736585776011,5.775548349221547,5.51386914173762,206346.76,0,7,1,9,0,1,3,1.0,-1,1,0,1,-2,0,1
4674,5.572195871855861,5.324102457179579,5.637963332871134,5.023275490879088,5.505361976549607,6.056830716687579,5.475369281547014,266437.1550387597,4,E01032742,6,5,7,5,6,4,5.572217153079474,5.310301500469891,5.59024305841816,5.095830466320265,5.312230787170467,6.042640356875178,5.661520971291101,333100.25373134325,5,6,4,7,3,6,6,1.0,1,0,-1,0,-2,0,2
4675,5.141966202219979,5.504551051092929,5.335707938084837,5.251696619831148,5.2369485819926025,5.726753395111834,5.311710517914569,432419.2950819672,0,E01032743,8,1,9,0,1,1,5.385597696900367,5.389447964727879,5.4087609350681305,5.087428919970989,5.2813853323459625,5.894492271542549,5.364337952435017,552284.525,3,8,1,7,2,3,1,1.0,3,0,0,-2,2,2,0
4676,5.231861901434162,5.5370773356172105,5.4501486518715,5.139692444590073,5.248498860793777,5.754710549040686,5.395087129707578,432010.10759493674,0,E01032744,9,2,9,0,1,2,5.335205101966858,5.466310623112847,5.538420184920816,5.1028782087213855,5.341900767999537,5.839319050312042,5.365048306128558,551775.6294117647,2,9,3,7,4,2,1,1.0,2,0,1,-2,4,1,-1
4677,4.8430537644852985,5.581299725999224,5.06456864235249,5.485246773476296,4.980908017462872,5.299838373508859,5.013510089224957,561638.0893617021,0,E01032764,9,0,9,0,0,0,4.951408256776631,5.445946716237813,5.194265721365809,5.385090592317283,4.997249386738986,5.47612250642851,5.198429598938674,710450.38671875,0,8,0,9,0,0,0,1.0,0,-1,0,0,0,0,0
4678,5.025452762534938,5.419345071635296,5.370549598919976,5.332106118349685,5.100066119862586,5.565973171253794,5.169556406355396,618021.8453608247,0,E01032765,7,1,9,0,0,0,5.12676450136666,5.327269215450109,5.491069246675367,5.226085735258655,5.194606003360214,5.716997081988326,5.3641539823229065,782594.4579439253,0,7,2,9,1,0,1,1.0,0,0,1,0,1,0,1
4679,5.088640852769216,5.046594007809957,5.626696340243021,5.097157241900762,5.428112085660299,5.60041716893514,5.483779958883921,730595.8,0,E01032766,1,5,8,3,0,4,5.14258683439511,4.936279880466746,5.752403173873674,5.071647047996521,5.415410500853809,5.605466294644484,5.425675924144574,927830.4776119404,0,1,7,7,5,0,2,1.0,0,0,2,-1,2,0,-2
4680,5.0979441634246285,5.0625667112214225,5.634491447040013,5.124850308895111,5.436401068312781,5.638090544087547,5.317406094925744,558152.3142857143,0,E01032767,2,5,8,3,0,1,5.185746862398868,5.00470789378842,5.721640826850537,5.084321933076871,5.473675967052283,5.698030323382245,5.494954369715508,743099.5761589404,0,1,7,7,7,0,3,1.0,0,-1,2,-1,4,0,2
4681,4.859148451776216,5.447660782120445,5.243903774203676,5.105693101882935,5.127944642847234,5.274319941347295,5.355908173503297,728838.8484848485,0,E01032768,8,0,8,0,0,2,4.993042770028114,5.211997148394585,5.2451947063207625,5.217166143655777,5.1005223333835605,5.470969462394715,5.543691027164459,925538.2,0,5,0,9,0,0,4,1.0,0,-3,0,1,0,0,2
4682,4.894396846709044,5.314674496650696,5.328502201515695,5.185584203056667,5.163570983254391,5.366086122782334,5.194773409677588,724073.5652173914,0,E01032769,5,1,9,0,0,0,4.8874488898686,5.204704766235654,5.327809973368569,5.313945414528014,5.1476938175776645,5.419082143950084,5.220807413260142,913021.1111111111,0,4,1,9,0,0,0,1.0,0,-1,0,0,0,0,0
4683,5.3057858149210615,5.3397259094097,5.698273261388143,5.085821487285473,5.406401369306776,5.886968480216132,5.295633461740282,501496.85185185185,1,E01032770,6,6,8,3,3,1,5.082518450419108,5.147386515140534,5.7223153432210285,4.991494965553284,5.206087561448415,5.769697666168213,5.325770004590352,640365.0666666667,0,4,7,5,1,1,1,1.0,-1,-2,1,-3,-2,-2,0
4684,5.440058520546666,5.165743790290974,5.606342823417099,5.028070460866998,5.502157151699066,5.77114639017317,5.4416310919655695,515970.7037037037,2,E01032771,3,4,7,5,1,3,5.1738275470155655,5.090930550387411,5.6434143167553525,5.200605666998661,5.352571420597307,5.731321053071455,5.516890357841145,651130.4848484849,0,3,5,9,4,1,4,1.0,-2,0,1,2,-1,0,1
4685,5.34499832500111,5.168959992582148,5.746045767177235,5.0179488550532945,5.410194498842412,5.862510369040749,5.430062276666814,517226.10909090907,1,E01032772,3,7,7,3,2,3,5.230535979998314,5.077450087514975,5.660204269118228,5.190361509888859,5.347137582504143,5.7660851640216375,5.372287241079039,658842.6101694915,1,2,6,8,4,1,1,1.0,0,-1,-1,1,1,-1,-2
4686,5.697184801101685,4.879763126373291,5.582434756415231,4.834394097328186,5.5941310950687955,5.614329133714948,5.731449808393206,495077.71428571426,5,E01032773,0,4,4,7,0,8,5.601450532674789,5.041610702872276,5.861536383628845,5.048399478197098,5.604993015527725,5.8173026740550995,5.619582265615463,633211.375,5,2,8,6,9,2,5,1.0,0,2,4,2,2,2,-3
4687,5.578603062518807,5.211318085359973,5.681145069211028,4.91284117865008,5.474067823831425,5.971151141233222,5.420732046282569,525329.6046511628,4,E01032774,4,6,5,4,4,3,5.469074204856274,4.987995540394502,5.7167247370177625,4.911140907044504,5.364900897530949,6.000338540357702,5.568302738900278,675427.1764705882,4,1,7,3,4,5,4,1.0,0,-3,1,-2,0,1,1
4688,4.623436620602241,5.730238875517478,4.902943349801577,5.568372465096987,4.848009338745704,5.227573956434544,5.294087964754838,494303.6153846154,0,E01032776,9,0,9,0,0,1,4.972571935810026,5.435328978006957,5.216108935778259,5.389539679542917,4.946475009449193,5.624226742103452,5.420318355325793,632012.8852459016,0,8,0,9,0,0,2,1.0,0,-1,0,0,0,0,1
4689,4.845699557116334,5.373901763432462,5.18966351428502,5.467880467293968,5.0876732896751085,5.348432060698388,5.204349673969645,506206.323943662,0,E01032777,6,0,9,0,0,0,4.943709933614156,5.32291236124843,5.283555418612009,5.342265785458577,5.06184873667108,5.491522606596889,5.326211000063333,648554.8072289156,0,7,0,9,0,0,1,1.0,0,1,0,0,0,0,1
4690,4.843982004571235,5.834774747662161,4.893487393856049,5.523884712964639,4.860484395904103,5.256991656347253,4.9688196237059845,512308.9540229885,0,E01032778,9,0,9,0,0,0,4.868317580790746,5.541735178516024,5.130084667887006,5.403619102069309,4.9421032275472365,5.444363277866727,5.1779642190252035,653354.4428571429,0,9,0,9,0,0,0,1.0,0,0,0,0,0,0,0
4691,4.263397616147995,5.919448673725128,4.542848581075669,5.3050661444664,4.758203321695328,4.949574095010758,5.014284729957581,494386.5,0,E01032779,9,0,9,0,0,0,4.490592660903931,5.311709728240967,5.0490600824356076,5.529392404556274,4.735197005271911,5.41715292930603,5.304097843170166,632207.08,0,6,0,9,0,0,1,1.0,0,-3,0,0,0,0,1
4692,5.005422282994278,5.497104604069779,5.2112015127166496,5.317255668523835,5.12483698178113,5.465848677526645,5.206685424820194,494510.44715447153,0,E01032780,8,0,9,0,0,0,4.908322359933409,5.355404182922008,5.273580151934956,5.353043432152549,4.981838012850562,5.568382612494535,5.399055980665739,632325.0930232558,0,7,0,9,0,0,2,1.0,0,-1,0,0,0,0,2
4693,5.081706721207191,5.058690523279124,5.685340486723801,5.189230964101594,5.445032391054877,5.715996577821929,5.181756044256276,652442.6206896552,0,E01032781,2,6,9,4,1,0,5.020327231713703,5.127086473362787,5.478693800313132,5.214253915207727,5.257003656455448,5.645011646406991,5.3489380819456915,839198.9642857143,0,3,2,9,2,0,1,1.0,0,1,-4,0,-2,-1,1
4694,4.9905265753085795,5.2821610661653375,5.526675485647642,5.121828650052731,5.189457405071992,5.581570373131679,5.41777393909601,588868.2115384615,0,E01032782,5,3,8,0,0,3,5.057095026213025,5.215807331932916,5.619293875164455,5.2898580233256025,5.269933288059537,5.716687985828945,5.478564101552206,757138.2698412698,0,5,5,9,2,0,3,1.0,0,0,2,1,2,0,0
4695,5.212348568607384,5.423228512347584,5.49592663536609,5.0509437658417395,5.293629634548241,5.801029504184991,5.33467738057526,278781.95774647885,0,E01032783,7,3,7,1,1,1,5.334978496206218,5.239293073785716,5.590612888336182,5.017521527306787,5.317102086955104,5.963017130720204,5.709598652247725,358603.9310344828,2,5,4,6,3,4,7,1.0,2,-2,1,-1,2,3,6
4696,5.4580786138210655,5.128804362045144,5.76693691397613,4.975948565411118,5.381200412534318,5.852250130671375,5.292611828390157,638321.0188679246,3,E01032784,2,7,6,2,2,1,5.302003107172378,5.217189994264157,5.702788677621395,4.999535705180878,5.3552605192712015,5.907079214745379,5.458163730641629,809454.7021276596,2,5,6,5,4,3,3,1.0,-1,3,-1,-1,2,1,2
4697,5.257022305771157,5.19934046709979,5.576884013635141,5.072740961004187,5.359837055206299,5.805196276417485,5.518128721802323,639483.1481481482,1,E01032785,3,4,8,2,2,4,5.255915691978053,5.071175054499977,5.690092839692769,5.115946223861293,5.256560520121925,5.824907434614081,5.613215402552956,810910.5789473684,1,2,6,7,2,2,5,1.0,0,-1,2,-1,0,0,1
4698,5.345928045029336,5.273727404310348,5.680670342546828,4.961962687208297,5.31304092610136,5.769441092267949,5.4367243558802505,639759.8936170213,1,E01032786,5,6,6,1,1,3,5.272478796284775,5.05450512006365,5.516696350327853,5.119260584485942,5.28403869374045,5.8129109596383985,5.487463102258485,811318.2931034482,1,2,3,7,2,2,3,1.0,0,-3,-3,1,1,1,0
4699,5.299803089637023,5.326480941130565,5.545414937230257,5.014622440704932,5.361555187748029,5.728039312821168,5.307237076071592,640229.375,1,E01032787,6,4,7,2,1,1,5.254513103311712,5.119029207663103,5.652021221681075,5.027147494662891,5.37568618926135,5.861223907904192,5.345532960241491,811903.1727272727,1,3,5,6,4,2,1,1.0,0,-3,1,-1,2,1,0
4700,5.469780101051813,5.1131610115872155,5.753713939763323,4.888582653637174,5.315275003638448,6.029511168033262,5.6229338283780255,87432.15189873418,3,E01032788,2,7,5,1,5,6,5.428590339693156,5.149439890276302,5.712656376036731,4.906799052249301,5.246279262683609,5.979356026107615,5.5051259967413815,111630.20454545454,3,4,6,3,2,5,3,1.0,0,2,-1,-2,1,0,-3
4701,5.7008134196786315,5.009840895147884,5.912389615002801,4.7408723901299865,5.5627055168151855,6.173713866402121,5.987376886255601,79150.05882352941,5,E01032789,1,8,2,7,7,9,5.739313542842865,4.923246145248413,5.655112107594808,4.8255531787872314,5.296250641345978,5.883799493312836,5.738239089647929,102523.58333333333,7,1,5,2,2,3,7,1.0,2,0,-3,0,-5,-4,-2
4702,5.240801885724068,5.346503272652626,5.500949412584305,4.957990288734436,5.439379021525383,5.762612655758858,5.546088084578514,87422.5625,1,E01032790,6,3,6,4,1,5,5.323102131485939,5.237813323736191,5.380813911557198,5.11159273982048,5.449493303894997,5.553318448364735,5.3840968906879425,111606.3125,2,5,1,7,6,0,1,1.0,1,-1,-2,1,2,-1,-4
4703,5.127505558602353,5.118102261360655,5.529080573548662,5.0821666514619865,5.38977824627085,5.672273209754457,5.344347679868657,619361.5531914893,0,E01032803,2,3,8,3,0,2,5.323803353309631,4.8185646623373035,5.598543792963028,5.024664318561554,5.414599120616913,5.761318075656891,5.5750621348619465,785918.9,2,0,4,6,5,1,5,1.0,2,-2,1,-2,2,1,3
4704,5.376041478580898,5.203586050108368,5.592741988063637,5.0963329715666426,5.304776232227002,5.779053485471438,5.377997337603102,294302.3790849673,2,E01032805,4,4,8,1,1,2,5.382359977740391,5.0916674053593045,5.654210032930799,5.029185724865859,5.2988027243097875,5.804489623209474,5.462456508047262,377775.8280254777,3,3,5,6,3,1,3,1.0,1,-1,1,-2,2,0,1
4705,5.272944173812866,5.049553060531617,5.774218034744263,5.013077163696289,5.53476233959198,5.692720699310303,5.37204384803772,616810.08,1,E01032834,1,7,7,6,0,2,5.263684780701347,4.903222913327425,5.677884495776633,4.937451129374296,5.609468035075976,5.609395929004835,5.542030075322026,782489.4347826086,1,1,6,4,9,0,4,1.0,0,0,-1,-3,3,0,2
4706,5.019361715941202,5.496437629063924,5.269184545392082,5.294519017140071,5.112778525976908,5.640150422141666,5.0996302763621015,223326.5357142857,0,E01033000,8,0,9,0,0,0,5.041141098453885,5.542094534351712,5.1557808092662265,5.379050297396524,5.078495550723303,5.582809740588779,5.2552328790937155,286831.3214285714,0,9,0,9,0,0,0,1.0,0,1,0,0,0,0,0
4707,5.263343907537914,5.158347087247031,5.505657956713722,4.857901153110323,5.334365305446443,5.746129745528812,5.404891840049198,223380.07142857142,1,E01033030,3,3,4,2,1,2,5.206513129028619,5.244100343947317,5.466283933789122,5.199640645700343,5.065924546297858,5.690705163806093,5.451357925639433,287181.1568627451,1,5,2,9,0,0,2,1.0,0,2,-1,5,-2,-1,0
4708,5.274849510192871,5.220838594436645,5.503425871242176,5.1692826877940785,5.341607657345858,5.67471717487682,5.219319402087819,186669.41818181818,1,E01033081,4,3,9,2,0,0,5.2820999083980436,5.1611264405712,5.6030318390938545,5.057724039400777,5.386230197645003,5.82863555031438,5.4321982533701005,236325.40322580645,1,4,5,6,5,2,2,1.0,0,0,2,-3,3,2,2
4709,5.348958184753639,5.3221863456394365,5.342696504316468,5.162113896314649,5.330364410428033,5.681451099506323,5.287962915240854,187380.76811594202,1,E01033082,6,1,9,1,0,1,5.023989845911662,5.383940598169962,5.275509080886841,5.189131345748901,5.13308690071106,5.57901330947876,5.150142512321472,237375.62666666668,0,8,0,8,0,0,0,1.0,-1,2,-1,-1,-1,0,-1
4710,4.902787446975708,5.3547271315644425,5.4539531207666165,5.216968728274834,5.136094942325499,5.56408154092184,5.259893836044684,212569.26829268291,0,E01033083,6,2,9,0,0,1,5.020687765734536,5.07640871490751,5.519759341648647,5.179274804251534,5.247169644492013,5.743903289522444,5.440165284701756,271089.1142857143,0,2,3,8,2,1,2,1.0,0,-4,1,-1,2,1,1
4711,5.396259878435705,5.333744914103777,5.527659132949307,5.044163265798846,5.388679614433875,5.818975515854665,5.251839404432182,212667.97435897434,2,E01033084,6,3,7,3,2,1,5.320218815578251,5.188283752268694,5.563162403782521,5.1422093581026935,5.328912909575335,5.831914432405487,5.3859472471898,271686.53543307085,2,4,4,8,3,2,1,1.0,0,-2,1,1,0,0,0
4712,5.336867764228728,5.252121573541222,5.4201966800340795,5.140776645846483,5.333362435422292,5.682638492526078,5.2395663930148615,397377.3292682927,1,E01033085,4,2,9,1,0,1,5.315366286039352,5.220594544708729,5.436057396233082,5.195205582678318,5.259085088968277,5.74617230296135,5.420189602673053,507007.7,2,5,2,9,2,1,2,1.0,1,1,0,0,1,1,1
4713,5.376108944416046,5.4001723527908325,5.471313612801688,5.030548151050295,5.384977449263845,5.789759503943579,5.147740921803883,399721.375,2,E01033086,7,2,7,2,1,0,4.983958663478974,5.3794310650517865,5.351927368871627,5.169660137545678,5.1049766502072735,5.679407742715651,5.304823863890864,511436.93548387097,0,8,1,8,0,0,1,1.0,-2,1,-1,1,-2,-1,1
4714,5.343185143117552,5.218208657370673,5.5901855424598415,4.985282848499439,5.435511650862517,5.849390049333926,5.334621931005407,89690.4074074074,1,E01033093,4,4,6,3,2,1,5.338182984234451,5.074305074555533,5.641062541441484,5.049001441373454,5.394287511125787,5.864496300746868,5.550155301372726,114645.22077922078,2,2,5,6,5,2,4,1.0,1,-2,1,0,2,0,3
4715,5.327713131904602,5.2909458101841444,5.337962982947366,5.104724440658302,5.286023060480754,5.680460611979167,5.4551598272825546,70991.1052631579,1,E01033098,5,1,8,1,0,3,5.607292115131271,5.224861606259212,5.41510769251351,5.055478595127569,5.371605164536806,5.685564955818319,5.418749723479013,92050.33644859813,5,5,1,6,4,0,2,1.0,4,0,0,-2,3,0,-1
4716,5.195297274324629,5.330004245705075,5.516639153162639,5.1384522822168135,5.302317806084951,5.667304997973972,5.383688651190864,76935.8,0,E01033099,6,3,9,1,0,2,5.196988181634382,5.227564855055376,5.504720965569669,5.151214542714032,5.190329191359607,5.671949497678063,5.361265951936895,98947.875,1,5,3,8,1,0,1,1.0,1,-1,0,-1,0,0,-1
4717,5.200370087510064,5.1131202933334166,5.629942607311976,5.142927439439864,5.381252498853774,5.6614453721614115,5.209783450478599,70936.98809523809,0,E01033100,2,5,9,2,0,0,5.256946524848109,4.975278022496597,5.682312986125117,5.121148377656937,5.351585107005161,5.730876720469931,5.426936700292256,91863.46739130435,1,1,6,8,4,1,2,1.0,1,-1,1,-1,2,1,2
4718,5.113492528597514,5.428675827525911,5.384477240698678,5.2471869521670875,5.188485947866289,5.545487475773645,5.1274719086904375,79874.53968253969,0,E01033101,7,1,9,0,0,0,5.226049408807859,5.197158709987179,5.535744685393113,5.116514593690306,5.2689167103924595,5.639656115364242,5.361064208732857,103003.43956043955,1,4,3,7,2,0,1,1.0,1,-3,2,-2,2,0,1
4719,4.904944393503007,5.484951819606762,5.162425216118894,5.38166222260825,5.07648648448925,5.494458540001107,5.067935877708933,70725.9648241206,0,E01033132,8,0,9,0,0,0,5.007508966158021,5.387214281648959,5.294086352834162,5.353541501288144,4.992759124288019,5.534473364083272,5.229812987570493,91616.50943396226,0,8,0,9,0,0,0,1.0,0,0,0,0,0,0,0
4720,5.25691694021225,5.318229407072067,5.462584361433983,5.057343631982803,5.243077144026756,5.649357587099075,5.255414925515652,75601.0625,1,E01033133,5,2,8,0,0,1,5.172539735662526,5.08988828494631,5.496510801644161,5.106858031503085,5.183007741796559,5.723601678322101,5.381166129276671,97922.03448275862,0,3,3,7,1,1,1,1.0,-1,-2,1,-1,1,1,0
4721,5.8331251535259305,4.998627621619428,5.790802603862325,4.68506449949546,5.544539861991757,6.2302710775469174,5.62172387467056,90428.09836065574,7,E01033135,1,7,1,6,8,6,5.893904115472521,4.808087031756129,5.894088702542441,4.63347670010158,5.499247657401221,6.273412270205362,5.75114985874721,115375.14285714286,8,0,8,0,7,9,8,1.0,1,-1,1,-1,1,1,2
4722,5.27511191368103,5.661468837530382,5.168958063087156,5.216991447633313,5.114133709861386,5.676506663522413,5.335943912306139,607245.2741935484,1,E01033146,9,0,9,0,0,2,5.329283435842884,5.426732595287152,5.362868307241753,5.197160522439587,5.250217807826711,5.746352304273577,5.2587431064292565,770731.0149253731,2,8,1,9,2,1,0,1.0,1,-1,1,0,2,1,-2
4723,5.553997466883321,5.509093556817122,5.385499813425259,4.945689787076214,5.326887200197835,5.93769560273238,5.484470542960279,649265.6692913385,4,E01033150,8,1,6,1,3,4,5.393433252970378,5.439471324284871,5.094808022181193,4.994834899902344,5.382109085718791,6.059237877527873,6.066402196884155,823613.0,3,8,0,5,5,6,9,1.0,-1,0,-1,-1,4,3,5
4724,5.070317951889781,5.689999368283655,5.077142820729838,5.254642568625413,5.023894977259945,5.516724025274252,5.003444879085986,607106.1623376623,0,E01033151,9,0,9,0,0,0,5.129813941749367,5.5126417464501145,5.152651246335055,5.283444114633508,5.054295439172435,5.594088280523145,5.045598601972735,770702.8851351351,0,9,0,9,0,0,0,1.0,0,0,0,0,0,0,0
4725,5.210902327649734,5.300222574963289,5.529051423072815,5.196312382641961,5.272325694561005,5.73087337437798,5.203005046003005,588466.1823529411,0,E01033153,5,3,9,1,1,0,5.19709905172359,5.122255135133776,5.604772297633176,5.136809472403774,5.250814085061839,5.823162418569444,5.410023548010456,748863.034682081,1,3,5,8,2,2,2,1.0,1,-2,2,-1,1,1,2
4726,5.32372640138902,5.255565454375069,5.553633554926458,5.018117497552116,5.337758838005786,5.7596561788762894,5.339255964980935,440610.9811320755,1,E01033207,4,4,7,2,1,2,5.302503976225853,5.033198677003384,5.61694737225771,4.989358024299145,5.2375282242894174,5.762867128103972,5.475628948956728,543437.33125,2,2,5,5,1,1,3,1.0,1,-2,1,-2,-1,0,1
4727,4.96518087387085,5.177679711266568,5.625457826413606,5.285176804191188,5.072649190300389,5.719534221448396,5.573415646427556,425449.2894736842,0,E01033208,3,5,9,0,1,5,5.036281749054238,5.1406033635139465,5.713206467805086,5.2962022225062055,5.082379248407152,5.8576517811527955,5.674709247218238,568921.6296296297,0,3,6,9,0,2,6,1.0,0,0,1,0,0,1,1
4728,5.960393959542979,5.180487508359163,5.831246270304141,4.644593532189079,5.596531020040097,6.286625587421915,5.8472573923028035,272746.25217391306,8,E01033320,3,8,0,7,9,9,5.76062919581232,5.11062364538839,5.7128714884608245,4.889137636531483,5.4947728086109,6.136689580176488,5.68785590770816,350963.35537190083,7,3,6,3,7,8,7,1.0,-1,0,-2,3,0,-1,-2
4729,5.568232397564122,5.110817395272802,5.711678508852349,4.793093853309506,5.4775231119062076,6.038391551033396,5.5586888731503095,272210.4262295082,4,E01033322,2,6,3,4,5,5,5.578361850231886,5.202159924432635,5.685604948550463,4.961701482534409,5.359442133456469,5.957558307796717,5.531388970091939,350368.296875,5,4,6,4,4,4,4,1.0,1,2,0,1,0,-1,-1
4730,5.5707593361536665,5.251120587652044,5.565612595210704,4.856201838153277,5.420259111611418,5.904159854548846,5.431109141933826,286530.87596899224,4,E01033324,4,4,4,3,3,3,5.53250362763878,5.0878655118796665,5.557382874816429,4.99569798880861,5.283926859156776,5.902065692057136,5.464509042164751,368259.3358778626,4,3,4,5,2,3,3,1.0,0,-1,0,1,-1,0,0
4731,5.280249106256585,5.619237109234459,5.191250060733996,5.197653770446777,5.360253748140837,5.66546294563695,5.205083621175666,286132.4736842105,1,E01033325,9,0,9,2,0,0,5.525251378183779,5.434841073077658,5.44939514865046,4.974058166794155,5.443820134453151,5.753652137258778,5.337003293244735,367819.3043478261,4,8,2,5,6,1,1,1.0,3,-1,2,-4,4,1,1
4732,5.476198082912468,5.1566110670923475,5.643574837439075,4.990288709452052,5.389923534707395,5.934384268914868,5.447537519974623,273825.1856287425,3,E01033327,3,5,6,3,3,3,5.492550209574743,4.988748577209788,5.71728943630096,4.927413856217621,5.3055843689026085,5.915091759021129,5.6022743353056255,352838.27981651376,4,1,7,4,3,3,5,1.0,1,-2,2,-2,0,0,2
4733,5.476593604840731,5.108247287649857,5.662348054584704,4.910221417326676,5.441098032499615,6.038200551585147,5.601069638603612,273939.4421052632,3,E01033341,2,5,5,4,5,6,5.488251264890035,5.097114162974887,5.768025008837382,5.021582404772441,5.365062718921237,6.011168026924134,5.615402868058946,352555.0333333333,4,3,7,6,4,5,5,1.0,1,1,2,1,0,0,-1
4734,4.864045463019996,5.556749143188806,5.276478415770496,5.391800953329896,5.123810021139735,5.4584740211637754,5.1318686994717275,33611.26618705036,0,E01033424,9,0,9,0,0,0,4.950898196016039,5.127553049398928,5.516136738718773,5.321732545385555,5.141661111189395,5.6409013776146635,5.481989432962573,43807.005102040814,0,3,3,9,0,0,3,1.0,0,-6,3,0,0,0,3
4735,5.350065112113953,4.958932006359101,5.9243538331985475,4.923807277679443,5.439643120765686,5.830289549827576,5.4583428812026975,437517.64,1,E01033455,1,9,5,4,2,3,5.324890928448371,4.728584984563431,5.928341744081029,4.928747856392051,5.423135712461652,5.804815913146397,5.550056965845935,560863.5094339623,2,0,9,4,6,1,4,1.0,1,-1,0,-1,2,-1,1
4736,5.481591425016912,5.3303973425121205,5.421918797867461,5.032050763749328,5.327065235033086,5.858243615215361,5.375282736348856,418070.02617801045,3,E01033456,6,2,7,1,2,2,5.377078600704963,5.282931780580229,5.462153778874815,5.067931016677706,5.097435863734466,5.853795091506883,5.387508902056464,533692.487684729,2,6,2,7,0,2,1,1.0,-1,0,0,0,-1,0,-1
4737,5.71359918951019,5.198479543856489,5.642384759778899,4.892632533864277,5.527683008007887,6.0596941525374,5.7300929945658865,32922.58536585366,6,E01033457,3,5,5,6,6,8,5.62716300220325,5.055749905520472,5.738652630098935,4.9584142791813814,5.410378707893964,6.097924873746675,5.692344526792395,42814.89655172414,6,2,7,4,5,7,7,1.0,0,-1,2,-1,-1,1,-1
4738,5.5618251813575625,5.388685727957636,5.4718762007541955,4.926619632635266,5.454467538744211,6.049407782964408,5.628662996925414,27824.6015625,4,E01033463,7,2,5,4,5,6,5.602496038590159,5.301721686124802,5.587619876861572,4.926704560433115,5.421135952642985,6.095671893017633,5.782094027740615,36414.24285714285,5,6,4,4,6,7,8,1.0,1,-1,2,-1,2,2,2
4739,5.424856284134824,5.349865302233629,5.667183283349158,5.083043571089355,5.2842061217402065,5.99655595799567,5.597445978245265,472142.28873239434,2,E01033464,6,5,8,1,4,6,5.2147316336631775,5.3052791078885395,5.592755276362102,5.133967893123627,5.112682741483052,5.843600505193074,5.4369552270571395,604056.0266666666,1,6,4,8,0,2,2,1.0,-1,0,-1,0,-1,-2,-4
4740,5.682290763904651,4.998080688218276,5.8102849672238035,4.83040714263916,5.4961631918946905,6.061556336780389,5.574117638170719,421881.96875,5,E01033485,1,7,3,5,6,5,5.6789972324564,4.993331322766314,5.804129600524902,4.807962706594756,5.328450133102109,6.059095447713679,5.566754815554378,539392.595959596,6,1,8,2,3,6,4,1.0,1,0,1,-1,-2,0,-1
4741,5.4592657424509525,5.192606024444103,5.550814367830753,4.944167794659734,5.522835247218609,5.760965783149004,5.2821092791855335,114266.421875,3,E01033486,3,4,6,6,1,1,5.5491430721585715,5.114118540097797,5.563748314267113,4.963884251458304,5.525399098320613,5.828670482786875,5.500912626584371,144862.57142857142,5,3,4,5,8,2,3,1.0,2,0,0,-1,2,1,2
4742,5.385726014773051,5.182007206810845,5.85869116253323,5.042077951961094,5.646825353304545,5.821476048893398,5.141377574867672,114252.44444444444,2,E01033487,3,8,7,8,2,0,5.301883310079575,5.070794063806534,5.600237250328064,4.9897249102592465,5.492141437530518,5.772110939025879,5.303545725345612,144855.15,2,2,4,5,7,1,1,1.0,0,-1,-4,-2,-1,-1,1
4743,5.2741983508410515,5.163222076141671,5.664061232788922,5.057508849117854,5.43345095033515,5.656932641382086,5.296499353565582,114320.69863013699,1,E01033488,3,5,8,3,0,1,5.414051510918308,4.987703518128731,5.722348683316943,5.078982979478971,5.435167020475361,5.815723362103315,5.4100458269387905,144940.35211267605,3,1,7,7,6,2,2,1.0,2,-2,2,-1,3,2,1
4744,5.1602179904778795,4.790499410458973,5.717035069352105,4.974065093767075,5.551290864036197,5.744652540910812,5.455820171605973,64231.94047619047,0,E01033489,0,6,6,6,1,3,5.2044579274249525,4.816093313244154,5.7695898334935025,4.9973148422421145,5.449088649929695,5.665507927255811,5.515298811894543,84093.60377358491,1,0,7,5,6,0,3,1.0,1,0,1,-1,0,-1,0
4745,5.174856198352316,4.8234173163123755,5.713132860349572,5.082023165536963,5.454293418967206,5.605430986570275,5.406104029779849,39377.747826086954,0,E01033490,0,6,8,4,0,2,5.110478637946977,4.866501493586434,5.704239981042014,5.153429011503856,5.374157668815719,5.593445747262901,5.453857464094956,61918.67361111111,0,0,6,8,4,0,2,1.0,0,0,0,0,0,0,0
4746,5.328689855023434,5.008570706216912,5.830251771525333,4.950677224209434,5.42935031087775,5.809161934099699,5.514795741282011,113710.8947368421,1,E01033491,1,8,6,3,2,4,5.476377970293949,4.929459785160265,5.846184180912219,4.895755431526585,5.3719107916480615,5.839801930126391,5.595718412650259,144189.94736842104,4,1,8,3,4,2,5,1.0,3,0,0,-3,1,0,1
4747,5.365018159692938,5.110506296157837,5.774196288802407,4.965831258080223,5.382146657596935,5.887413315339522,5.384998087449508,113619.74545454545,2,E01033492,2,7,6,2,3,2,5.256225207022259,5.117319170917783,5.603618651628494,5.028813262070928,5.3044456626687735,5.7635122793061395,5.415416904858181,144122.5357142857,1,3,5,6,3,1,2,1.0,-1,1,-2,0,1,-2,0
4748,5.452683478593826,4.93211430311203,6.224186033010483,4.608214303851128,5.498613268136978,6.178351104259491,5.714856743812561,112381.125,3,E01033493,0,9,0,5,7,7,5.929731667041779,4.508417636156082,5.869547486305237,4.723378419876099,5.534670531749725,5.970743656158447,5.424579977989197,142611.0,9,0,8,0,8,5,2,1.0,6,0,-1,0,3,-2,-5
4749,5.702145995813257,4.9322630152982825,5.8490314764135025,4.827798690515406,5.4651819355347575,6.080636462043313,5.661325019948623,112417.31764705882,5,E01033494,0,8,3,4,6,7,5.613979350893121,4.892746985586066,5.954108920850252,4.915199070227773,5.399405833294517,6.073465101342452,5.68094475896735,142627.2947368421,5,0,9,4,5,7,7,1.0,0,0,1,1,1,1,0
4750,5.25024958010073,5.606059297367379,5.302827742364672,5.17801437554536,5.248773782341568,5.635323550966051,5.099260588486989,18495.24074074074,1,E01033568,9,0,9,0,0,0,5.469071563747194,5.229519168535869,5.575361877679825,5.031964838504791,5.474457876549827,5.898307740688324,5.496128410100937,24393.569444444445,4,5,4,6,7,3,3,1.0,3,-4,4,-3,7,3,3
4751,5.320587100806059,5.229743958623321,5.6302801503075495,5.090988112820519,5.309048304955165,5.8846453781481145,5.414909467652992,17779.12037037037,1,E01033569,4,5,8,1,3,3,5.369428609098707,5.121629779300992,5.709379502705166,5.08301231785426,5.4293984685625345,5.943681542835538,5.614455565573677,23524.81746031746,2,3,6,7,6,4,5,1.0,1,-1,1,-1,5,1,2
4752,5.863036988675594,5.3886936292052265,5.5141775727272035,4.787016500532627,5.450717571377754,6.009126681089401,5.538003444671631,189549.9875,7,E01033570,7,3,3,4,5,5,6.029715823275702,5.351912382457938,5.444121026567051,4.692231700888702,5.571497183825288,6.042889703597341,5.63492950797081,240433.5357142857,9,7,2,0,9,6,6,1.0,2,0,-1,-3,5,1,1
4753,6.066754775113225,5.180170028989766,5.7114836389568,4.655451246670315,5.655893285153648,6.268383270035142,5.747171027319772,189836.9539170507,9,E01033571,3,6,1,8,8,8,6.043915877739589,5.099934318086557,5.742855705712971,4.608141350118737,5.647930620009439,6.208995699882507,5.852734601288511,241080.05701754385,9,3,7,0,9,8,9,1.0,0,0,1,-1,1,0,1
4754,5.49363164725127,5.41070838327761,5.38142757680681,5.004516268659521,5.390961660720684,5.879762199189928,5.400900067664959,473437.2555555556,3,E01033572,7,1,7,3,3,2,5.464738523706477,5.369454196521214,5.514971580548852,5.020730417550154,5.383647982110369,5.907429688607306,5.446679369656873,606133.340425532,4,7,3,6,5,3,2,1.0,1,0,2,-1,2,0,0
4755,5.321876336546505,5.334495581832587,5.332438595154706,5.159574422181821,5.390170312395282,5.747136684025035,5.221557881317887,476115.0588235294,1,E01033573,6,1,9,3,1,0,5.475333633488172,5.2293482561634015,5.632116342244083,5.153071645188005,5.364344595229789,5.914055736097571,5.4742207494500565,610469.9589041095,4,5,5,8,4,3,3,1.0,3,-1,4,-1,1,2,3
4756,4.647867015150727,5.70724540069455,4.833900119437546,5.816688166290033,4.701615015014273,5.208914580892344,4.825620068878424,493448.2786885246,0,E01033574,9,0,9,0,0,0,4.926826457892146,5.682625949382782,5.153751530817577,5.467892902238028,4.803891788635935,5.4113932847976685,5.29670050740242,630902.6785714285,0,9,0,9,0,0,0,1.0,0,0,0,0,0,0,0
4757,4.887014935656292,5.416191083628957,5.092153115970333,5.449475631481263,4.96398158189727,5.388505487907223,5.153562129997626,493217.1707317073,0,E01033575,7,0,9,0,0,0,5.080569609682611,5.477993620202897,5.112572913474225,5.411231294591376,4.961617102014258,5.5073710096643325,5.216169879791584,630630.6382978724,0,9,0,9,0,0,0,1.0,0,2,0,0,0,0,0
4758,4.816652717481133,5.7980077621591,4.891134328059568,5.5503867432361345,4.88012334727149,5.271871631837073,4.85794559098382,499192.80152671755,0,E01033576,9,0,9,0,0,0,4.918442541274471,5.529393602972445,5.159297022698582,5.452441564936569,5.012653700683428,5.480369335931281,5.279893936886304,637066.0398550725,0,9,0,9,0,0,0,1.0,0,0,0,0,0,0,0
4759,4.86267957899058,5.633192275729135,5.09003415285984,5.43775841008837,4.995073204285631,5.439190586593663,5.02029061540265,493456.9345794392,0,E01033577,9,0,9,0,0,0,5.083505390531423,5.431602166694345,5.259015440555066,5.297762447576307,5.17995341734593,5.546061260414741,5.228445747137841,630722.4822006472,0,8,0,9,1,0,0,1.0,0,-1,0,0,1,0,0
4760,4.733293921175138,5.55354560932643,5.043995900892876,5.550134150075241,4.900994025485616,5.276323575369069,5.076433050800377,516532.8309859155,0,E01033578,9,0,9,0,0,0,4.796713035236033,5.634779240733893,5.019701917966207,5.568492778511935,4.894732770993728,5.382864819940671,5.192283754200899,659285.8217054263,0,9,0,9,0,0,0,1.0,0,0,0,0,0,0,0
4761,4.720550112034145,5.601584415686758,4.933466996801527,5.575166227001893,4.918856509422001,5.284665101452878,4.9451668591875775,516836.8881578947,0,E01033579,9,0,9,0,0,0,4.716056255032035,5.707598404323353,4.997864226032706,5.557168858892777,4.931407003542956,5.354480155776529,5.033666945205015,659671.5705882353,0,9,0,9,0,0,0,1.0,0,0,0,0,0,0,0
4762,5.211132816473643,5.296076230208079,5.487207806110382,5.149461168050766,5.313036866982778,5.738374106089274,5.3213343242804205,493220.25,0,E01033580,5,3,9,1,1,1,5.395047231154009,5.194297235662287,5.5267695166847925,5.025727057456971,5.318544884161516,5.827451458844272,5.505238034508445,630557.2,3,4,3,6,3,2,3,1.0,3,-1,0,-3,2,1,2
4763,5.105309951851386,5.657558238688316,5.027291489921454,5.303309079799943,5.115049903174393,5.4794232408509,4.980210334290075,492239.93511450384,0,E01033581,9,0,9,0,0,0,5.2167138862805285,5.58096288608723,5.164428346958316,5.282183394568865,5.162078409898476,5.556335046643117,5.0749546748692875,629344.9631147541,1,9,0,9,0,0,0,1.0,1,0,0,0,0,0,0
4764,5.429761373635494,5.476251804467403,5.4429353860893634,5.053902736817948,5.3806199208654535,5.776345019388681,5.387105346930148,491971.2727272727,2,E01033582,8,2,7,2,1,2,5.493734379609426,5.296349144230287,5.427354879677296,5.083977090815703,5.310505462189515,5.786814843614896,5.238708936919768,628928.8854166666,4,6,2,7,3,1,0,1.0,2,-2,0,0,1,0,-2
4765,4.859863732036672,5.634893060296845,5.045448380524642,5.433580136355765,4.966285599948675,5.394294423615281,5.036916949686698,514767.33966745844,0,E01033583,9,0,9,0,0,0,4.949794739684803,5.479860565806395,5.235550445064869,5.455293582989865,4.9854706804491,5.53401141252027,5.268576418526754,657916.8836689038,0,9,0,9,0,0,0,1.0,0,0,0,0,0,0,0
4766,5.496916082968195,5.332131806626378,5.443741993731763,5.023487922656967,5.400802375322365,5.821273713226778,5.441794447152011,508213.313253012,3,E01033584,6,2,7,3,2,3,5.6258774060075005,5.258577763393361,5.632994887649372,4.991351414752263,5.557384655039797,5.9985525813153995,5.499984854011125,648928.0107526882,6,5,5,5,8,5,3,1.0,3,-1,3,-2,5,3,0
4767,4.985808942482056,5.569617904149569,5.133974309392303,5.35693552088641,5.026899292401457,5.54322446357866,5.0993162702452315,512357.21457489877,0,E01033585,9,0,9,0,0,0,5.057706115319747,5.381579304850379,5.2954056369241815,5.304572203824686,5.148736872414286,5.591009308201398,5.2572103156599885,653823.1240310078,0,8,0,9,0,0,0,1.0,0,-1,0,0,0,0,0
4768,5.229642171412706,5.512855827063322,5.1757371976971625,5.250906103104353,5.136223960667849,5.605853094160556,5.251134707778692,516945.64375,0,E01033586,8,0,9,0,0,1,5.333418264240026,5.3620425797998905,5.298478158563375,5.138454595208168,5.223113716393709,5.779345972836017,5.388760732859373,659970.88125,2,7,0,8,1,1,1,1.0,2,-1,0,-1,1,1,0
4769,4.975108124469888,5.623087145542276,5.047748155429446,5.412238495103244,5.124523344533197,5.500989280897995,5.016490255553147,172383.6,0,E01033587,9,0,9,0,0,0,5.038595830521932,5.523016448427991,5.084646573153938,5.377285237719373,5.050574166018788,5.54343424192289,5.114184447178027,218068.2012195122,0,9,0,9,0,0,0,1.0,0,0,0,0,0,0,0
4770,5.014637492515228,5.514478756831243,5.220369321959359,5.3696133684326,5.085886707672706,5.585940968859327,5.129642009735107,169401.5164835165,0,E01033588,8,0,9,0,0,0,5.050803018140269,5.393993394715445,5.255443553348164,5.362537424642961,5.139500696580488,5.637612319254613,5.181635250102032,212810.5934065934,0,8,0,9,0,0,0,1.0,0,0,0,0,0,0,0
4771,4.928491742412249,5.384616795182228,5.409998927513758,5.273595008254051,5.187866173187891,5.5465521067380905,5.080314990878105,168366.73333333334,0,E01033589,7,1,9,0,0,0,5.027408151698292,5.2375716634262774,5.463878172680848,5.201561174894634,5.141695555887725,5.5853667133732845,5.168464027849355,211464.38345864663,0,5,2,9,0,0,0,1.0,0,-2,1,0,0,0,0
4772,5.442236351412396,5.339924105378085,5.493217307467793,4.955762293449668,5.397846196973046,5.9001006220662315,5.439035856446554,151686.93023255814,2,E01033590,6,3,6,3,3,3,5.3508892514732445,5.4094599043385365,5.478950580854095,5.12897173608287,5.218508337320906,5.888458495729425,5.488528285133705,191505.55056179775,2,8,2,8,1,3,3,1.0,0,2,-1,2,-2,0,0
4773,5.326485803463315,5.279747094884015,5.5046882789407,5.167948669235178,5.187586221118901,5.714094998852518,5.160245231333995,161442.36241610738,1,E01033591,5,3,9,0,1,0,5.2434010822325945,5.169018262065947,5.511346509680152,5.1551776845008135,5.127269978635013,5.694689299911261,5.286274733953178,203361.6640625,1,4,3,8,0,0,0,1.0,0,-1,0,-1,0,-1,0
4774,5.493955945211743,5.2434508923500305,5.621918453110589,4.920346592153821,5.4319249457783165,6.089438273793175,5.722130841679043,148613.47619047618,3,E01033592,4,5,5,3,6,8,5.342164691478487,5.2778882715437145,5.524055955901979,5.063372318706815,5.215460846348415,5.972027916756887,5.684936515868656,187882.70634920636,2,6,3,7,1,5,7,1.0,-1,2,-2,2,-2,-1,-1
4775,5.024982411034253,5.506595908379068,5.309724968306872,5.368942825161681,5.103688685261473,5.5474550967313805,5.324140918498137,134527.8775510204,0,E01033593,8,1,9,0,0,1,4.976152536247959,5.266912755845976,5.39117608350866,5.327374709754431,5.102526038634677,5.558676769753464,5.426132075926837,170009.3949579832,0,6,1,9,0,0,2,1.0,0,-2,0,0,0,0,1
4776,5.47514224391092,4.838581461798061,5.932372943921522,4.904996775090694,5.5653625117106875,5.818408879366788,5.60154307091778,133769.07386363635,3,E01033594,0,9,5,7,2,6,5.380264334562348,4.826731897563469,5.877088131555697,4.934426564123572,5.406633126444933,5.767068112768778,5.565232082692588,168758.1512195122,2,0,8,4,5,1,4,1.0,-1,0,-1,-1,-2,-1,-2
4777,5.531568363017994,4.488188899002985,6.122931425845546,4.845657073753258,5.727527450325691,5.8825341613070306,5.81492447749653,503623.0433839479,3,E01033595,0,9,4,9,3,9,5.433542413594293,4.558890561588475,6.063530330970639,4.838067483315703,5.588131790278388,5.814187877490872,5.728567049542411,632776.937704918,3,0,9,2,9,2,7,1.0,0,0,0,-2,0,-1,-2
4778,5.32324640306772,4.621863327774347,6.056811807202358,4.931932605949103,5.680599696495953,5.837913171917784,5.6151461051959615,523444.29411764705,1,E01033596,0,9,5,9,2,6,5.224137254346881,4.707439681939912,5.914609504164311,4.905959757587366,5.505520220806724,5.635752257966159,5.405235960609034,668678.3754385965,1,0,9,3,8,0,2,1.0,0,0,0,-2,-1,-2,-4
4779,5.729279237134116,5.077789621693747,5.692442984808059,4.857312985828945,5.559942921002706,5.894712629772368,5.5151455373991105,95338.47619047618,6,E01033597,2,6,4,6,3,4,5.7678865277489955,4.9584641207096185,5.664808511734009,4.920411121013553,5.4655923316645065,5.930871852608615,5.624729053918705,125228.06976744186,7,1,6,4,7,4,6,1.0,1,-1,0,0,1,1,2
4780,5.256140640226461,5.113044391244145,5.671345076318515,5.024157722117537,5.367671336157847,5.739442772784476,5.287629291162652,131784.0,1,E01033598,2,6,7,2,1,1,5.061982951666179,5.171837863169219,5.451570962604723,5.182526789213481,5.211752565283525,5.643498700961732,5.274373048230221,166284.43859649124,0,4,2,8,1,0,0,1.0,-1,2,-4,1,-1,-1,-1
4781,5.331766264779227,5.113179956163679,5.844466890607562,4.919993877410889,5.383510555539813,5.885815382003784,5.604619707380023,394951.0,1,E01033599,2,8,5,2,3,6,5.481602191925049,4.970407277345657,5.91129544377327,4.905483692884445,5.415182560682297,6.0217927396297455,5.868012994527817,525158.5,4,1,9,3,5,6,9,1.0,3,-1,1,-2,3,3,3
4782,5.749642921611667,4.8091730289161205,5.933768678456545,4.615537205711007,5.598889980465174,5.998707950115204,5.678240276873112,135946.5,6,E01033600,0,9,0,7,5,7,5.731322741822193,4.927717618252101,5.916050120403892,4.857288796650736,5.517867458494086,5.945175390494497,5.786501279002742,171776.7894736842,7,1,9,2,8,4,8,1.0,1,1,0,2,1,-1,1
4783,5.303926540202782,5.243765502679543,5.713464045133747,4.9905285972063655,5.359411638291156,5.765206292027333,5.414160099185881,131814.26229508198,1,E01033601,4,6,6,2,1,3,5.16167617019485,5.2028506152770095,5.48394848318661,5.222481443601496,5.233997243292191,5.678385527694926,5.324322402477264,166366.01470588235,0,4,2,9,1,0,1,1.0,-1,0,-4,3,-1,-1,-2
4784,5.186817535332271,5.069997210587774,5.706471260104861,5.152423873543739,5.340027919837406,5.606008418968746,5.198318860360554,131834.01785714287,0,E01033602,2,6,9,2,0,0,5.027230928021092,5.1097476751573625,5.563499331474304,5.132979489141895,5.197422089115266,5.5999226570129395,5.250672972971393,166349.35483870967,0,3,4,8,1,0,0,1.0,0,1,-2,-1,-1,0,0
4785,5.3511082477736895,4.940933875870287,5.691354601006759,4.923869490623474,5.473915744246098,5.741380879753514,5.420614616912708,132815.22807017545,2,E01033603,0,6,5,4,1,3,5.3635439852873485,4.9629183133443195,5.6770710945129395,4.999906965096792,5.35487859249115,5.648366526762644,5.490370710690816,167598.38333333333,2,1,6,5,4,0,3,1.0,0,1,0,0,0,-1,0
4786,5.16038194869427,5.145093565291547,5.6624062061309814,5.056545811764737,5.421427717868318,5.630289862764642,5.319275928304551,132564.43617021278,0,E01033604,3,5,7,3,0,1,5.039461222764488,5.0684492899992755,5.615647803957217,5.271498664517269,5.231362902115438,5.575725599984143,5.326878999995294,167248.90654205607,0,2,5,9,1,0,1,1.0,0,-1,0,2,-2,0,0
4787,5.404482107896071,5.037317878160721,5.824761879749787,4.905603962066846,5.527048486929673,5.888526402986967,5.480810646827404,132108.9871794872,2,E01033605,1,8,5,6,3,4,5.3850278243422505,4.940542130172252,5.741181614995003,4.979400537908077,5.332666192948818,5.825335875153542,5.555188189446926,166701.7,3,1,7,5,3,2,4,1.0,1,0,-1,0,-3,-1,0
4788,5.661063459941319,4.930202116285051,5.887951251438686,4.803480638776507,5.601682077135359,5.902634790965489,5.709821673801967,137109.0285714286,5,E01033606,0,8,3,7,3,7,5.605472907423973,4.763279460370541,5.979164406657219,4.88492264226079,5.537068657577038,5.949274390935898,5.843623161315918,173408.09375,5,0,9,3,8,4,9,1.0,0,0,1,0,1,1,2
4789,5.809598646302154,4.999389145685279,5.876325527826945,4.760405946468961,5.566886352456135,5.991708852242732,5.626152898954309,136889.89855072464,7,E01033607,1,8,2,7,4,6,5.61018458707833,5.044389668806099,5.756261026417768,4.887633940319956,5.436267646742456,5.856985576358842,5.6686066860034146,173147.37037037036,5,2,7,3,6,2,6,1.0,-2,1,-1,1,-1,-2,0
4790,5.971954010151051,4.784887925342277,6.040229258713899,4.666358537144131,5.616374722233525,6.130995185286911,5.90543618467119,136379.37037037036,8,E01033608,0,9,1,8,7,9,5.784617230809968,4.719223378033473,6.050021274336453,4.662274173621474,5.471366504143024,6.072521538570009,5.885518579647459,172342.60344827586,7,0,9,0,7,7,9,1.0,-1,0,0,-1,-1,0,0
4791,5.560825287406124,5.26316234602857,5.614878078005207,5.0202667410693955,5.412791376683249,5.983080878186581,5.5770184442178525,647498.895522388,4,E01033698,5,5,7,3,4,5,5.330439987182618,5.142576662699382,5.629381844202677,4.99113099416097,5.363652159372966,5.885405060450236,5.555670816103618,820957.84,2,3,5,5,4,3,4,1.0,-2,-2,0,-2,1,-1,-1
4792,5.317497381600001,4.922183466214006,5.769077680444204,5.016825079917908,5.4154046940547165,5.754026137372499,5.418740305849301,512178.22580645164,1,E01033699,0,7,7,3,1,3,5.232022415293326,4.922268972538485,5.758641291372847,5.053073478217172,5.377251242647077,5.693709142137282,5.380739607433282,649417.7326732674,1,1,7,6,4,0,1,1.0,0,1,0,-1,1,-1,-2
4793,5.002860029106555,5.185628910427508,5.550725988719774,5.2045024814813035,5.246850179589313,5.54887643845185,5.299587161644645,629598.3260869565,0,E01033700,3,4,9,0,0,1,5.011643899248002,5.049304255779753,5.576377934597908,5.190063465148844,5.30098430400199,5.649359924996153,5.310913182319479,798743.8085106383,0,2,4,8,3,0,1,1.0,0,-1,0,-1,3,0,0
4794,5.389398087072008,5.30245346058416,5.401062500385838,5.039152969840829,5.385079075361936,5.77447140944823,5.398283275939126,109307.0534351145,2,E01033701,5,1,7,2,1,2,5.34689930267632,5.073729873634875,5.618261059746146,4.98646598495543,5.348192309960723,5.857473498210311,5.616938971914351,138935.9453125,2,2,5,5,4,2,5,1.0,0,-3,4,-2,2,1,3
4795,4.914608518282573,5.522074597676595,5.28070680141449,5.302377338409424,5.123910565376281,5.5258251555760705,5.104126003583272,389452.4533333333,0,E01033702,8,0,9,0,0,0,4.941577870594828,5.315936433641534,5.393759158096816,5.259828532996931,5.115947786130403,5.616323207554064,5.1663952642365505,498609.4210526316,0,6,1,9,0,0,0,1.0,0,-2,1,0,0,0,0
4796,5.318825347082956,5.011848882753021,5.732591132728421,5.047399058633921,5.430992676287281,5.872114337220484,5.434924429776717,595971.081632653,1,E01033703,1,6,7,3,2,3,5.355385106542836,4.945412508819414,5.820783475170964,4.978735306988591,5.38525969049205,5.7539876232976495,5.5659629832143365,757508.304347826,2,1,8,5,5,1,4,1.0,1,0,2,-2,2,-1,1
4797,5.147811809699692,5.1344758364968675,5.553853907271059,5.143183144266734,5.3401294261395575,5.644793454044593,5.283663696157718,643723.8622754491,0,E01033704,3,4,9,2,0,1,5.115947138663777,5.114025352387455,5.504339489856911,5.158923729171966,5.263883545412032,5.555734894129151,5.285572835187006,816263.8659217877,0,3,3,8,2,0,0,1.0,0,0,-1,-1,0,0,-1
4798,5.623213277621702,5.242692152207548,5.4218747968023475,4.884644184600223,5.457290360873396,5.8830617422407325,5.323892965912819,564676.8636363636,5,E01033705,4,2,5,4,3,1,5.594692004077575,5.232711350216585,5.463816751452053,5.0113411142545585,5.379842908943401,5.785733194912181,5.293712012908038,707189.2794117647,5,5,2,6,4,1,0,1.0,0,1,0,1,0,-2,-1
4799,5.3133115000449695,4.780302442037142,5.809895742398042,4.976411732343527,5.5407369916255655,5.712660301190156,5.433752655982971,188792.8173076923,1,E01033706,0,7,6,6,0,3,5.286629638396019,4.780002330945543,5.8261992970774,4.979101353440403,5.4243473119972165,5.682531847441492,5.492260757556632,287564.71074380167,1,0,8,5,6,0,3,1.0,0,0,1,-1,0,0,0
4800,5.292374260723591,5.131572847919805,5.5319497521434515,5.081191625978265,5.375916285174234,5.763102479279041,5.4605430109160285,565547.7410714285,1,E01033707,2,3,8,2,1,3,5.284575569629669,5.163990295926729,5.461025331417719,5.101169960697492,5.218770184119543,5.68833865125974,5.366970380147298,729891.0666666667,1,4,2,7,1,0,1,1.0,0,2,-1,-1,-1,-1,-2
4801,5.053032642524493,4.955436058734593,5.659205256324065,5.131683307650842,5.418066980415269,5.6315671766274855,5.2913055706181025,86927.35197368421,0,E01033708,1,5,8,3,0,1,5.128585379084046,4.818185367097198,5.760504813488759,5.052134145467129,5.396759113053528,5.645179238851733,5.513515257495599,110625.99762470309,0,0,7,6,5,0,3,1.0,0,-1,2,-2,2,0,2
4802,5.217723031587239,5.198330592505539,5.63925022414968,5.054650339899184,5.476295990279958,5.72827965398378,5.418747164026091,106425.83544303797,0,E01033709,3,5,7,4,1,3,5.11606572688311,5.003790770453969,5.718620977182498,5.012228368342607,5.3061892520422225,5.766913435925012,5.487270211351329,135493.4367816092,0,1,7,6,3,1,3,1.0,0,-2,2,-1,-1,0,0
4803,4.978540394041273,5.489114231533474,5.447205234456946,5.222812723230432,5.24650087179961,5.695635769102308,5.306326963283397,389575.85185185185,0,E01033710,8,2,9,0,0,1,5.156563454660876,5.290199937491582,5.511199071489531,5.193135208096997,5.4050965555782975,5.896061716408565,5.263906372004542,498763.5172413793,0,6,3,8,5,3,0,1.0,0,-2,1,-1,5,3,-1
4804,5.227072141740633,4.985316578460776,5.7246297701545386,4.989566580108974,5.456421903941942,5.741205770036449,5.34078374893769,106323.72826086957,0,E01033711,1,6,6,4,1,2,5.156436842515928,4.926313039359696,5.729125865008853,5.0962025123998655,5.421823574862349,5.680115677894802,5.5398681688746185,135421.46788990826,0,1,7,7,6,0,4,1.0,0,0,1,1,2,-1,2
4805,5.091866380679681,5.217861659778571,5.490275800598334,5.155328965335158,5.282180126409353,5.596742960236828,5.191541448142958,644176.8757763975,0,E01033712,4,3,9,1,0,0,5.078094124062661,5.14456127465137,5.490499585684092,5.207410498630781,5.263318080843592,5.57594873568763,5.212078501110428,816731.8036809816,0,3,2,9,2,0,0,1.0,0,-1,-1,0,1,0,0
4806,5.901381134986877,5.0767393218619485,5.702825067298753,4.813954817397254,5.689561149903706,6.032309419342449,5.580229978476252,599236.3392857143,8,E01033713,2,6,3,9,5,5,5.914444747659349,4.932823033676934,5.859033650958661,4.8215070446741946,5.619481863434782,6.129254867121117,5.692861226416126,760982.0103092784,8,1,8,2,9,7,7,1.0,0,-1,2,-1,0,2,2
4807,5.625552272867589,5.421594898970354,5.422975410662946,4.9553757565362115,5.462132731718676,5.910021860684667,5.3632352242157575,700893.7648809524,5,E01033724,7,2,6,4,3,2,5.595343165201683,5.304372620909182,5.553031235525053,4.919793403311951,5.426872831501373,6.044124884148166,5.5129741707893265,887127.2876712328,5,6,4,4,6,6,3,1.0,0,-1,2,-2,2,3,1
4808,5.772228355814771,5.406139728863065,5.374320217748967,4.816727023299148,5.456946636845426,5.8921480127951,5.473616122109134,698909.393292683,6,E01033725,7,1,3,4,3,4,5.651928839102314,5.480856227637523,5.327038118791817,4.987103753125489,5.3324517495003505,5.891775971028342,5.530451065865322,886065.6940298508,6,9,1,5,3,3,4,1.0,0,2,0,2,-1,0,0
4809,5.465633234925033,5.531532555873443,5.256664409382787,5.045062382137798,5.36872241400443,5.7538171567530485,5.254274089692047,262571.10681399633,3,E01033726,9,0,7,2,1,1,5.456867774258127,5.493528344414451,5.269101495926197,5.056997207494883,5.266859481384704,5.862589454317426,5.46348399403212,338174.99475524476,3,9,0,6,2,2,3,1.0,0,0,0,-1,0,1,2
4810,5.376473317543666,5.378235374887784,5.418773267666499,5.081451191504796,5.377727694312731,5.695445026954015,5.27025438050429,280398.275,2,E01033727,6,2,8,2,0,1,5.523987873512156,5.183522680226495,5.509388317080105,4.934027240556829,5.417869731783867,5.799046234172933,5.478355388430988,360659.70588235295,4,4,3,4,6,1,3,1.0,2,-2,1,-4,4,1,2
4811,5.150302007084801,5.377982798076811,5.322859298615229,5.202890793482463,5.116292232558841,5.432502008619762,5.156544991901943,280049.4285714286,0,E01033728,6,1,9,0,0,0,5.339692708217736,5.09110028815992,5.458132967804417,4.967957019805908,5.282898379094673,5.7256026845989805,5.405724344831524,360305.1818181818,2,3,2,5,2,1,2,1.0,2,-3,1,-4,2,1,2
4812,5.588637814009931,5.438422828070862,5.432916814998045,5.004231456309388,5.439738445362802,5.879013578770524,5.404436403748679,384526.7514124294,4,E01033729,7,2,7,4,2,2,5.54686501883142,5.365322676122463,5.501945832357978,4.936067416371288,5.293098413449828,5.963368060951408,5.580396137479264,489187.62211981567,5,7,3,4,2,4,5,1.0,1,0,1,-3,-2,2,3
4813,5.028898978442476,5.407878205441592,5.302063035337548,5.304886624478457,5.178384901138774,5.521562396434316,5.160924528774462,282896.2105263158,0,E01033730,7,0,9,0,0,0,5.067171906357381,5.291168930815227,5.466804250852386,5.223170042927586,5.217263002004197,5.6645284713204225,5.335659279752133,363691.75373134325,0,6,2,9,1,0,1,1.0,0,-1,2,0,1,0,1
4814,5.044532562504296,5.468155299915987,5.258676163288725,5.32224224996166,5.201642996122857,5.532104454120668,5.075446683819554,561266.319327731,0,E01033731,8,0,9,0,0,0,5.082312235756526,5.360939302141705,5.330385140010288,5.326635022012014,5.175365302297804,5.704705751131451,5.217956790848384,715841.3888888889,0,7,1,9,0,0,0,1.0,0,-1,1,0,0,0,0
4815,5.263611982035083,5.62102060262547,5.294694822888042,4.988744549973067,5.233756284381068,5.765115482862606,5.115773325742677,440084.3023255814,1,E01033732,9,0,6,0,1,0,5.403093731921652,5.54087217476057,5.377203796220862,5.228439170381297,5.233950806700665,5.7978596687316895,5.151006245094797,587172.1521739131,3,9,1,9,1,1,0,1.0,2,0,1,3,1,0,0
4816,5.036549048388705,5.735657049452557,4.878883633543463,5.413211915422888,5.1508197801954605,5.403686223661198,4.824640365207896,357992.0,0,E01033733,9,0,9,0,0,0,5.045721057173494,5.465086786777942,5.212797465262475,5.321042876739006,5.147112494165247,5.495741532994555,5.088749393240198,484170.7987012987,0,9,0,9,0,0,0,1.0,0,0,0,0,0,0,0
4817,5.372688033888417,5.463946802000845,5.3595870156441965,5.129031338999348,5.318531736250846,5.777887655842688,5.301608200996153,530661.0645161291,2,E01033734,8,1,8,1,1,1,5.346815843839903,5.409295289903073,5.307376913122229,5.133268866990064,5.23899910417763,5.772443255862674,5.293279016340101,673073.8513513514,2,8,0,8,1,1,0,1.0,0,0,-1,0,0,0,-1
4818,5.217110666475798,4.9879071047431545,5.7010014634383355,5.126403153570075,5.374197149276734,5.696921890660336,5.277280786162929,576609.6315789474,0,E01033735,1,6,8,2,0,1,5.294845752094103,4.877206416233726,5.692788987056069,5.055484303961629,5.41466798082642,5.776974201202393,5.542903644883114,734272.3369565217,1,0,6,6,5,1,4,1.0,1,-1,0,-2,3,1,3
4819,5.581479600957922,5.250319049165055,5.499307967521049,4.946889664675738,5.451930381156303,5.999428066047463,5.578032409822619,544156.2162162162,4,E01033736,4,3,6,4,5,5,5.590694609810324,5.127530890352586,5.68173755383959,4.974569318341274,5.542252351255978,6.026795606987149,5.744031873403811,713054.8431372549,5,3,6,5,8,6,7,1.0,1,-1,3,-1,4,1,2
4820,5.204561710959733,5.387542848635202,5.377906121990898,5.144049916604553,5.266005095809397,5.6948157687379855,5.271121531423896,576710.1363636364,0,E01033737,7,1,9,1,0,1,5.207314160382636,5.328321940988023,5.482137915129973,5.185526694649848,5.2598905373956555,5.739550023992485,5.363533646146828,734438.4158878505,1,7,2,8,2,1,1,1.0,1,0,1,-1,1,1,0
4821,5.218237122303338,5.467913300252808,5.28570919472554,5.268796830612996,5.19883723307382,5.642349488844121,5.1185637313097265,266986.26395939087,0,E01033738,8,0,9,0,0,0,5.185198770574302,5.475729797004668,5.289415609738058,5.209342409756558,5.124601724719213,5.654452817006544,5.238785143726128,343619.2603305785,0,9,0,9,0,0,0,1.0,0,1,0,0,0,0,0
4822,4.961812083537762,5.592194052842947,5.330178361672622,5.297170079671419,5.303140961206877,5.864624518614549,5.19947361946106,360991.76923076925,0,E01033739,9,1,9,1,2,0,5.006878957748413,5.382712869644165,5.330905494689941,5.260054712295532,5.245991010665893,5.759616842269898,5.17602077960968,462351.84,0,8,1,9,2,1,0,1.0,0,-1,0,0,1,-1,0
4823,5.429396348529392,5.5268958038753935,5.32094884801794,5.167218181822035,5.37618290759899,5.896061950259739,5.389825708777816,361188.5925925926,2,E01033740,8,1,9,2,3,2,5.367139906567686,5.383417497662937,5.452125182923148,5.084355880232418,5.395315175547319,5.937245596857632,5.354199876680093,462600.26470588235,2,8,2,7,5,4,1,1.0,0,0,1,-2,3,1,-1
4824,5.311384957398164,5.674863899120291,5.112969325671017,5.154750678726431,5.223591657628785,5.77490335031581,5.218683341257401,361536.3959044369,1,E01033741,9,0,9,0,1,0,5.418212016423543,5.516008956196868,5.187767504174032,5.092347725673958,5.247550697974217,5.772996672509629,5.202380500825835,462979.93827160494,3,9,0,7,2,1,0,1.0,2,0,0,-2,2,0,0
4825,5.346133429953393,5.4819007477861765,5.501693233530572,5.0641898068975895,5.456652265913943,5.860222917922,5.200074581389732,361941.72340425535,1,E01033742,8,3,8,4,2,0,5.329851698231053,5.246538471531224,5.421353069511619,5.053075838733363,5.351425776610503,5.880146348798597,5.213096370568147,463467.4324324324,2,5,1,6,4,3,0,1.0,1,-3,-2,-2,0,1,0
4826,5.399209331944992,5.630569332935771,5.228866483344406,5.092336428621428,5.292672126019587,5.967630712060981,5.467383587295241,360647.1038251366,2,E01033743,9,0,8,1,4,4,5.479207091539809,5.445719427854112,5.277515362188654,5.040889569277902,5.289643903380459,5.977965430148597,5.398539643264511,461955.47572815535,4,8,0,6,2,5,2,1.0,2,-1,0,-2,1,1,-2
4827,5.549113108998253,5.4695313430967785,5.397708794427296,4.798510467249249,5.494467256561158,5.985458173449078,5.312807704721179,368281.85714285716,4,E01033744,8,1,3,5,4,1,5.506846338510513,5.319179529590266,5.50756572825568,4.870104420397963,5.431617975234985,5.965705386229923,5.418817797941821,465221.41964285716,4,6,3,3,6,4,2,1.0,0,-2,2,0,1,0,1
4828,5.279852420330047,5.747684704303741,5.02364262676239,5.256242649078369,5.1684277095794675,5.6670596361160275,5.178155479907989,360903.828,1,E01033745,9,0,9,0,0,0,5.470627819691446,5.657287053842848,5.138232198705101,5.167672954262777,5.170960624731893,5.798288922849055,5.276587482897216,462406.4134275618,4,9,0,8,0,1,0,1.0,3,0,0,-1,0,1,0
4829,5.651670456909742,5.149637156822642,5.660059221455308,4.907949388027191,5.372123092901512,5.985568306485161,5.530240171268338,276102.47540983604,5,E01033746,3,5,5,2,4,5,5.586068221238944,5.070734142340147,5.7124160143045275,4.928940593279325,5.3961281162041885,5.9592342358369095,5.557818945554587,355219.4846153846,5,2,6,4,5,4,4,1.0,0,-1,1,-1,3,0,-1
